CountyFIPS,County,CNTY,VTD,CNTYVTD,VTDKEY,total,anglo,nanglo,asian,black,hisp,bh,vap,anglovap,nanglovap,asianvap,blackvap,hispvap,bhvap
29,BEXAR,29,2109,292109,522,0,0,0,0,0,0,0,0,0,0,0,0,0,0
29,BEXAR,29,4043,294043,854,5072,1287,3785,228,1413,2195,3455,3598,1018,2580,156,967,1441,2343
39,BRAZORIA,39,0073,390073,1186,1770,510,1260,139,687,431,1105,1211,384,827,97,458,264,714
65,CARSON,65,0101,650101,1518,679,585,94,3,4,55,58,515,461,54,3,2,31,32
85,COLLIN,85,0221,850221,1850,7160,4974,2186,506,752,811,1523,5024,3617,1407,323,483,512,978
113,DALLAS,113,4606,1134606,2846,7614,1464,6150,195,405,5483,5847,5461,1283,4178,147,274,3669,3936
485,WICHITA,485,0304,4850304,9344,1730,956,774,26,123,574,686,1322,797,525,13,77,387,458
215,HIDALGO,215,0211,2150211,5763,647,89,558,12,8,540,547,460,69,391,8,6,377,383
245,JEFFERSON,245,0067,2450067,6095,4037,371,3666,63,2818,772,3565,2904,328,2576,49,2044,467,2496
289,LEON,289,0003,2890003,6427,766,601,165,7,58,83,141,639,510,129,6,49,57,106
321,MATAGORDA,321,0008,3210008,6759,1230,680,550,3,83,427,506,940,545,395,1,61,302,362
451,TOM GREEN,451,0201,4510201,8680,5530,3031,2499,226,480,1751,2149,4486,2583,1903,191,394,1271,1615
455,TRINITY,455,0007,4550007,9012,250,217,33,1,7,13,20,192,169,23,0,4,10,14
113,DALLAS,113,3077,1133077,2514,5110,619,4491,266,2074,2172,4184,3773,557,3216,194,1551,1478,2992
113,DALLAS,113,1724,1131724,2182,401,76,325,10,197,124,314,254,59,195,7,116,74,187
201,HARRIS,201,0218,2010218,4435,6362,875,5487,156,254,5066,5267,4848,756,4092,129,191,3754,3922
201,HARRIS,201,0881,2010881,5099,7316,979,6337,540,2044,3847,5752,5022,772,4250,409,1345,2529,3807
201,HARRIS,201,0550,2010550,4767,7443,1322,6121,203,3414,2545,5827,5538,1193,4345,166,2407,1764,4102
209,HAYS,209,0112,2090112,5431,3717,1138,2579,89,362,2124,2420,2905,971,1934,68,226,1620,1811
41,BRAZOS,41,0018,410018,1209,1118,141,977,5,318,645,953,861,126,735,5,263,462,717
67,CASS,67,0021,670021,1541,459,392,67,5,17,24,41,340,298,42,4,10,18,28
85,COLLIN,85,0244,850244,1873,4566,2404,2162,1544,193,321,503,3053,1655,1398,996,130,198,323
113,DALLAS,113,4629,1134629,2869,3946,597,3349,452,890,1996,2845,2853,523,2330,343,620,1345,1947
113,DALLAS,113,30A4,11330A4,2537,26,2,24,4,2,18,19,13,0,13,0,2,9,10
113,DALLAS,113,1747,1131747,2205,5587,1986,3601,1360,1208,960,2125,4408,1699,2709,1045,907,678,1567
201,HARRIS,201,0195,2010195,4412,2680,390,2290,46,1261,1013,2237,2145,349,1796,42,1050,716,1745
203,HARRISON,203,0025,2030025,5408,4430,3426,1004,80,334,453,774,3231,2602,629,48,214,257,467
215,HIDALGO,215,0188,2150188,5740,4998,1040,3958,61,41,3847,3858,3764,1018,2746,39,16,2663,2672
245,JEFFERSON,245,0044,2450044,6072,1598,284,1314,43,423,850,1260,1112,241,871,34,272,560,828
489,WILLACY,489,0002,4890002,9367,145,25,120,3,2,114,116,118,25,93,0,2,90,92
133,EASTLAND,133,0001,1330001,3201,4305,3171,1134,52,121,866,971,3352,2572,780,40,77,578,651
141,EL PASO,141,0218,1410218,3533,291,8,283,0,0,280,280,224,8,216,0,0,214,214
157,FORT BEND,157,3168,1573168,3748,942,109,833,615,139,67,204,605,74,531,397,76,46,121
187,GUADALUPE,187,0125,1870125,4080,275,162,113,4,11,87,98,233,158,75,3,11,50,61
201,HARRIS,201,0527,2010527,4744,1627,187,1440,20,62,1367,1418,1175,161,1014,17,38,963,998
201,HARRIS,201,0858,2010858,5076,622,12,610,2,410,206,605,432,12,420,2,316,106,415
19,BANDERA,19,0409,190409,144,1272,808,464,16,14,344,358,1049,683,366,10,13,264,277
29,BEXAR,29,2064,292064,476,3969,706,3263,49,101,3115,3194,3073,626,2447,29,70,2327,2386
29,BEXAR,29,3202,293202,808,1735,760,975,142,116,715,812,1247,578,669,94,82,482,555
39,BRAZORIA,39,0027,390027,1140,2656,1503,1153,428,386,303,685,2284,1376,908,318,314,233,545
249,JIM WELLS,249,0004,2490004,6141,1849,213,1636,8,6,1619,1622,1345,182,1163,3,3,1152,1152
293,LIMESTONE,293,0303,2930303,6473,312,224,88,9,18,52,69,256,199,57,7,13,27,40
327,MENARD,327,0004A,3270004A,6805,310,209,101,0,2,96,97,237,157,80,0,2,75,76
355,NUECES,355,0022,3550022,7137,649,153,496,15,13,481,487,508,121,387,11,6,377,378
381,RANDALL,381,0227,3810227,7469,4250,3212,1038,264,113,560,662,3375,2624,751,181,84,403,483
427,STARR,427,0004,4270004,7801,882,46,836,3,8,827,831,716,40,676,1,7,669,673
439,TARRANT,439,4141,4394141,8465,7771,2978,4793,928,1483,2333,3740,6110,2561,3549,722,1116,1633,2703
439,TARRANT,439,2310,4392310,8133,3680,1747,1933,156,1100,636,1674,2781,1469,1312,115,738,398,1116
21,BASTROP,21,4022,214022,167,4374,1900,2474,26,291,2057,2336,3198,1618,1580,19,224,1250,1470
29,BEXAR,29,4020,294020,831,3339,678,2661,146,244,2292,2491,2596,615,1981,123,179,1667,1825
29,BEXAR,29,2086,292086,499,5054,1503,3551,368,339,2825,3112,3892,1251,2641,299,245,2055,2275
39,BRAZORIA,39,0050,390050,1163,5530,1072,4458,1014,2572,910,3375,4112,893,3219,733,1888,596,2433
61,CAMERON,61,0083,610083,1495,3884,587,3297,31,28,3215,3226,2750,530,2220,25,20,2145,2156
85,COLLIN,85,0198,850198,1827,186,117,69,1,4,59,61,140,98,42,1,2,35,37
353,NOLAN,353,0008,3530008,7114,195,171,24,0,2,17,18,169,154,15,0,1,10,11
377,PRESIDIO,377,0004,3770004,7446,1492,34,1458,44,7,1407,1414,1107,28,1079,28,5,1046,1051
423,SMITH,423,0057,4230057,7778,621,550,71,26,26,14,38,561,501,60,22,21,12,31
201,HARRIS,201,0904,2010904,5122,0,0,0,0,0,0,0,0,0,0,0,0,0,0
209,HAYS,209,0218,2090218,5454,65,10,55,4,14,35,49,38,4,34,1,8,24,32
215,HIDALGO,215,0234,2150234,5786,3256,75,3181,4,21,3160,3166,2390,51,2339,3,15,2324,2327
245,JEFFERSON,245,0090,2450090,6118,73,14,59,8,37,15,50,60,14,46,7,29,11,38
291,LIBERTY,291,0018,2910018,6450,2125,580,1545,20,1036,440,1466,1580,413,1167,19,831,276,1106
323,MAVERICK,323,003B,323003B,6782,8068,204,7864,21,28,7806,7809,5595,148,5447,16,18,5409,5412
29,BEXAR,29,4206,294206,1017,1077,296,781,47,159,598,731,757,225,532,34,100,405,489
29,BEXAR,29,1103,291103,353,1909,586,1323,85,127,1084,1196,1352,453,899,60,84,724,801
85,COLLIN,85,0052,850052,1681,8073,2126,5947,3351,1060,1456,2492,5664,1637,4027,2314,719,921,1631
85,COLLIN,85,0058,850058,1687,5532,2668,2864,1254,995,527,1488,4484,2314,2170,989,715,368,1067
113,DALLAS,113,2300,1132300,2351,2632,650,1982,85,130,1764,1861,1979,566,1413,72,91,1234,1311
121,DENTON,121,2091,1212091,3015,5538,3889,1649,810,312,435,731,4736,3416,1320,662,240,328,560
491,WILLIAMSON,491,0399,4910399,9507,1688,193,1495,1308,52,101,145,1021,137,884,784,29,53,80
259,KENDALL,259,2060,2592060,6264,2939,2130,809,63,36,642,668,1945,1455,490,38,21,381,396
339,MONTGOMERY,339,0033,3390033,6928,4482,3199,1283,386,160,608,759,3955,2922,1033,321,126,484,608
387,RED RIVER,387,19-4,38719-4,7515,420,354,66,2,42,10,51,346,290,56,2,42,6,47
401,RUSK,401,0111,4010111,7592,3320,1889,1431,13,888,481,1364,2999,1714,1285,12,834,406,1235
439,TARRANT,439,2474,4392474,8179,1240,705,535,20,115,376,482,925,583,342,13,73,227,298
453,TRAVIS,453,0275,4530275,8843,3018,2071,947,268,157,460,592,2438,1736,702,190,112,331,432
151,FISHER,151,0010B,1510010B,3602,0,0,0,0,0,0,0,0,0,0,0,0,0,0
157,FORT BEND,157,2114,1572114,3679,6942,272,6670,89,4426,2287,6576,5098,249,4849,61,3282,1578,4779
201,HARRIS,201,0712,2010712,4930,10110,1734,8376,568,2717,5222,7710,7052,1385,5667,432,1779,3499,5162
201,HARRIS,201,0049,2010049,4266,6772,2029,4743,168,1011,3532,4473,4673,1585,3088,98,643,2285,2901
215,HIDALGO,215,0048,2150048,5600,6645,143,6502,77,24,6405,6408,4972,102,4870,54,10,4807,4808
215,HIDALGO,215,0042,2150042,5594,5498,291,5207,46,44,5135,5162,3884,270,3614,38,33,3548,3572
29,BEXAR,29,4189,294189,1000,1766,322,1444,63,527,897,1368,1205,267,938,41,334,580,892
29,BEXAR,29,1080,291080,330,7340,1427,5913,441,1286,4269,5388,5530,1232,4298,337,913,3025,3878
29,BEXAR,29,2041,292041,453,4356,245,4111,43,195,3892,4041,3354,216,3138,28,146,2967,3088
29,BEXAR,29,4183,294183,994,80,39,41,1,1,41,41,71,35,36,0,1,36,36
85,COLLIN,85,0035,850035,1664,2577,1639,938,36,63,755,815,1920,1306,614,27,43,472,515
113,DALLAS,113,2144,1132144,2328,1910,1436,474,124,70,242,298,1647,1262,385,92,51,206,246
453,TRAVIS,453,0246,4530246,8820,5843,2734,3109,712,702,1653,2276,4846,2451,2395,567,542,1233,1731
471,WALKER,471,0103,4710103,9158,2443,1530,913,20,377,467,827,1916,1253,663,19,278,319,587
329,MIDLAND,329,0208,3290208,6828,1808,676,1132,38,208,855,1047,1358,550,808,29,144,597,736
339,MONTGOMERY,339,0053,3390053,6951,7747,4361,3386,165,516,2548,3012,5727,3485,2242,123,357,1629,1961
383,REAGAN,383,0003B,3830003B,7492,124,81,43,3,0,40,40,101,65,36,1,0,34,34
403,SABINE,403,0001,4030001,7615,2487,2074,413,48,176,120,288,2056,1759,297,38,115,77,188
439,TARRANT,439,2402,4392402,8156,93,40,53,13,31,13,39,88,39,49,13,28,12,35
439,TARRANT,439,3192,4393192,8279,1338,950,388,66,123,165,274,1110,809,301,50,95,129,215
121,DENTON,121,2068,1212068,2992,6944,3597,3347,241,1551,1445,2925,4732,2662,2070,136,945,900,1803
201,HARRIS,201,0072,2010072,4289,4588,350,4238,45,226,3999,4187,3505,319,3186,32,182,2984,3148
201,HARRIS,201,0735,2010735,4953,6374,2928,3446,454,755,2173,2878,4486,2235,2251,316,479,1395,1847
215,HIDALGO,215,0065,2150065,5617,4563,275,4288,369,60,3877,3908,3234,216,3018,286,39,2703,2728
261,KENEDY,261,0006,2610006,6281,26,2,24,2,1,21,21,16,2,14,2,0,11,11
263,KENT,263,0401,2630401,6287,177,142,35,3,4,27,29,149,121,28,2,4,21,23
29,BEXAR,29,1057,291057,307,5964,1041,4923,61,129,4721,4820,4155,873,3282,37,101,3123,3207
113,DALLAS,113,2020,1132020,2228,3300,2373,927,212,236,442,664,2803,2056,747,157,207,353,550
113,DALLAS,113,4660,1134660,2892,99,29,70,5,7,57,63,70,24,46,5,6,35,41
121,DENTON,121,3137,1213137,3061,4819,2101,2718,406,495,1748,2204,3662,1761,1901,309,376,1147,1503
143,ERATH,143,0046,1430046,3556,1637,1056,581,32,52,450,490,1261,872,389,21,33,291,322
157,FORT BEND,157,3107,1573107,3725,2328,1162,1166,880,93,168,255,2008,1033,975,742,76,132,205
439,TARRANT,439,3322,4393322,8302,2561,1948,613,128,101,327,421,2117,1676,441,109,73,214,281
453,TRAVIS,453,0433,4530433,8966,904,463,441,46,54,314,359,803,435,368,35,45,262,302
469,VICTORIA,469,0015,4690015,9135,173,93,80,2,7,66,71,140,82,58,0,4,50,53
493,WILSON,493,0206,4930206,9553,3897,1642,2255,50,86,2086,2153,2958,1372,1586,29,67,1457,1511
201,HARRIS,201,0835,2010835,5053,845,33,812,2,21,796,809,570,31,539,2,14,526,536
201,HARRIS,201,0172,2010172,4389,1543,121,1422,18,52,1344,1385,1160,110,1050,14,27,996,1022
201,HARRIS,201,0004,2010004,4220,2509,1752,757,152,110,448,546,2009,1416,593,110,94,347,429
339,MONTGOMERY,339,0075,3390075,6974,6728,4219,2509,514,696,1148,1801,5681,3780,1901,380,521,876,1374
407,SAN JACINTO,407,0005,4070005,7638,4167,2314,1853,23,105,1581,1674,2995,1821,1174,18,83,969,1041
439,TARRANT,439,4178,4394178,8471,5816,3222,2594,222,955,1318,2237,4733,2828,1905,186,684,963,1624
113,DALLAS,113,2408,1132408,2374,5635,983,4652,408,408,3819,4186,4202,896,3306,357,331,2598,2904
117,DEAF SMITH,117,0003,1170003,2915,4853,1875,2978,22,81,2843,2893,3549,1585,1964,17,54,1855,1891
121,DENTON,121,2114,1212114,3038,2744,1129,1615,1058,209,311,512,2198,943,1255,831,172,220,385
147,FANNIN,147,0011,1470011,3579,3739,2916,823,28,141,437,569,2804,2267,537,22,82,265,347
157,FORT BEND,157,3044,1573044,3702,6863,1140,5723,4801,565,354,894,4694,867,3827,3221,365,227,571
201,HARRIS,201,0027,2010027,4243,5791,1033,4758,145,341,4248,4531,4736,945,3791,109,273,3367,3607
453,TRAVIS,453,0464,4530464,8989,5669,1844,3825,305,414,3092,3451,4442,1646,2796,241,305,2201,2476
467,VAN ZANDT,467,003A,467003A,9112,1406,1045,361,17,158,153,308,1117,873,244,10,105,100,203
491,WILLIAMSON,491,0434,4910434,9530,1696,1144,552,6,72,435,498,1355,951,404,1,56,323,372
201,HARRIS,201,0689,2010689,4907,4463,671,3792,1116,329,2377,2671,3635,594,3041,962,264,1833,2070
201,HARRIS,201,0149,2010149,4366,5832,2486,3346,1277,827,1155,1959,3888,1756,2132,809,530,731,1255
423,SMITH,423,0071,4230071,7784,5343,4057,1286,405,432,333,757,4097,3176,921,290,313,237,545
439,TARRANT,439,4110,4394110,8448,2063,200,1863,15,23,1837,1850,1525,166,1359,8,17,1337,1348
439,TARRANT,439,3385,4393385,8325,3587,2807,780,285,79,303,373,2769,2208,561,209,66,194,254
453,TRAVIS,453,0320,4530320,8866,5122,3813,1309,560,70,562,628,3764,2878,886,373,56,391,443
25,BEE,25,0013,250013,184,2097,719,1378,9,25,1334,1351,1586,577,1009,7,11,984,991
29,BEXAR,29,1017,291017,267,498,105,393,9,29,361,377,421,98,323,8,23,295,310
29,BEXAR,29,2103,292103,516,563,6,557,1,7,549,555,395,2,393,0,5,387,392
113,DALLAS,113,3000,1133000,2437,5488,3969,1519,491,308,611,895,5260,3858,1402,463,256,561,801
113,DALLAS,113,4116,1134116,2769,0,0,0,0,0,0,0,0,0,0,0,0,0,0
127,DIMMIT,127,0005,1270005,3184,881,41,840,1,4,833,837,676,35,641,0,2,636,638
451,TOM GREEN,451,0112,4510112,8674,1469,991,478,15,10,435,442,1095,748,347,10,5,318,320
341,MOORE,341,0202,3410202,7014,2701,1292,1409,87,43,1209,1242,1878,1033,845,53,22,701,720
351,NEWTON,351,0014,3510014,7097,365,147,218,0,197,8,205,303,117,186,0,168,7,175
367,PARKER,367,0140,3670140,7346,1927,1608,319,22,20,201,219,1446,1239,207,15,15,115,130
439,TARRANT,439,4048,4394048,8425,2135,139,1996,26,123,1857,1958,1548,121,1427,12,85,1329,1403
439,TARRANT,439,2171,4392171,8093,4150,2694,1456,109,446,825,1226,3139,2195,944,75,251,522,765
439,TARRANT,439,3447,4393447,8342,0,0,0,0,0,0,0,0,0,0,0,0,0,0
141,EL PASO,141,0203,1410203,3516,11376,816,10560,217,482,9901,10291,7318,587,6731,141,308,6282,6553
157,FORT BEND,157,4066,1574066,3765,8243,587,7656,1544,3136,3051,6084,6387,495,5892,1298,2356,2271,4572
187,GUADALUPE,187,0213,1870213,4097,5320,2995,2325,112,241,1867,2081,3695,2169,1526,79,156,1208,1353
201,HARRIS,201,0295,2010295,4512,1420,27,1393,7,1103,280,1371,1066,24,1042,6,841,190,1025
201,HARRIS,201,0627,2010627,4844,8559,638,7921,2401,1841,3587,5366,6338,540,5798,1872,1314,2559,3832
321,MATAGORDA,321,001B,321001B,6765,6019,2568,3451,86,870,2491,3287,4472,2153,2319,76,544,1672,2178
29,BEXAR,29,4060,294060,871,3713,870,2843,149,739,1974,2630,2726,777,1949,115,523,1296,1787
41,BRAZOS,41,0012,410012,1203,6816,4129,2687,200,902,1467,2319,5324,3467,1857,152,607,987,1569
85,COLLIN,85,0121,850121,1750,4225,1144,3081,2569,211,225,427,3084,906,2178,1825,150,146,292
113,DALLAS,113,1109,1131109,2082,2264,139,2125,20,77,2038,2103,1462,128,1334,13,70,1257,1320
121,DENTON,121,3154,1213154,3078,3803,2952,851,294,166,316,471,2814,2242,572,206,113,206,311
141,EL PASO,141,0097,1410097,3410,3609,472,3137,73,167,2902,3031,2795,425,2370,56,113,2190,2287
373,POLK,373,0010,3730010,7406,3576,1750,1826,36,790,970,1744,2758,1475,1283,21,564,670,1224
419,SHELBY,419,0002,4190002,7701,1171,973,198,2,19,159,178,889,760,129,1,10,103,113
423,SMITH,423,0017,4230017,7738,2104,1725,379,23,78,163,238,1604,1349,255,16,58,99,156
439,TARRANT,439,1625,4391625,8033,0,0,0,0,0,0,0,0,0,0,0,0,0,0
457,TYLER,457,0004,4570004,9029,1735,1526,209,12,62,52,113,1355,1207,148,9,44,34,78
487,WILBARGER,487,0001A,4870001A,9361,3237,1840,1397,167,223,938,1136,2414,1508,906,110,135,600,731
167,GALVESTON,167,0225,1670225,3871,3715,2920,795,87,68,551,605,3348,2697,651,74,43,439,479
199,HARDIN,199,0006,1990006,4203,7447,6474,973,89,93,546,627,5464,4813,651,62,52,356,403
201,HARRIS,201,0981,2010981,5199,105,54,51,34,3,5,8,90,47,43,33,0,4,4
213,HENDERSON,213,002M,213002M,5531,1440,1125,315,64,65,125,188,1059,848,211,44,43,73,116
245,JEFFERSON,245,0050,2450050,6078,4559,257,4302,436,1786,2086,3832,3320,210,3110,347,1413,1333,2726
287,LEE,287,0101,2870101,6410,3596,1462,2134,24,449,1622,2034,2590,1196,1394,17,300,1030,1322
27,BELL,27,0310,270310,230,750,606,144,7,9,107,114,574,473,101,4,4,74,78
29,BEXAR,29,1063,291063,313,4227,734,3493,41,71,3357,3404,3002,624,2378,24,45,2268,2307
29,BEXAR,29,2149,292149,562,6206,1299,4907,1676,997,2260,3149,4643,1151,3492,1084,659,1729,2334
35,BOSQUE,35,0010,350010,1063,2218,1601,617,20,77,447,509,1658,1241,417,13,51,290,336
45,BRISCOE,45,0001,450001,1309,265,142,123,5,9,108,116,194,108,86,4,7,76,83
57,CALHOUN,57,0002,570002,1395,1038,441,597,32,22,537,551,773,360,413,22,14,371,380
255,KARNES,255,0012,2550012,6218,1537,450,1087,61,259,709,962,1364,418,946,57,243,592,832
309,MCLENNAN,309,0085,3090085,6719,1549,548,1001,16,507,460,950,1150,463,687,15,361,292,643
339,MONTGOMERY,339,0069,3390069,6968,5821,4150,1671,558,192,774,959,4340,3178,1162,373,137,538,671
347,NACOGDOCHES,347,0047,3470047,7051,1225,1145,80,0,6,21,27,1029,973,56,0,0,11,11
363,PALO PINTO,363,0012,3630012,7300,575,450,125,6,11,93,102,474,393,81,2,5,62,66
201,HARRIS,201,0673,2010673,4890,4248,2841,1407,74,77,1180,1249,3423,2421,1002,53,49,826,870
203,HARRISON,203,0008,2030008,5391,3899,2359,1540,85,826,565,1364,2960,1908,1052,71,576,332,904
215,HIDALGO,215,0171,2150171,5723,40,4,36,3,2,36,36,34,1,33,0,2,33,33
215,HIDALGO,215,0088,2150088,5640,6615,177,6438,8,34,6410,6422,4574,124,4450,6,18,4434,4438
225,HOUSTON,225,0010,2250010,5886,386,285,101,3,52,33,82,301,240,61,3,34,17,50
231,HUNT,231,0434,2310434,5972,1846,1479,367,19,42,228,266,1466,1219,247,11,28,154,179
71,CHAMBERS,71,0007,710007,1558,3875,2493,1382,36,171,1090,1251,2947,2026,921,34,125,701,816
85,COLLIN,85,0012,850012,1641,2786,2095,691,156,172,282,441,2097,1617,480,103,118,184,298
89,COLORADO,89,0302,890302,1890,1276,1122,154,13,27,100,126,1059,950,109,11,16,71,87
113,DALLAS,113,4066,1134066,2723,4196,102,4094,22,87,3985,4055,2895,93,2802,19,51,2725,2774
113,DALLAS,113,2511,1132511,2391,2840,1571,1269,418,373,457,811,2306,1324,982,336,288,321,596
201,HARRIS,201,0341,2010341,4558,3733,175,3558,27,804,2750,3520,2495,151,2344,7,396,1942,2323
29,BEXAR,29,4106,294106,917,1591,160,1431,40,304,1116,1377,1038,133,905,32,189,690,860
29,BEXAR,29,3104,293104,708,3463,1896,1567,134,235,1167,1374,2819,1642,1177,92,174,863,1026
29,BEXAR,29,4143,294143,954,5097,923,4174,250,1574,2460,3855,3477,690,2787,151,1004,1619,2559
29,BEXAR,29,1125,291125,376,3469,1027,2442,208,445,1848,2214,2417,778,1639,133,294,1232,1485
29,BEXAR,29,3018,293018,622,2180,1566,614,60,52,473,517,1690,1235,455,40,27,358,383
41,BRAZOS,41,0058,410058,1249,1350,935,415,155,92,150,240,1276,907,369,148,76,134,210
309,MCLENNAN,309,0027,3090027,6659,2762,456,2306,48,1302,981,2215,1802,389,1413,37,747,617,1343
339,MONTGOMERY,339,0012,3390012,6905,6338,2315,4023,74,113,3750,3836,4301,1761,2540,38,69,2374,2423
409,SAN PATRICIO,409,0111,4090111,7655,221,179,42,0,1,41,42,185,150,35,0,1,34,35
439,TARRANT,439,1455,4391455,7987,0,0,0,0,0,0,0,0,0,0,0,0,0,0
201,HARRIS,201,0487,2010487,4704,12011,545,11466,2595,2638,6158,8620,8570,448,8122,2157,1773,4127,5792
215,HIDALGO,215,0025,2150025,5577,6485,738,5747,60,48,5649,5667,4567,694,3873,39,20,3812,3823
245,JEFFERSON,245,0004,2450004,6032,2135,1510,625,65,332,211,532,1676,1226,450,44,248,137,380
273,KLEBERG,273,0021,2730021,6327,2790,786,2004,77,123,1798,1900,2109,656,1453,67,87,1280,1357
277,LAMAR,277,004GA,277004GA,6364,1165,930,235,24,30,85,113,920,773,147,20,20,40,59
303,LUBBOCK,303,0063,3030063,6573,424,203,221,1,17,200,217,294,151,143,0,10,129,139
85,COLLIN,85,0075,850075,1704,3567,2076,1491,701,310,421,718,3025,1850,1175,558,253,321,564
113,DALLAS,113,2040,1132040,2245,2236,1885,351,81,38,187,216,1628,1408,220,52,22,115,131
113,DALLAS,113,1055,1131055,2036,2542,245,2297,50,145,2082,2224,1829,234,1595,40,100,1439,1537
113,DALLAS,113,32C1,11332C1,2577,0,0,0,0,0,0,0,0,0,0,0,0,0,0
201,HARRIS,201,0818,2010818,5036,1734,389,1345,25,481,860,1320,1325,382,943,12,356,575,923
201,HARRIS,201,1027,2011027,5245,1065,410,655,20,173,452,609,713,307,406,18,117,252,368
1,ANDERSON,1,0023,10023,21,1689,1461,228,5,68,98,166,1395,1236,159,4,45,67,112
29,BEXAR,29,3162,293162,768,4881,1966,2915,417,406,2052,2416,4217,1816,2401,326,336,1698,2013
51,BURLESON,51,0410,510410,1349,2590,1900,690,25,216,327,538,2198,1682,516,17,154,240,391
53,BURNET,53,0006,530006,1355,717,624,93,8,10,61,70,603,537,66,6,8,38,46
77,CLAY,77,0011,770011,1604,1206,1042,164,8,5,111,115,976,864,112,4,3,68,71
113,DALLAS,113,4021,1134021,2683,4129,1738,2391,263,548,1538,2048,3683,1687,1996,233,476,1236,1682
471,WALKER,471,0405,4710405,9175,142,93,49,3,15,25,40,114,75,39,3,11,19,30
491,WILLIAMSON,491,0411,4910411,9513,5233,2477,2756,61,146,2492,2600,3755,2034,1721,40,92,1525,1605
301,LOVING,301,0001,3010001,6513,28,23,5,1,1,1,1,17,15,2,0,0,0,0
361,ORANGE,361,0005,3610005,7260,2354,984,1370,26,1133,182,1310,1855,833,1022,22,840,134,970
401,RUSK,401,0213,4010213,7598,2830,1996,834,20,363,352,708,2185,1625,560,13,264,203,465
437,SWISHER,437,0011,4370011,7841,500,250,250,9,24,211,233,392,216,176,6,18,146,163
439,TARRANT,439,1010,4391010,7847,1424,271,1153,19,423,704,1109,1087,242,845,12,337,478,805
453,TRAVIS,453,0384,4530384,8926,5701,2991,2710,1994,144,487,606,4245,2403,1842,1333,110,333,422
121,DENTON,121,1008,1211008,2932,5846,3598,2248,53,274,1673,1926,4464,2972,1492,39,167,1098,1258
201,HARRIS,201,0381,2010381,4598,7710,399,7311,160,1375,5876,7130,5005,312,4693,129,947,3642,4542
201,HARRIS,201,0132,2010132,4349,2885,37,2848,16,2320,543,2821,2234,31,2203,11,1881,330,2185
215,HIDALGO,215,0125,2150125,5677,2841,85,2756,16,21,2729,2740,1953,69,1884,15,10,1867,1871
227,HOWARD,227,034A,227034A,5926,49,38,11,0,2,8,10,34,27,7,0,0,6,6
227,HOWARD,227,208C,227208C,5932,225,162,63,2,4,51,55,156,121,35,1,1,27,28
15,AUSTIN,15,0412,150412,127,908,509,399,12,161,213,369,721,426,295,7,128,146,271
15,AUSTIN,15,0206,150206,121,1613,1362,251,5,45,136,180,1304,1121,183,4,32,93,125
29,BEXAR,29,3058,293058,662,6314,2109,4205,686,519,3010,3451,5554,1913,3641,544,452,2625,3016
29,BEXAR,29,3064,293064,668,564,268,296,16,15,266,273,444,229,215,13,5,193,197
61,CAMERON,61,0043,610043,1455,2729,195,2534,13,15,2497,2503,1917,144,1773,13,7,1744,1750
103,CRANE,103,0004,1030004,1996,1190,292,898,8,21,858,876,833,233,600,6,14,568,582
439,TARRANT,439,3212,4393212,8285,3742,1945,1797,226,941,522,1403,3010,1741,1269,176,610,377,955
453,TRAVIS,453,0254,4530254,8826,6575,2704,3871,1220,658,1963,2547,5409,2350,3059,994,525,1483,1965
501,YOAKUM,501,0406,5010406,9613,1112,282,830,19,18,785,801,786,230,556,16,12,522,533
303,LUBBOCK,303,0154,3030154,6613,6161,3599,2562,408,309,1750,2026,4200,2642,1558,278,175,1018,1185
305,LYNN,305,0004,3050004,6619,1317,974,343,4,13,311,320,887,668,219,2,3,202,204
355,NUECES,355,0045,3550045,7160,1275,104,1171,4,60,1115,1160,972,88,884,4,36,845,876
355,NUECES,355,0039,3550039,7154,1257,403,854,28,57,767,820,1063,374,689,24,47,614,659
439,TARRANT,439,4242,4394242,8488,1017,711,306,30,62,181,241,845,624,221,27,45,119,164
439,TARRANT,439,1301,4391301,7947,3587,340,3247,60,1729,1460,3164,2587,293,2294,49,1316,915,2222
113,DALLAS,113,2105,1132105,2291,3031,1756,1275,281,495,478,941,2850,1678,1172,264,444,429,855
157,FORT BEND,157,2059,1572059,3662,3216,131,3085,59,2340,732,3017,2522,114,2408,38,1875,509,2353
157,FORT BEND,157,1038,1571038,3619,12075,4262,7813,3546,1079,3045,4043,8055,3030,5025,2243,714,1983,2641
201,HARRIS,201,1067,2011067,5285,3717,529,3188,375,1888,907,2747,2753,468,2285,313,1259,678,1910
201,HARRIS,201,0772,2010772,4990,6199,4100,2099,934,291,779,1032,4681,3202,1479,665,212,520,710
219,HOCKLEY,219,0014,2190014,5826,1178,759,419,3,17,375,385,896,585,311,3,11,277,287
29,BEXAR,29,4003,294003,814,3002,236,2766,44,521,2268,2705,2216,183,2033,26,396,1628,1994
35,BOSQUE,35,0004,350004,1057,638,470,168,3,28,106,132,527,418,109,2,14,71,84
91,COMAL,91,0101,910101,1896,5422,3955,1467,82,134,1135,1247,4374,3341,1033,64,84,788,869
113,DALLAS,113,1326,1131326,2142,2438,913,1525,161,393,940,1317,1831,752,1079,137,271,635,904
121,DENTON,121,1054,1211054,2978,4555,2543,2012,148,890,849,1699,3013,1753,1260,97,559,513,1054
121,DENTON,121,1051,1211051,2975,916,434,482,57,258,159,410,668,352,316,35,165,103,266
443,TERRELL,443,0001,4430001,8634,186,70,116,3,7,104,110,155,67,88,1,3,79,82
477,WASHINGTON,477,0418,4770418,9221,874,515,359,12,135,199,330,686,438,248,8,92,141,233
491,WILLIAMSON,491,0312,4910312,9467,1193,900,293,19,35,226,252,1002,789,213,17,13,163,175
257,KAUFMAN,257,0003,2570003,6224,3861,2439,1422,99,473,747,1203,2878,1893,985,68,339,486,819
293,LIMESTONE,293,0203,2930203,6467,186,88,98,3,72,24,93,145,69,76,2,64,9,72
363,PALO PINTO,363,0018,3630018,7306,273,236,37,2,1,23,24,210,179,31,2,1,17,18
395,ROBERTSON,395,0023,3950023,7552,1396,384,1012,8,285,729,988,1009,311,698,6,182,501,676
439,TARRANT,439,2318,4392318,8139,2720,1605,1115,97,380,604,956,2208,1388,820,79,271,426,682
439,TARRANT,439,3654,4393654,8388,0,0,0,0,0,0,0,0,0,0,0,0,0,0
135,ECTOR,135,0207,1350207,3224,2996,1907,1089,29,70,927,979,2236,1552,684,17,34,570,603
185,GRIMES,185,0009,1850009,4057,414,282,132,5,63,53,107,313,213,100,5,50,33,78
201,HARRIS,201,0921,2010921,5139,417,219,198,18,30,138,166,321,192,129,11,22,84,106
201,HARRIS,201,0089,2010089,4306,1818,1217,601,293,86,200,279,1405,946,459,216,72,149,218
201,HARRIS,201,0086,2010086,4303,5906,3402,2504,680,444,1304,1711,5074,3003,2071,545,375,1060,1411
203,HARRISON,203,0002,2030002,5385,4487,1318,3169,27,2047,1064,3064,3461,1193,2268,17,1529,674,2181
29,BEXAR,29,1120,291120,370,409,18,391,7,48,350,381,255,12,243,4,24,222,240
113,DALLAS,113,2102,1132102,2288,6088,4361,1727,572,318,713,1010,5865,4241,1624,541,293,665,939
113,DALLAS,113,1061,1131061,2042,1690,1214,476,45,84,293,365,1438,1074,364,34,60,222,274
113,DALLAS,113,4536,1134536,2829,113,22,91,18,11,55,64,92,22,70,15,8,40,46
113,DALLAS,113,3307,1133307,2583,5504,1114,4390,82,1403,2881,4230,3695,935,2760,66,821,1823,2631
121,DENTON,121,4199,1214199,3124,67,64,3,0,1,2,3,54,53,1,0,1,0,1
439,TARRANT,439,2742,4392742,8239,1127,178,949,309,165,457,618,875,166,709,251,129,312,438
453,TRAVIS,453,0192,4530192,8780,4913,1925,2988,508,873,1609,2406,3702,1576,2126,390,587,1117,1663
463,UVALDE,463,0007,4630007,9075,772,358,414,7,5,389,392,592,311,281,0,2,266,268
485,WICHITA,485,0101,4850101,9321,388,336,52,6,6,27,31,294,263,31,3,3,11,14
201,HARRIS,201,0775,2010775,4993,4643,2651,1992,590,324,1022,1330,4166,2485,1681,469,279,867,1135
201,HARRIS,201,0481,2010481,4698,6990,3654,3336,425,934,1804,2692,5288,2974,2314,315,612,1256,1850
339,MONTGOMERY,339,0018,3390018,6911,6083,3546,2537,84,301,2028,2310,4393,2784,1609,49,202,1251,1452
379,RAINS,379,0203,3790203,7452,2072,1870,202,7,15,134,147,1656,1518,138,6,7,84,91
439,TARRANT,439,4485,4394485,8534,1686,276,1410,57,23,1304,1324,1125,240,885,37,15,809,824
439,TARRANT,439,1473,4391473,7993,382,73,309,7,6,293,298,260,59,201,6,4,189,192
141,EL PASO,141,0057,1410057,3370,3620,566,3054,99,273,2692,2891,2783,510,2273,90,197,1964,2124
157,FORT BEND,157,2070,1572070,3665,3355,597,2758,468,1097,1164,2236,2643,540,2103,403,802,855,1645
157,FORT BEND,157,1013,1571013,3616,5519,1488,4031,118,771,3161,3858,4035,1278,2757,99,490,2152,2615
167,GALVESTON,167,0434,1670434,3911,2594,497,2097,13,1504,579,2050,1840,389,1451,5,1073,352,1413
189,HALE,189,0306,1890306,4157,214,42,172,7,18,142,160,142,36,106,3,17,82,99
201,HARRIS,201,0235,2010235,4452,5623,283,5340,117,4330,945,5208,4535,259,4276,105,3529,666,4154
29,BEXAR,29,3165,293165,771,5752,2696,3056,629,352,2031,2324,4152,2049,2103,442,229,1378,1583
29,BEXAR,29,1023,291023,273,4531,119,4412,16,53,4333,4363,3381,96,3285,8,26,3231,3248
29,BEXAR,29,3001,293001,605,6129,2671,3458,569,490,2388,2804,4943,2335,2608,392,385,1794,2127
37,BOWIE,37,008A,37008A,1103,1267,485,782,10,573,176,746,955,369,586,8,454,109,562
41,BRAZOS,41,0078,410078,1269,416,214,202,0,21,168,188,297,168,129,0,7,110,117
85,COLLIN,85,0138,850138,1767,2654,1758,896,286,217,332,543,2202,1514,688,229,161,249,408
479,WEBB,479,0274,4790274,9261,4789,109,4680,30,16,4639,4641,3009,73,2936,29,16,2900,2902
491,WILLIAMSON,491,0209,4910209,9427,5252,4002,1250,154,163,770,894,3679,2930,749,93,95,451,528
215,HIDALGO,215,0128,2150128,5680,4932,84,4848,11,12,4818,4822,3448,55,3393,11,10,3370,3374
221,HOOD,221,0216,2210216,5846,3487,3167,320,47,28,166,194,3104,2850,254,34,18,132,150
275,KNOX,275,0302,2750302,6344,68,53,15,0,4,11,13,65,53,12,0,2,8,10
329,MIDLAND,329,0403,3290403,6842,5011,3372,1639,179,188,1155,1324,3622,2571,1051,129,117,711,818
453,TRAVIS,453,0386A,4530386A,8929,4163,1910,2253,1632,88,461,537,2943,1465,1478,1094,61,270,329
453,TRAVIS,453,0171,4530171,8763,5747,2231,3516,688,1212,1553,2702,4471,1893,2578,522,874,1103,1941
113,DALLAS,113,4110,1134110,2763,2095,17,2078,12,679,1408,2067,1499,11,1488,9,577,914,1478
113,DALLAS,113,2076,1132076,2265,12,7,5,1,5,0,5,11,6,5,1,5,0,5
201,HARRIS,201,0964,2010964,5182,4162,1236,2926,276,1487,1192,2630,2901,938,1963,189,1011,759,1755
201,HARRIS,201,1130,2011130,5348,1628,253,1375,176,188,1016,1194,1189,216,973,134,147,694,834
201,HARRIS,201,0467,2010467,4684,2776,123,2653,382,769,1526,2270,2093,102,1991,335,602,1059,1652
201,HARRIS,201,0633,2010633,4850,5486,2996,2490,629,670,1069,1718,4218,2448,1770,485,483,707,1179
27,BELL,27,0419,270419,250,1594,1048,546,49,173,288,433,1216,858,358,32,112,175,269
29,BEXAR,29,4103,294103,914,13,6,7,1,0,5,5,10,4,6,1,0,4,4
29,BEXAR,29,3142,293142,748,1254,410,844,121,162,573,716,1080,372,708,94,129,495,608
41,BRAZOS,41,0055,410055,1246,6453,3204,3249,713,969,1445,2375,5234,2750,2484,592,660,1118,1763
59,CALLAHAN,59,0008,590008,1412,1875,1540,335,7,62,210,262,1404,1189,215,4,29,133,161
85,COLLIN,85,0115,850115,1744,3993,2563,1430,514,382,464,837,3294,2182,1112,414,289,347,632
453,TRAVIS,453,0363,4530363,8906,4941,2857,2084,1314,178,525,692,3295,1998,1297,822,112,313,418
491,WILLIAMSON,491,0163,4910163,9404,6119,1933,4186,814,1362,2003,3242,4327,1589,2738,545,844,1303,2092
497,WISE,497,0005,4970005,9570,3119,2279,840,16,40,638,672,2330,1790,540,8,25,397,419
355,NUECES,355,0082,3550082,7197,1253,165,1088,17,69,992,1056,1001,148,853,14,58,773,829
367,PARKER,367,0310,3670310,7363,3201,2489,712,56,130,452,573,2634,2110,524,47,108,303,404
417,SHACKELFORD,417,0303,4170303,7695,426,374,52,2,7,36,40,334,305,29,1,3,19,20
423,SMITH,423,0023,4230023,7744,3636,2095,1541,91,620,783,1374,2843,1770,1073,69,412,545,951
439,TARRANT,439,1184,4391184,7910,2522,837,1685,77,453,1159,1575,1839,735,1104,54,312,727,1020
439,TARRANT,439,3732,4393732,8408,2691,2027,664,79,62,458,504,2035,1607,428,49,30,278,306
91,COMAL,91,0204,910204,1910,5032,3292,1740,99,84,1458,1526,4006,2733,1273,66,58,1050,1098
201,HARRIS,201,0987,2010987,5205,2036,68,1968,20,784,1179,1947,1501,48,1453,15,631,813,1433
215,HIDALGO,215,0151,2150151,5703,5222,631,4591,263,81,4257,4312,3945,532,3413,181,58,3155,3203
251,JOHNSON,251,0042,2510042,6201,5951,2676,3275,62,529,2539,3026,4187,2093,2094,21,355,1574,1916
309,MCLENNAN,309,0066,3090066,6699,1980,1603,377,7,47,236,275,1563,1324,239,3,27,151,176
331,MILAM,331,0318,3310318,6865,3828,2408,1420,33,325,1015,1295,2912,1977,935,22,211,646,838
5,ANGELINA,5,0031,50031,58,705,379,326,2,31,287,315,515,288,227,2,23,195,218
29,BEXAR,29,4080,294080,891,4549,835,3714,94,888,2778,3579,3303,713,2590,72,599,1896,2476
113,DALLAS,113,3040,1133040,2477,3943,128,3815,18,2451,1355,3768,2639,102,2537,11,1635,881,2502
113,DALLAS,113,4517,1134517,2812,5155,2222,2933,206,933,1699,2580,4193,2028,2165,157,705,1189,1872
113,DALLAS,113,1329,1131329,2145,24,11,13,0,4,10,13,19,11,8,0,2,7,8
121,DENTON,121,4215,1214215,3141,4497,3048,1449,497,320,502,800,3041,2145,896,318,192,297,483
491,WILLIAMSON,491,0491,4910491,9547,6210,3036,3174,449,865,1735,2548,4470,2299,2171,333,581,1139,1698
309,MCLENNAN,309,0088,3090088,6722,1477,571,906,5,279,598,863,1046,440,606,4,191,394,578
349,NAVARRO,349,0104,3490104,7054,1441,765,676,5,67,568,628,1066,614,452,0,47,370,416
397,ROCKWALL,397,0003,3970003,7555,2625,1533,1092,166,381,520,872,1762,1080,682,114,204,314,518
421,SHERMAN,421,0202,4210202,7718,202,137,65,3,4,55,59,142,99,43,3,4,33,37
439,TARRANT,439,1105,4391105,7887,2007,1202,805,77,320,395,699,1691,1086,605,56,245,282,517
439,TARRANT,439,4534,4394534,8551,6959,3976,2983,241,779,1806,2521,5155,3098,2057,189,531,1206,1701
141,EL PASO,141,0163,1410163,3476,4951,106,4845,22,30,4798,4817,3812,71,3741,11,18,3712,3723
161,FREESTONE,161,0006B,1610006B,3808,31,24,7,0,1,6,7,28,22,6,0,1,5,6
187,GUADALUPE,187,0415,1870415,4137,8057,3499,4558,457,1293,2790,3926,5538,2571,2967,292,820,1760,2525
201,HARRIS,201,0255,2010255,4472,3557,1951,1606,304,643,590,1212,2863,1606,1257,225,528,436,951
209,HAYS,209,0316,2090316,5468,3545,1789,1756,112,176,1460,1611,2909,1608,1301,86,143,1054,1190
245,JEFFERSON,245,0030,2450030,6058,1661,1402,259,17,53,138,189,1284,1111,173,10,30,88,118
9,ARCHER,9,0007,90007,81,292,239,53,4,1,26,27,224,194,30,1,1,15,16
29,BEXAR,29,2001,292001,413,2369,188,2181,57,191,1982,2123,1451,139,1312,32,103,1191,1273
29,BEXAR,29,2123,292123,536,3195,1024,2171,170,201,1816,1973,2253,777,1476,118,122,1219,1328
37,BOWIE,37,001A,37001A,1077,3155,376,2779,15,2294,449,2719,2172,306,1866,11,1537,286,1812
39,BRAZORIA,39,0013,390013,1126,6515,2896,3619,519,1078,1950,2991,4704,2190,2514,382,772,1297,2050
113,DALLAS,113,4147,1134147,2786,113,4,109,3,5,99,104,80,2,78,2,4,69,73
453,TRAVIS,453,0137,4530137,8737,5604,1514,4090,476,789,2847,3561,4325,1353,2972,383,601,1996,2552
463,UVALDE,463,0001,4630001,9069,1857,429,1428,6,26,1403,1411,1373,379,994,5,12,977,983
303,LUBBOCK,303,0022,3030022,6536,4598,2358,2240,78,399,1689,2023,3409,1982,1427,54,243,1046,1266
349,NAVARRO,349,0402,3490402,7077,3466,2092,1374,41,524,690,1192,2739,1799,940,32,361,455,805
391,REFUGIO,391,003A,391003A,7532,918,463,455,2,68,389,441,718,401,317,1,47,266,309
439,TARRANT,439,4456,4394456,8528,1467,1139,328,41,84,165,247,1178,938,240,29,54,120,173
439,TARRANT,439,2027,4392027,8073,1507,325,1182,188,260,731,977,1051,272,779,148,165,466,627
439,TARRANT,439,2546,4392546,8196,417,52,365,11,199,165,352,338,52,286,10,165,119,274
113,DALLAS,113,1176,1131176,2122,0,0,0,0,0,0,0,0,0,0,0,0,0,0
121,DENTON,121,4193,1214193,3118,6709,4916,1793,107,234,1244,1442,4790,3742,1048,71,126,700,812
165,GAINES,165,0002,1650002,3831,4359,2646,1713,38,55,1563,1602,2876,1735,1141,23,31,1036,1063
201,HARRIS,201,0610,2010610,4827,9688,941,8747,257,315,8173,8435,6596,789,5807,199,201,5385,5557
209,HAYS,209,0422,2090422,5491,3045,1578,1467,82,166,1189,1321,2392,1316,1076,58,124,845,953
217,HILL,217,0012,2170012,5823,2628,1862,766,12,340,319,655,1975,1459,516,9,245,181,426
29,BEXAR,29,2024,292024,436,4262,299,3963,46,194,3760,3898,2986,254,2732,42,116,2587,2677
61,CAMERON,61,0026,610026,1438,3334,531,2803,20,28,2751,2761,2502,492,2010,15,13,1973,1978
93,COMANCHE,93,0004,930004,1936,134,108,26,0,1,21,22,102,94,8,0,0,6,6
113,DALLAS,113,1142,1131142,2102,4745,3248,1497,264,385,797,1159,3087,2163,924,151,242,493,724
113,DALLAS,113,3500,1133500,2600,5132,2401,2731,1606,460,558,1000,3690,1766,1924,1160,307,378,680
449,TITUS,449,0001,4490001,8652,1489,141,1348,13,404,925,1318,1025,104,921,8,328,576,899
491,WILLIAMSON,491,0149,4910149,9399,5588,2374,3214,367,1199,1650,2752,4352,2025,2327,289,819,1201,1960
201,HARRIS,201,0107,2010107,4324,5752,267,5485,45,1271,4202,5429,4026,229,3797,34,829,2934,3748
201,HARRIS,201,0022,2010022,4238,5700,405,5295,157,3307,1847,5084,4033,344,3689,130,2302,1256,3518
201,HARRIS,201,1102,2011102,5320,6081,2299,3782,494,1004,2258,3164,4546,1819,2727,356,700,1615,2265
201,HARRIS,201,0853,2010853,5071,3478,2163,1315,294,325,621,924,2624,1710,914,219,219,407,612
365,PANOLA,365,0005,3650005,7321,741,553,188,4,69,92,158,546,422,124,2,53,51,104
397,ROCKWALL,397,003AA,397003AA,7570,4734,3177,1557,127,201,1078,1265,3383,2387,996,88,135,663,791
29,BEXAR,29,4118,294118,929,117,58,59,2,6,50,55,90,47,43,2,5,35,39
29,BEXAR,29,1052,291052,302,3632,371,3261,34,65,3170,3200,2641,317,2324,28,34,2250,2276
29,BEXAR,29,1101,291101,351,1,0,1,1,0,1,1,1,0,1,1,0,1,1
29,BEXAR,29,1137,291137,388,0,0,0,0,0,0,0,0,0,0,0,0,0,0
55,CALDWELL,55,0301,550301,1384,2001,842,1159,10,49,1053,1089,1527,716,811,6,36,730,756
91,COMAL,91,0308,910308,1925,3938,2312,1626,43,78,1436,1505,3252,2007,1245,35,65,1084,1143
439,TARRANT,439,1382,4391382,7962,5902,1235,4667,358,3324,1035,4249,4698,1093,3605,280,2577,753,3268
455,TRINITY,455,0002,4550002,9007,1205,1052,153,7,21,72,92,1029,909,120,4,11,53,64
459,UPSHUR,459,0002,4590002,9044,4114,3437,677,27,124,319,439,3080,2654,426,21,74,171,243
497,WISE,497,0020,4970020,9585,1775,1487,288,7,23,181,201,1351,1170,181,6,13,104,117
201,HARRIS,201,0462,2010462,4679,4283,1138,3145,476,1077,1575,2610,3479,1025,2454,421,898,1113,1981
201,HARRIS,201,0499,2010499,4716,3137,2184,953,338,147,415,544,2566,1801,765,286,114,328,432
265,KERR,265,0404,2650404,6302,1213,1005,208,7,11,158,168,989,842,147,6,2,114,116
273,KLEBERG,273,0044,2730044,6339,1008,206,802,27,45,732,773,810,175,635,20,35,578,612
369,PARMER,369,0301,3690301,7384,2353,1314,1039,6,16,1009,1018,1750,1050,700,5,12,674,683
439,TARRANT,439,1241,4391241,7925,1282,257,1025,199,570,248,803,849,202,647,118,350,161,508
99,CORYELL,99,0102,990102,1974,2053,1689,364,18,42,213,250,1624,1384,240,13,16,145,157
111,DALLAM,111,0002,1110002,2011,119,77,42,1,1,35,35,79,56,23,0,0,20,20
121,DENTON,121,3132,1213132,3056,4717,2320,2397,568,770,971,1723,3751,1926,1825,437,583,729,1303
149,FAYETTE,149,201E,149201E,3597,2015,1315,700,16,192,453,638,1544,1081,463,13,123,294,412
157,FORT BEND,157,1146,1571146,3634,13078,4847,8231,4104,1231,2741,3892,8191,3130,5061,2499,737,1705,2409
201,HARRIS,201,1039,2011039,5257,0,0,0,0,0,0,0,0,0,0,0,0,0,0
29,BEXAR,29,3180,293180,786,1546,727,819,60,83,672,739,1290,642,648,47,54,529,578
29,BEXAR,29,4224,294224,1035,0,0,0,0,0,0,0,0,0,0,0,0,0,0
29,BEXAR,29,2124,292124,537,838,275,563,42,52,468,506,685,243,442,38,32,369,396
41,BRAZOS,41,0092,410092,1284,0,0,0,0,0,0,0,0,0,0,0,0,0,0
113,DALLAS,113,4041,1134041,2701,1369,30,1339,6,354,981,1327,1014,28,986,4,317,666,978
121,DENTON,121,1026,1211026,2950,4927,4368,559,155,129,187,306,4831,4348,483,141,105,157,256
345,MOTLEY,345,0003,3450003,7029,24,19,5,0,1,5,5,21,17,4,0,0,4,4
361,ORANGE,361,0023,3610023,7278,4223,3684,539,77,44,285,317,3028,2688,340,58,24,159,178
391,REFUGIO,391,0003,3910003,7527,762,367,395,3,46,342,379,596,315,281,1,36,241,272
423,SMITH,423,0055,4230055,7776,4026,1728,2298,238,1434,533,1946,3275,1515,1760,181,1107,396,1493
473,WALLER,473,0418,4730418,9193,4471,2774,1697,253,458,932,1346,2945,1876,1069,156,279,577,838
491,WILLIAMSON,491,0258,4910258,9442,278,133,145,44,24,55,78,184,87,97,28,15,37,51
131,DUVAL,131,0008,1310008,3199,2526,328,2198,30,27,2070,2082,1817,272,1545,24,16,1442,1448
141,EL PASO,141,0135,1410135,3448,4088,116,3972,27,37,3914,3940,3174,84,3090,22,16,3058,3067
201,HARRIS,201,0896,2010896,5114,2440,1612,828,276,186,341,513,2269,1531,738,248,166,297,456
201,HARRIS,201,0648,2010648,4865,4841,2550,2291,676,668,884,1520,3726,2081,1645,514,475,606,1055
201,HARRIS,201,1145,2011145,5363,6339,3434,2905,664,316,1787,2087,4207,2410,1797,410,192,1091,1282
215,HIDALGO,215,0060,2150060,5612,8272,333,7939,38,17,7846,7857,5506,262,5244,24,12,5175,5181
29,BEXAR,29,3033,293033,637,3184,1718,1466,215,157,1046,1187,2653,1558,1095,161,119,778,885
39,BRAZORIA,39,0065,390065,1178,4235,2158,2077,184,673,1158,1791,3244,1804,1440,128,477,767,1227
39,BRAZORIA,39,0022,390022,1135,5193,3635,1558,135,233,1082,1283,4018,2951,1067,90,162,714,862
85,COLLIN,85,0047,850047,1676,3658,1861,1797,309,381,1056,1411,2974,1639,1335,236,291,759,1029
113,DALLAS,113,4506,1134506,2801,3509,662,2847,105,388,2339,2669,2579,593,1986,73,254,1605,1839
139,ELLIS,139,1045,1391045,3299,188,153,35,5,3,26,29,146,122,24,5,0,18,18
479,WEBB,479,0416,4790416,9293,2310,58,2252,2,14,2240,2244,1636,42,1594,2,10,1586,1589
479,WEBB,479,0453,4790453,9299,1131,22,1109,0,1,1108,1108,827,14,813,0,1,812,812
209,HAYS,209,0252,2090252,5463,4740,1476,3264,159,348,2739,3032,3443,1156,2287,111,262,1867,2101
241,JASPER,241,0001,2410001,6004,66,54,12,1,5,0,5,54,47,7,1,1,0,1
355,NUECES,355,0020,3550020,7135,5480,752,4728,143,348,4268,4536,4048,616,3432,108,238,3056,3276
355,NUECES,355,0014,3550014,7129,695,185,510,12,18,471,486,461,146,315,8,12,290,299
411,SAN SABA,411,0001,4110001,7670,1402,801,601,8,11,564,570,1100,680,420,8,10,389,394
411,SAN SABA,411,004B,411004B,7676,164,155,9,0,2,7,7,143,134,9,0,2,7,7
141,EL PASO,141,0029,1410029,3342,4771,677,4094,159,195,3770,3933,3885,600,3285,136,159,3005,3142
167,GALVESTON,167,0143,1670143,3840,5323,1599,3724,42,1186,2488,3575,3752,1266,2486,32,741,1667,2367
201,HARRIS,201,0747,2010747,4965,6080,1474,4606,241,1965,2371,4257,4317,1218,3099,175,1317,1556,2836
201,HARRIS,201,0753,2010753,4971,813,174,639,54,347,264,582,578,136,442,32,240,184,407
209,HAYS,209,0450A,2090450A,5512,1580,1259,321,42,26,207,232,1189,963,226,26,21,139,159
209,HAYS,209,0443,2090443,5506,3830,2829,1001,275,98,569,654,2464,1865,599,174,61,321,377
27,BELL,27,0410,270410,245,8598,1933,6665,323,3331,3090,6110,6391,1667,4724,247,2367,2093,4282
29,BEXAR,29,2081,292081,494,1437,175,1262,47,104,1106,1203,1105,165,940,31,73,818,889
49,BROWN,49,0215,490215,1327,304,275,29,0,10,9,19,269,244,25,0,8,8,16
73,CHEROKEE,73,0024,730024,1576,3443,2176,1267,39,779,388,1155,2631,1702,929,36,581,265,841
113,DALLAS,113,2608,1132608,2409,4400,1759,2641,1686,359,517,863,3450,1478,1972,1282,269,356,618
113,DALLAS,113,3981,1133981,2658,2254,1382,872,280,182,343,515,1820,1176,644,200,135,243,373
315,MARION,315,0004,3150004,6737,555,369,186,3,164,9,171,446,311,135,0,123,4,127
339,MONTGOMERY,339,0086,3390086,6986,4048,2752,1296,71,251,855,1098,3087,2194,893,59,171,572,736
431,STERLING,431,0002A,4310002A,7819,249,118,131,9,3,122,124,183,88,95,3,1,90,91
439,TARRANT,439,1821,4391821,8068,0,0,0,0,0,0,0,0,0,0,0,0,0,0
453,TRAVIS,453,0357,4530357,8901,4935,2931,2004,385,216,1319,1503,3942,2451,1491,299,182,942,1102
469,VICTORIA,469,0030,4690030,9150,820,313,507,10,52,434,479,631,261,370,6,34,318,349
141,EL PASO,141,0178,1410178,3491,1975,269,1706,28,105,1599,1671,1478,243,1235,18,77,1146,1207
157,FORT BEND,157,3138,1573138,3740,750,65,685,393,202,86,279,573,48,525,303,152,58,208
201,HARRIS,201,0605,2010605,4822,4077,384,3693,48,1000,2673,3620,2915,330,2585,40,754,1817,2531
201,HARRIS,201,0356,2010356,4573,6761,2668,4093,531,1386,2162,3459,5133,2180,2953,443,973,1507,2429
215,HIDALGO,215,0103,2150103,5655,4912,580,4332,60,34,4236,4262,3755,519,3236,44,21,3164,3179
227,HOWARD,227,0025,2270025,5904,1727,1016,711,52,61,544,595,1281,822,459,39,40,338,373
29,BEXAR,29,4075,294075,886,1037,109,928,20,72,844,899,791,90,701,10,53,640,681
29,BEXAR,29,1095,291095,345,881,460,421,69,162,193,323,637,343,294,54,109,119,211
61,CAMERON,61,0015,610015,1427,3389,258,3131,19,19,3093,3099,2606,214,2392,19,18,2357,2363
97,COOKE,97,001C,97001C,1968,7301,4283,3018,145,518,2161,2618,5341,3478,1863,106,318,1285,1584
113,DALLAS,113,3072,1133072,2509,170,8,162,1,71,92,158,120,8,112,1,53,62,110
121,DENTON,121,3126,1213126,3050,4820,1707,3113,577,1324,1171,2444,3731,1466,2265,452,952,803,1730
491,WILLIAMSON,491,0486,4910486,9542,1756,840,916,388,173,361,516,1360,747,613,265,121,220,332
497,WISE,497,0028,4970028,9591,3282,1897,1385,41,46,1190,1234,2304,1446,858,27,25,728,753
329,MIDLAND,329,0308,3290308,6837,6056,1047,5009,90,1476,3463,4869,4455,818,3637,75,1130,2425,3531
367,PARKER,367,0440,3670440,7378,5368,4580,788,79,102,443,537,3720,3237,483,39,61,266,323
439,TARRANT,439,4130,4394130,8460,3068,2595,473,132,94,187,271,2286,1977,309,89,66,117,180
439,TARRANT,439,1208,4391208,7919,2649,2038,611,118,127,280,396,2055,1638,417,87,96,176,267
453,TRAVIS,453,0482,4530482,9001,4671,1071,3600,30,774,2796,3547,3977,1017,2960,17,752,2184,2919
459,UPSHUR,459,0008,4590008,9050,1441,1100,341,2,135,169,297,1116,867,249,1,107,108,211
149,FAYETTE,149,0315,1490315,3591,736,597,139,1,9,117,126,618,523,95,0,9,75,84
187,GUADALUPE,187,0409,1870409,4132,4184,1491,2693,343,1180,1237,2317,2869,1089,1780,234,797,753,1513
201,HARRIS,201,0456,2010456,4673,9852,3071,6781,309,2479,3984,6321,7281,2584,4697,252,1743,2639,4316
201,HARRIS,201,0996,2010996,5214,1080,371,709,85,158,468,621,831,317,514,58,126,331,456
215,HIDALGO,215,0203,2150203,5755,8173,698,7475,525,165,6806,6931,5629,500,5129,383,98,4647,4734
265,KERR,265,0215,2650215,6296,4513,3066,1447,70,42,1202,1237,3612,2608,1004,46,30,814,841
29,BEXAR,29,3108,293108,712,1889,1096,793,64,124,590,694,1506,916,590,40,92,432,514
31,BLANCO,31,0302,310302,1044,1796,1425,371,20,8,275,279,1468,1176,292,19,5,215,219
55,CALDWELL,55,0111,550111,1376,3188,1410,1778,29,412,1337,1724,2648,1277,1371,17,333,1001,1326
85,COLLIN,85,0079,850079,1708,6200,2200,4000,1629,985,1371,2284,5151,1865,3286,1477,784,984,1729
113,DALLAS,113,4046,1134046,2704,3118,36,3082,13,554,2520,3059,2131,30,2101,11,458,1632,2085
113,DALLAS,113,1059,1131059,2040,2455,1409,1046,44,123,802,919,1936,1176,760,35,96,564,657
491,WILLIAMSON,491,0468,4910468,9534,1719,752,967,132,381,439,794,1433,660,773,111,300,346,630
231,HUNT,231,0213,2310213,5953,1519,1186,333,10,26,233,257,1131,909,222,6,17,143,159
263,KENT,263,0301,2630301,6285,88,71,17,1,3,15,16,66,54,12,1,3,10,11
305,LYNN,305,0002,3050002,6617,797,429,368,5,9,330,336,603,334,269,1,3,245,248
339,MONTGOMERY,339,0051,3390051,6949,6783,2305,4478,154,1444,2844,4203,4984,1937,3047,121,932,1934,2835
453,TRAVIS,453,0324,4530324,8870,3810,2851,959,219,64,561,612,2754,2161,593,128,37,340,370
475,WARD,475,004M,475004M,9202,420,226,194,4,14,161,170,298,173,125,2,4,106,109
113,DALLAS,113,2406,1132406,2372,5804,2323,3481,765,1289,1340,2578,4867,2127,2740,642,999,1002,1969
121,DENTON,121,2112,1212112,3036,2520,1186,1334,609,260,419,663,2028,1017,1011,478,184,302,481
201,HARRIS,201,0408,2010408,4625,4498,303,4195,77,48,4064,4091,3112,265,2847,61,36,2740,2763
201,HARRIS,201,1071,2011071,5289,6026,1497,4529,98,1731,2687,4304,4243,1222,3021,71,1094,1800,2847
201,HARRIS,201,0739,2010739,4957,5706,1195,4511,89,1720,2715,4335,4101,979,3122,83,1175,1861,2973
215,HIDALGO,215,0069,2150069,5621,18067,797,17270,18,604,16644,17184,12303,675,11628,13,575,11049,11581
57,CALHOUN,57,0006,570006,1399,719,225,494,10,21,457,476,560,190,370,10,18,337,354
85,COLLIN,85,0102,850102,1731,2942,2352,590,149,114,223,331,2314,1900,414,107,75,143,217
113,DALLAS,113,4070,1134070,2727,3376,215,3161,12,141,3014,3141,2537,180,2357,9,105,2245,2343
113,DALLAS,113,1090,1131090,2063,5681,357,5324,28,1133,4151,5250,4024,328,3696,21,859,2791,3637
113,DALLAS,113,2515,1132515,2395,1113,700,413,71,82,242,319,888,581,307,61,58,169,224
121,DENTON,121,3135,1213135,3059,10410,3373,7037,1423,1246,4283,5445,7652,2818,4834,959,885,2884,3737
201,HARRIS,201,1048,2011048,5266,1086,451,635,238,194,206,391,766,318,448,174,141,138,274
215,HIDALGO,215,0046,2150046,5598,791,38,753,3,6,737,740,537,37,500,2,3,491,491
227,HOWARD,227,0409,2270409,5930,877,603,274,5,10,228,235,649,470,179,5,2,143,145
259,KENDALL,259,1110,2591110,6262,2959,2142,817,48,26,681,701,2371,1808,563,39,16,453,466
493,WILSON,493,0313,4930313,9557,5577,3486,2091,61,133,1760,1874,4148,2727,1421,45,78,1173,1247
141,EL PASO,141,0078,1410078,3391,1879,92,1787,22,17,1747,1756,1609,84,1525,19,16,1487,1496
157,FORT BEND,157,3102,1573102,3723,3467,596,2871,2602,116,135,251,2691,480,2211,1993,84,114,198
169,GARZA,169,0005,1690005,3938,166,129,37,2,0,33,33,131,104,27,2,0,23,23
201,HARRIS,201,0716,2010716,4934,4556,2582,1974,85,295,1495,1769,3433,2058,1375,67,198,1004,1195
201,HARRIS,201,0385,2010385,4602,2696,2020,676,337,57,246,297,2137,1654,483,234,37,176,209
201,HARRIS,201,0053,2010053,4270,3100,1801,1299,310,252,703,941,2731,1610,1121,267,220,609,820
21,BASTROP,21,3020,213020,165,10083,1594,8489,57,264,8093,8318,6833,1335,5498,41,194,5191,5364
29,BEXAR,29,2084,292084,497,4320,1954,2366,171,242,1941,2145,3483,1696,1787,121,163,1449,1601
113,DALLAS,113,4094,1134094,2750,930,175,755,29,65,648,705,724,156,568,27,48,479,524
113,DALLAS,113,1114,1131114,2086,2242,95,2147,53,1096,991,2071,1628,95,1533,34,866,620,1479
113,DALLAS,113,2802,1132802,2418,6820,3377,3443,1812,243,1272,1488,4930,2645,2285,1240,151,794,939
121,DENTON,121,3158,1213158,3082,4759,3331,1428,279,294,731,999,3823,2797,1026,218,200,498,685
471,WALKER,471,0101,4710101,9156,2534,858,1676,24,931,722,1636,2235,797,1438,23,804,610,1402
491,WILLIAMSON,491,0367,4910367,9488,203,80,123,25,11,85,95,159,60,99,18,9,67,76
355,NUECES,355,0049,3550049,7164,1864,733,1131,16,68,1028,1078,1422,628,794,10,46,713,751
385,REAL,385,0003,3850003,7496,680,415,265,7,12,232,241,555,361,194,3,6,168,172
433,STONEWALL,433,0003,4330003,7828,296,239,57,1,9,46,52,252,213,39,1,7,32,36
439,TARRANT,439,4250,4394250,8492,7477,3369,4108,656,1708,1639,3241,5942,2962,2980,499,1207,1141,2312
439,TARRANT,439,2413,4392413,8160,1380,166,1214,141,466,609,1056,992,127,865,103,338,420,744
453,TRAVIS,453,0252,4530252,8824,5523,659,4864,584,702,3571,4235,3812,579,3233,479,502,2238,2723
201,HARRIS,201,1025,2011025,5243,1343,438,905,125,371,415,769,904,315,589,82,256,249,497
201,HARRIS,201,0193,2010193,4410,1532,177,1355,38,1084,254,1305,1248,155,1093,32,866,205,1050
201,HARRIS,201,0031,2010031,4247,5059,111,4948,42,4350,646,4878,3460,94,3366,33,2988,392,3316
201,HARRIS,201,0693,2010693,4911,1343,237,1106,67,540,518,1036,1012,206,806,46,403,363,751
201,HARRIS,201,0362,2010362,4579,8134,4532,3602,682,598,2191,2727,6071,3576,2495,496,397,1473,1831
215,HIDALGO,215,0023,2150023,5575,4324,553,3771,10,29,3728,3738,3056,517,2539,5,15,2512,2518
137,EDWARDS,137,0001,1370001,3251,353,88,265,3,1,255,256,286,79,207,2,1,199,200
141,EL PASO,141,0101,1410101,3414,3575,486,3089,54,155,2898,3021,2838,428,2410,44,117,2256,2356
147,FANNIN,147,0016,1470016,3583,444,398,46,8,10,10,20,352,325,27,4,5,3,8
157,FORT BEND,157,3158,1573158,3746,4096,502,3594,3187,173,233,399,2899,371,2528,2245,119,159,277
167,GALVESTON,167,0439,1670439,3915,5612,3350,2262,157,539,1466,1969,4273,2774,1499,108,356,937,1278
187,GUADALUPE,187,0123,1870123,4078,4,0,4,0,1,3,3,3,0,3,0,1,2,2
113,DALLAS,113,4120,1134120,2773,5397,102,5295,30,176,5080,5226,3766,88,3678,19,141,3516,3635
113,DALLAS,113,4664,1134664,2896,2456,695,1761,493,311,931,1226,2071,597,1474,408,245,801,1039
113,DALLAS,113,3201,1133201,2564,2721,825,1896,50,724,1094,1785,2108,759,1349,38,542,723,1250
121,DENTON,121,4180,1214180,3105,1790,1188,602,193,170,208,366,1405,977,428,146,123,129,245
135,ECTOR,135,0302,1350302,3228,2096,597,1499,20,106,1360,1451,1498,502,996,12,52,908,958
141,EL PASO,141,0124,1410124,3437,6219,378,5841,83,155,5640,5751,4588,285,4303,45,104,4156,4236
439,TARRANT,439,4371,4394371,8515,3321,2624,697,122,85,362,438,2582,2111,471,90,43,238,277
453,TRAVIS,453,0290,4530290,8847,5848,4606,1242,614,61,464,516,4226,3449,777,387,37,273,307
473,WALLER,473,0104,4730104,9179,1430,572,858,14,168,661,820,1020,462,558,7,132,402,530
491,WILLIAMSON,491,0409,4910409,9511,520,347,173,4,12,156,164,415,290,125,4,4,113,117
201,HARRIS,201,0008,2010008,4224,2960,1327,1633,137,259,1195,1427,2349,1141,1208,97,191,875,1053
201,HARRIS,201,0879,2010879,5097,5957,1324,4633,758,1105,2791,3813,4308,1018,3290,586,723,1969,2647
201,HARRIS,201,0548,2010548,4765,5225,1087,4138,403,1173,2534,3649,3894,952,2942,325,835,1727,2533
201,HARRIS,201,0671,2010671,4888,5588,1831,3757,664,941,2109,2998,4351,1573,2778,542,672,1508,2148
209,HAYS,209,0103,2090103,5429,0,0,0,0,0,0,0,0,0,0,0,0,0,0
439,TARRANT,439,2506,4392506,8183,6832,4141,2691,218,1087,1221,2269,5262,3422,1840,142,741,808,1537
145,FALLS,145,0103,1450103,3560,925,714,211,5,54,119,173,762,609,153,2,38,84,122
157,FORT BEND,157,4073A,1574073A,3769,2586,820,1766,41,382,1364,1712,1909,741,1168,27,244,899,1134
167,GALVESTON,167,0371,1670371,3892,4599,2470,2129,552,549,880,1404,3616,2003,1613,439,419,628,1032
187,GUADALUPE,187,0217,1870217,4101,342,86,256,0,23,226,249,253,77,176,0,19,150,169
201,HARRIS,201,0339,2010339,4556,4260,344,3916,57,427,3451,3834,3197,298,2899,42,269,2584,2836
201,HARRIS,201,0216,2010216,4433,3892,109,3783,32,1317,2449,3729,2874,94,2780,20,1052,1710,2743
27,BELL,27,0207,270207,211,6975,1871,5104,537,2845,1830,4418,5516,1658,3858,453,2053,1357,3279
29,BEXAR,29,4064,294064,875,3831,1071,2760,118,574,2104,2605,2938,935,2003,93,415,1500,1882
67,CASS,67,0018,670018,1539,759,681,78,4,37,19,54,586,523,63,3,29,16,43
85,COLLIN,85,0248,850248,1877,3598,1542,2056,1156,502,350,835,2559,1171,1388,775,341,226,560
113,DALLAS,113,30T6,11330T6,2541,0,0,0,0,0,0,0,0,0,0,0,0,0,0
133,EASTLAND,133,0005,1330005,3205,1160,718,442,4,12,394,401,879,562,317,2,6,283,288
291,LIBERTY,291,0022,2910022,6454,7270,2809,4461,89,509,3733,4214,5131,2175,2956,68,361,2410,2761
355,NUECES,355,0003,3550003,7118,5044,1720,3324,280,246,2755,2962,3958,1435,2523,217,190,2061,2236
419,SHELBY,419,0006,4190006,7705,762,627,135,4,77,46,120,610,527,83,1,51,21,71
423,SMITH,423,0061,4230061,7782,4391,2142,2249,79,903,1202,2058,3470,1846,1624,63,671,810,1461
439,TARRANT,439,3566,4393566,8369,0,0,0,0,0,0,0,0,0,0,0,0,0,0
457,TYLER,457,0008,4570008,9033,240,217,23,0,10,5,15,190,172,18,0,8,2,10
167,GALVESTON,167,0223,1670223,3869,6093,2690,3403,217,1339,1808,3075,4653,2262,2391,169,864,1285,2121
187,GUADALUPE,187,0310,1870310,4124,3382,1495,1887,119,329,1398,1671,2523,1219,1304,81,218,962,1154
201,HARRIS,201,0571,2010571,4788,4684,265,4419,22,126,4307,4381,3214,224,2990,11,87,2915,2968
209,HAYS,209,0216,2090216,5452,401,81,320,2,12,312,316,271,71,200,2,6,194,196
215,HIDALGO,215,0238,2150238,5790,324,15,309,0,5,309,309,192,6,186,0,1,186,186
245,JEFFERSON,245,0088,2450088,6116,2050,631,1419,148,966,287,1232,1639,564,1075,110,725,218,925
25,BEE,25,0019,250019,188,1022,140,882,8,28,836,859,720,108,612,8,21,582,599
29,BEXAR,29,4041,294041,852,3580,282,3298,25,1540,1769,3245,2625,213,2412,17,1211,1199,2374
29,BEXAR,29,1061,291061,311,6261,316,5945,59,202,5742,5877,4308,248,4060,40,134,3916,4023
39,BRAZORIA,39,0077,390077,1190,7807,4344,3463,176,468,2734,3140,6034,3605,2429,129,320,1881,2165
85,COLLIN,85,0225,850225,1854,6520,2071,4449,2645,1191,538,1681,4394,1480,2914,1747,759,350,1088
113,DALLAS,113,3081,1133081,2518,1836,1428,408,165,46,162,208,1813,1413,400,163,45,156,201
455,TRINITY,455,0005,4550005,9010,780,437,343,14,129,196,323,605,367,238,11,104,119,223
455,TRINITY,455,0011,4550011,9016,2211,1839,372,16,85,186,269,1896,1627,269,13,53,132,184
341,MOORE,341,0402,3410402,7018,3211,137,3074,354,391,2347,2718,2185,91,2094,192,308,1590,1893
355,NUECES,355,0026,3550026,7141,6851,2643,4208,813,348,2997,3298,4972,2040,2932,581,221,2066,2263
415,SCURRY,415,0006,4150006,7682,494,397,97,1,5,85,90,379,318,61,1,0,54,54
427,STARR,427,0008,4270008,7805,7296,106,7190,20,19,7144,7153,5053,73,4980,11,14,4952,4960
439,TARRANT,439,4162,4394162,8469,1948,310,1638,140,109,1387,1486,1317,252,1065,113,46,903,941
439,TARRANT,439,3471,4393471,8346,2303,1835,468,140,76,196,262,1705,1411,294,84,50,117,164
127,DIMMIT,127,0003,1270003,3182,544,45,499,2,7,492,497,395,40,355,2,3,353,354
201,HARRIS,201,0594,2010594,4811,3711,556,3155,91,1161,1884,3008,2821,510,2311,81,881,1324,2182
209,HAYS,209,0332,2090332,5475,4662,2790,1872,298,235,1254,1443,3970,2432,1538,261,186,1002,1155
249,JIM WELLS,249,0002,2490002,6139,882,368,514,1,11,482,492,649,283,366,0,10,340,350
293,LIMESTONE,293,0402,2930402,6477,622,567,55,3,9,30,38,510,472,38,1,7,19,25
327,MENARD,327,0002,3270002,6803,485,284,201,2,9,183,191,383,246,137,2,5,122,127
29,BEXAR,29,4187,294187,998,0,0,0,0,0,0,0,0,0,0,0,0,0,0
29,BEXAR,29,1084,291084,334,4461,428,4033,87,269,3692,3916,3270,355,2915,60,197,2653,2824
29,BEXAR,29,2090,292090,503,4807,1045,3762,337,625,2841,3385,3688,881,2807,248,447,2097,2514
39,BRAZORIA,39,0054,390054,1167,4374,1416,2958,681,1174,1093,2210,3314,1138,2176,543,884,721,1582
73,CHEROKEE,73,0036,730036,1585,2391,1685,706,6,140,512,642,1916,1452,464,5,95,318,412
85,COLLIN,85,0202,850202,1831,0,0,0,0,0,0,0,0,0,0,0,0,0,0
339,MONTGOMERY,339,0095,3390095,6995,8349,4280,4069,809,1131,2055,3096,6440,3526,2914,569,808,1427,2199
383,REAGAN,383,0002,3830002,7490,861,340,521,4,16,503,515,630,281,349,2,8,337,345
409,SAN PATRICIO,409,0115,4090115,7659,7962,4198,3764,131,280,3209,3437,6196,3597,2599,99,171,2179,2339
439,TARRANT,439,3372,4393372,8323,6546,3883,2663,750,657,1128,1733,4447,2681,1766,542,402,702,1086
209,HAYS,209,0430,2090430,5498,2040,1424,616,59,46,435,474,1577,1170,407,36,27,282,305
215,HIDALGO,215,0192,2150192,5744,1262,52,1210,3,2,1207,1208,855,48,807,2,2,805,806
251,JOHNSON,251,0004,2510004,6162,6122,4700,1422,137,219,887,1079,4639,3708,931,87,131,559,682
273,KLEBERG,273,0031,2730031,6331,2965,757,2208,124,120,1931,2024,2276,642,1634,96,85,1427,1499
285,LAVACA,285,0416,2850416,6408,1041,883,158,3,30,102,131,854,748,106,3,17,67,84
329,MIDLAND,329,0206,3290206,6826,2716,1978,738,51,120,530,631,2033,1533,500,32,84,351,423
113,DALLAS,113,3058,1133058,2495,2890,43,2847,10,1975,866,2824,2238,39,2199,8,1644,546,2179
113,DALLAS,113,2044,1132044,2249,2143,1076,1067,386,256,390,631,1712,879,833,341,199,265,456
117,DEAF SMITH,117,0001,1170001,2913,4514,755,3759,22,56,3673,3702,3089,602,2487,18,32,2422,2437
147,FANNIN,147,0009,1470009,3577,1219,1037,182,6,24,88,110,1022,885,137,6,16,66,82
201,HARRIS,201,0199,2010199,4416,4760,3172,1588,176,300,1012,1274,3678,2601,1077,128,193,668,847
201,HARRIS,201,0862,2010862,5080,6626,2585,4041,1257,1175,1585,2680,4816,1958,2858,936,812,1056,1825
27,BELL,27,0314,270314,234,6576,3097,3479,194,1030,2192,3146,5208,2725,2483,159,740,1516,2218
29,BEXAR,29,4210,294210,1021,36,11,25,0,7,19,22,23,8,15,0,3,11,12
29,BEXAR,29,4087,294087,898,3094,964,2130,189,1236,763,1898,2350,750,1600,132,970,520,1431
29,BEXAR,29,1107,291107,357,6767,1057,5710,42,109,5497,5572,4840,866,3974,33,61,3824,3869
29,BEXAR,29,2067,292067,480,361,64,297,14,5,276,279,326,58,268,11,5,250,253
39,BRAZORIA,39,0031,390031,1144,2007,1221,786,17,86,637,710,1530,996,534,15,57,420,472
339,MONTGOMERY,339,0073,3390073,6972,3002,1832,1170,136,370,597,953,2250,1413,837,115,269,406,668
351,NEWTON,351,0012,3510012,7095,442,372,70,2,43,8,50,322,279,43,2,23,4,27
387,RED RIVER,387,13-4,38713-4,7513,709,634,75,6,18,29,46,551,492,59,4,12,21,33
407,SAN JACINTO,407,0003,4070003,7636,1105,833,272,5,190,55,240,907,693,214,4,150,36,186
439,TARRANT,439,2467,4392467,8177,5153,1665,3488,243,2307,940,3158,4265,1523,2742,214,1759,757,2449
215,HIDALGO,215,0215,2150215,5767,3427,255,3172,240,42,2879,2916,2519,194,2325,195,38,2077,2114
215,HIDALGO,215,0092,2150092,5644,1626,55,1571,2,12,1556,1561,978,38,940,1,4,935,936
251,JOHNSON,251,0026,2510026,6185,2336,1848,488,31,59,302,353,1676,1380,296,17,44,172,215
267,KIMBLE,267,0001,2670001,6308,943,686,257,11,6,232,237,727,542,185,9,6,164,169
289,LEON,289,0007,2890007,6431,725,594,131,5,27,85,108,557,485,72,2,11,47,58
329,MIDLAND,329,0410,3290410,6849,2416,1699,717,89,52,499,542,1631,1207,424,58,23,289,311
71,CHAMBERS,71,0011,710011,1562,3547,1945,1602,57,368,1142,1477,2653,1600,1053,44,250,718,958
85,COLLIN,85,0179,850179,1808,5328,4432,896,317,76,357,428,4314,3721,593,200,50,212,261
85,COLLIN,85,0056,850056,1685,5895,3083,2812,647,553,1479,2014,4049,2283,1766,444,353,868,1214
113,DALLAS,113,2018,1132018,2226,1201,923,278,143,34,88,115,874,688,186,91,31,52,77
113,DALLAS,113,2225,1132225,2349,2328,1846,482,204,42,179,220,1698,1408,290,114,24,111,135
201,HARRIS,201,0885,2010885,5103,5026,1988,3038,287,1186,1458,2615,3607,1506,2101,203,840,981,1809
15,AUSTIN,15,0310,150310,125,4389,2518,1871,99,409,1294,1667,3272,2038,1234,63,256,841,1089
29,BEXAR,29,1123,291123,374,1340,300,1040,27,20,991,1006,960,251,709,14,15,670,681
29,BEXAR,29,2045,292045,457,1497,411,1086,20,27,1034,1054,1239,357,882,15,22,840,857
29,BEXAR,29,3102,293102,706,4481,2440,2041,167,284,1521,1777,3503,2022,1481,123,187,1106,1283
113,DALLAS,113,3702,1133702,2627,0,0,0,0,0,0,0,0,0,0,0,0,0,0
141,EL PASO,141,0061,1410061,3374,2540,411,2129,93,200,1869,2002,1875,358,1517,66,134,1319,1416
439,TARRANT,439,3200,4393200,8283,3877,2349,1528,308,515,611,1094,3125,2031,1094,224,361,427,771
479,WEBB,479,0361,4790361,9279,3473,98,3375,19,23,3335,3339,2556,78,2478,14,14,2457,2458
333,MILLS,333,0008,3330008,6872,805,703,102,1,7,65,72,672,602,70,1,2,50,52
339,MONTGOMERY,339,0057,3390057,6955,4257,3237,1020,40,132,687,811,3424,2724,700,24,80,452,529
355,NUECES,355,0089,3550089,7204,1139,272,867,17,25,818,834,874,230,644,17,13,600,612
439,TARRANT,439,4480,4394480,8532,1366,1087,279,59,44,162,205,961,766,195,48,31,100,131
439,TARRANT,439,1345,4391345,7951,841,392,449,33,169,219,381,616,287,329,27,129,152,277
439,TARRANT,439,2557,4392557,8200,2424,481,1943,356,1037,542,1538,1684,354,1330,261,684,360,1023
157,FORT BEND,157,3049,1573049,3706,5470,904,4566,2065,1879,630,2479,4356,763,3593,1660,1459,465,1910
157,FORT BEND,157,1063,1571063,3623,4241,2947,1294,173,289,737,1015,3332,2387,945,133,207,520,726
173,GLASSCOCK,173,0003,1730003,3955,273,185,88,0,8,81,86,222,159,63,0,4,58,62
201,HARRIS,201,0733,2010733,4951,1985,92,1893,14,414,1477,1860,1277,79,1198,12,273,912,1173
201,HARRIS,201,0816,2010816,5034,135,17,118,2,9,112,115,98,14,84,0,3,81,81
201,HARRIS,201,0485,2010485,4702,7816,4118,3698,678,917,2025,2880,5705,3175,2530,460,637,1354,1954
5,ANGELINA,5,0039,50039,65,885,551,334,17,216,91,304,758,488,270,14,175,67,242
35,BOSQUE,35,0008,350008,1061,3457,2428,1029,37,134,764,877,2723,2078,645,20,79,480,549
55,CALDWELL,55,0405,550405,1393,959,429,530,2,76,416,486,724,365,359,1,60,265,325
93,COMANCHE,93,0009,930009,1940,306,216,90,0,5,81,84,246,176,70,0,2,65,66
121,DENTON,121,1012,1211012,2936,1254,684,570,59,186,305,486,934,530,404,47,129,210,338
139,ELLIS,139,1014,1391014,3268,2499,1935,564,25,105,361,458,1972,1610,362,10,74,215,286
477,WASHINGTON,477,0410,4770410,9219,1519,1144,375,15,156,168,323,1216,951,265,7,118,106,224
259,KENDALL,259,3030,2593030,6268,2822,2230,592,34,28,433,454,2248,1840,408,24,22,282,299
361,ORANGE,361,0009,3610009,7264,3172,2770,402,28,91,190,271,2461,2179,282,23,52,114,165
397,ROCKWALL,397,001BA,397001BA,7559,6426,4823,1603,332,343,769,1097,4465,3446,1019,203,208,480,685
401,RUSK,401,0201,4010201,7596,3750,1838,1912,16,842,1027,1861,3295,1646,1649,14,723,898,1615
439,TARRANT,439,1111,4391111,7891,4837,3602,1235,182,211,727,911,3479,2673,806,128,124,452,568
453,TRAVIS,453,0344,4530344,8887,4286,2678,1608,618,134,761,884,3065,1971,1094,412,81,529,607
185,GRIMES,185,0015,1850015,4061,2187,1587,600,13,70,424,487,1705,1299,406,11,50,261,308
201,HARRIS,201,0047,2010047,4264,3058,131,2927,18,1309,1630,2896,2261,104,2157,12,1052,1096,2132
201,HARRIS,201,0176,2010176,4393,1745,1046,699,379,73,232,300,1299,787,512,289,45,158,201
203,HARRISON,203,0006,2030006,5389,2095,1638,457,12,303,108,403,1594,1248,346,7,234,73,304
215,HIDALGO,215,0169,2150169,5721,771,20,751,3,7,740,745,582,13,569,2,3,565,566
229,HUDSPETH,229,001W,229001W,5936,262,15,247,1,3,244,245,182,15,167,0,1,165,166
29,BEXAR,29,4193,294193,1004,217,37,180,10,48,126,163,155,29,126,4,34,85,115
105,CROCKETT,105,0004,1050004,2000,737,132,605,5,11,586,594,559,104,455,2,10,439,447
113,DALLAS,113,2148,1132148,2332,1452,584,868,84,299,458,747,1230,538,692,77,234,349,578
141,EL PASO,141,0015,1410015,3328,3608,1149,2459,283,130,2052,2153,2705,931,1774,210,90,1488,1556
201,HARRIS,201,0779,2010779,4997,4363,218,4145,20,68,4065,4114,2927,178,2749,15,43,2680,2721
201,HARRIS,201,1111,2011111,5329,6196,1465,4731,453,1143,3086,4151,4646,1211,3435,342,815,2234,3007
491,WILLIAMSON,491,0181,4910181,9411,3146,1407,1739,614,325,758,1052,2277,1065,1212,440,218,516,710
497,WISE,497,0009,4970009,9574,3285,2744,541,33,46,323,362,2480,2105,375,28,23,218,239
273,KLEBERG,273,0013,2730013,6325,1114,103,1011,17,38,975,992,818,83,735,16,18,711,720
309,MCLENNAN,309,0025,3090025,6657,4433,874,3559,62,525,2992,3453,3177,776,2401,44,338,1995,2315
439,TARRANT,439,3390,4393390,8329,5176,3667,1509,834,144,368,506,3914,2915,999,563,92,216,305
439,TARRANT,439,4650,4394650,8578,5584,2561,3023,428,1041,1478,2472,3782,1879,1903,267,638,891,1511
439,TARRANT,439,2755,4392755,8246,0,0,0,0,0,0,0,0,0,0,0,0,0,0
485,WICHITA,485,0105,4850105,9325,1311,1090,221,9,14,88,102,1018,853,165,3,6,69,75
1,ANDERSON,1,0021,10021,19,2772,2104,668,38,212,374,575,2169,1717,452,32,140,235,372
113,DALLAS,113,4025,1134025,2687,885,16,869,9,182,675,855,625,14,611,4,148,453,601
121,DENTON,121,2095,1212095,3019,3707,1861,1846,1335,175,269,434,2684,1400,1284,942,136,162,293
141,EL PASO,141,0001,1410001,3314,3872,287,3585,32,51,3507,3536,2704,244,2460,20,39,2401,2424
181,GRAYSON,181,0310,1810310,4015,358,250,108,27,14,34,48,273,206,67,10,13,22,35
201,HARRIS,201,0093,2010093,4310,9665,771,8894,85,375,8444,8754,6808,671,6137,69,226,5829,6028
453,TRAVIS,453,0437,4530437,8970,6516,2785,3731,179,375,3071,3386,5501,2520,2981,145,313,2407,2687
479,WEBB,479,0308,4790308,9265,1711,74,1637,20,11,1608,1613,1275,58,1217,17,5,1193,1197
201,HARRIS,201,0425,2010425,4642,3528,338,3190,236,605,2375,2934,2533,303,2230,207,441,1591,2011
201,HARRIS,201,0130,2010130,4347,3092,2075,1017,341,228,449,638,2569,1754,815,284,185,342,498
215,HIDALGO,215,0086,2150086,5638,928,163,765,12,6,747,752,749,154,595,11,1,583,584
407,SAN JACINTO,407,0009,4070009,7642,706,628,78,2,6,61,66,558,504,54,2,3,43,45
443,TERRELL,443,0004A,4430004A,8638,112,53,59,0,2,56,58,77,46,31,0,1,29,30
453,TRAVIS,453,0122,4530122,8724,6764,865,5899,76,742,5060,5766,4507,750,3757,58,510,3148,3648
29,BEXAR,29,4147,294147,958,484,237,247,35,35,185,211,398,211,187,31,28,132,158
41,BRAZOS,41,0016,410016,1207,3296,341,2955,41,577,2334,2890,2331,299,2032,34,399,1581,1977
69,CASTRO,69,0105,690105,1545,515,64,451,0,17,428,442,351,51,300,0,10,282,292
85,COLLIN,85,0165,850165,1794,1194,664,530,294,103,113,208,875,533,342,203,58,74,130
113,DALLAS,113,4633,1134633,2873,5358,505,4853,3405,885,562,1411,3900,447,3453,2406,637,412,1031
121,DENTON,121,4197,1214197,3122,1889,1600,289,36,20,152,170,1315,1146,169,19,11,81,92
379,RAINS,379,0101,3790101,7450,1932,1635,297,14,35,171,205,1558,1349,209,11,21,110,131
417,SHACKELFORD,417,0406A,4170406A,7699,422,337,85,7,10,66,73,324,275,49,6,6,38,42
439,TARRANT,439,1639,4391639,8037,2546,333,2213,115,1151,943,2073,1652,258,1394,83,719,595,1306
453,TRAVIS,453,0201,4530201,8784,4653,3973,680,182,59,367,418,3567,3067,500,121,43,274,316
487,WILBARGER,487,0021,4870021,9365,3805,2334,1471,260,373,744,1100,3078,1983,1095,188,324,514,831
199,HARDIN,199,0010,1990010,4207,3229,1599,1630,24,1378,182,1552,2409,1213,1196,16,1032,118,1147
201,HARRIS,201,0239,2010239,4456,2658,37,2621,13,1774,866,2608,2050,33,2017,10,1426,605,2007
213,HENDERSON,213,003N,213003N,5535,1628,1208,420,17,58,300,357,1265,998,267,15,38,180,218
215,HIDALGO,215,0232,2150232,5784,4412,88,4324,12,9,4311,4312,2758,55,2703,9,4,2697,2698
245,JEFFERSON,245,0094,2450094,6122,2621,1696,925,250,365,277,636,2069,1378,691,201,270,190,459
277,LAMAR,277,3H3C,2773H3C,6371,2049,1340,709,22,425,197,620,1604,1138,466,17,284,115,397
29,BEXAR,29,4047,294047,858,5755,1039,4716,217,978,3576,4431,4115,919,3196,135,553,2503,2996
29,BEXAR,29,1067,291067,317,6224,1348,4876,88,137,4645,4733,4572,1147,3425,54,78,3253,3309
29,BEXAR,29,2107,292107,520,6399,1688,4711,423,680,3712,4261,4286,1215,3071,267,408,2398,2764
85,COLLIN,85,0016,850016,1645,6289,3949,2340,449,861,875,1695,4236,2781,1455,291,524,518,1023
113,DALLAS,113,3044,1133044,2481,5506,105,5401,39,3042,2343,5343,3764,74,3690,34,2201,1474,3647
113,DALLAS,113,1728,1131728,2186,3317,807,2510,91,309,2068,2358,2427,694,1733,80,228,1395,1606
329,MIDLAND,329,0101,3290101,6809,1898,892,1006,27,86,830,906,1386,698,688,20,51,564,614
341,MOORE,341,0101,3410101,7012,5327,1550,3777,230,113,3345,3439,3690,1227,2463,112,83,2197,2272
367,PARKER,367,0215,3670215,7350,5262,4248,1014,41,67,637,701,3897,3229,668,25,46,401,446
439,TARRANT,439,2316,4392316,8137,3163,1404,1759,337,866,543,1357,2707,1285,1422,288,682,422,1078
451,TOM GREEN,451,0144,4510144,8678,3582,1210,2372,133,267,1962,2183,2521,889,1632,87,148,1366,1505
491,WILLIAMSON,491,0319,4910319,9471,259,160,99,31,27,38,64,180,117,63,14,16,28,44
141,EL PASO,141,0207,1410207,3520,4343,69,4274,13,29,4243,4256,3072,52,3020,10,26,3001,3014
161,FREESTONE,161,0006C,1610006C,3809,0,0,0,0,0,0,0,0,0,0,0,0,0,0
201,HARRIS,201,0925,2010925,5143,0,0,0,0,0,0,0,0,0,0,0,0,0,0
201,HARRIS,201,0631,2010631,4848,5317,2186,3131,571,967,1583,2482,3980,1820,2160,417,669,1054,1686
215,HIDALGO,215,0132,2150132,5684,1473,39,1434,1,7,1427,1427,1125,30,1095,0,6,1090,1090
293,LIMESTONE,293,0301,2930301,6471,2381,1347,1034,70,420,519,926,1840,1061,779,65,305,380,682
21,BASTROP,21,4026,214026,171,3622,1397,2225,36,723,1435,2114,2619,1148,1471,24,492,904,1382
29,BEXAR,29,2008,292008,420,2202,103,2099,13,52,2040,2082,1712,95,1617,5,44,1570,1608
29,BEXAR,29,3062,293062,666,81,20,61,3,6,55,56,67,20,47,1,2,44,44
41,BRAZOS,41,0062,410062,1253,2353,943,1410,218,396,744,1112,1824,848,976,186,266,468,722
61,CAMERON,61,0087,610087,1499,4048,470,3578,33,35,3503,3519,2968,428,2540,25,21,2488,2497
85,COLLIN,85,0119,850119,1748,3073,1508,1565,1173,136,202,338,2396,1220,1176,876,110,143,253
339,MONTGOMERY,339,0016,3390016,6909,7708,4763,2945,63,111,2487,2587,5495,3651,1844,43,69,1516,1576
355,NUECES,355,0043,3550043,7158,1320,131,1189,12,107,1082,1169,941,105,836,7,70,757,822
423,SMITH,423,0024,4230024,7745,2895,2238,657,31,184,388,561,2271,1827,444,21,133,243,373
201,HARRIS,201,1080,2011080,5298,2555,326,2229,212,549,1459,1984,1783,269,1514,170,367,962,1314
201,HARRIS,201,0660,2010660,4877,6543,218,6325,593,3078,2646,5671,4713,166,4547,480,2349,1716,4035
21,BASTROP,21,2012,212012,157,2021,1441,580,36,76,407,473,1655,1214,441,28,62,294,351
29,BEXAR,29,4010,294010,821,5196,331,4865,52,1423,3521,4798,3612,289,3323,29,1072,2255,3275
29,BEXAR,29,3051,293051,655,416,309,107,12,4,85,88,360,277,83,8,2,67,69
29,BEXAR,29,3094,293094,698,7017,3102,3915,663,496,2755,3182,5884,2762,3122,517,395,2176,2535
41,BRAZOS,41,0005,410005,1196,2591,1747,844,16,110,642,747,1955,1419,536,10,70,398,465
49,BROWN,49,0101,490101,1319,3482,2548,934,43,151,701,820,2717,2078,639,34,91,467,553
485,WICHITA,485,0404,4850404,9354,3776,2706,1070,308,223,463,667,2928,2196,732,226,137,300,432
491,WILLIAMSON,491,0332,4910332,9477,4801,2771,2030,1113,211,592,775,3003,1818,1185,646,126,323,438
309,MCLENNAN,309,0017,3090017,6649,1665,722,943,22,384,504,875,1274,632,642,17,290,305,591
355,NUECES,355,0032,3550032,7147,4148,1319,2829,215,286,2267,2514,3310,1176,2134,169,216,1687,1883
363,PALO PINTO,363,0026,3630026,7313,287,183,104,9,24,65,85,194,136,58,8,4,39,43
427,STARR,427,0014,4270014,7811,4751,81,4670,5,12,4655,4659,3335,56,3279,3,7,3268,3271
453,TRAVIS,453,0238,4530238,8813,4793,3383,1410,371,209,776,956,3888,2852,1036,262,156,563,702
481,WHARTON,481,0301,4810301,9311,3599,2311,1288,13,112,1134,1229,2826,1917,909,9,78,794,865
53,BURNET,53,0013,530013,1362,1948,1254,694,25,16,588,601,1459,1005,454,19,6,374,379
85,COLLIN,85,0231,850231,1860,5308,2852,2456,494,1015,885,1856,4001,2219,1782,376,741,608,1317
113,DALLAS,113,4622,1134622,2862,3982,867,3115,438,598,2072,2617,2970,787,2183,318,419,1425,1823
141,EL PASO,141,0047,1410047,3360,3674,838,2836,196,407,2268,2603,2816,769,2047,150,260,1607,1852
141,EL PASO,141,0211B,1410211B,3526,0,0,0,0,0,0,0,0,0,0,0,0,0,0
181,GRAYSON,181,0409,1810409,4024,3358,2554,804,67,234,368,583,2651,2107,544,47,165,218,379
29,BEXAR,29,2093,292093,506,4101,996,3105,335,600,2228,2762,2975,799,2176,219,401,1562,1940
29,BEXAR,29,3074,293074,678,3122,1733,1389,138,108,1130,1216,2602,1543,1059,90,93,850,926
51,BURLESON,51,0203,510203,1339,562,395,167,7,47,112,157,444,329,115,3,38,73,111
61,CAMERON,61,0099,610099,1511,1089,66,1023,7,6,1009,1013,748,54,694,5,4,686,688
113,DALLAS,113,4008,1134008,2670,7387,170,7217,48,184,6994,7148,4781,131,4650,33,138,4488,4604
113,DALLAS,113,3317,1133317,2593,4054,695,3359,116,1492,1719,3170,2809,595,2214,86,1037,1050,2067
485,WICHITA,485,0205,4850205,9334,6238,4873,1365,158,329,643,949,4634,3773,861,93,180,375,550
317,MARTIN,317,004A,317004A,6749,341,243,98,0,4,93,97,240,171,69,0,4,64,68
355,NUECES,355,0055,3550055,7170,1317,68,1249,2,12,1230,1240,1011,54,957,2,11,943,952
439,TARRANT,439,1504,4391504,8003,3220,2340,880,52,143,598,725,2525,1934,591,24,86,392,473
439,TARRANT,439,2055,4392055,8080,2690,1605,1085,173,472,418,861,2232,1421,811,134,358,281,628
449,TITUS,449,0020,4490020,8670,2339,1060,1279,72,264,902,1153,1724,871,853,59,185,571,752
471,WALKER,471,0203,4710203,9162,2765,1834,931,13,594,254,841,2215,1507,708,4,471,182,649
141,EL PASO,141,0190,1410190,3503,188,2,186,0,0,186,186,172,2,170,0,0,170,170
167,GALVESTON,167,0483,1670483,3924,5975,3149,2826,381,941,1448,2319,4357,2460,1897,277,612,922,1509
201,HARRIS,201,0368,2010368,4585,2143,203,1940,38,728,1191,1893,1496,176,1320,27,498,805,1286
201,HARRIS,201,0540,2010540,4757,4132,2232,1900,1010,374,487,845,3773,2103,1670,870,325,446,759
227,HOWARD,227,0103,2270103,5916,321,157,164,11,30,113,137,257,132,125,9,20,86,103
245,JEFFERSON,245,0060,2450060,6088,5944,3666,2278,228,279,1672,1929,4319,2864,1455,151,157,1044,1195
29,BEXAR,29,2116,292116,529,0,0,0,0,0,0,0,0,0,0,0,0,0,0
61,CAMERON,61,0076,610076,1488,7051,401,6650,46,32,6582,6592,5094,345,4749,44,17,4684,4693
113,DALLAS,113,4031,1134031,2693,4496,137,4359,57,1606,2702,4280,3152,122,3030,46,1282,1698,2966
113,DALLAS,113,1407,1131407,2152,63,4,59,1,10,49,57,31,4,27,1,4,24,26
113,DALLAS,113,1047,1131047,2029,2899,838,2061,25,174,1830,1980,2208,720,1488,18,112,1317,1423
113,DALLAS,113,3207,1133207,2570,5350,1100,4250,71,1661,2515,4120,3754,976,2778,56,1088,1598,2662
439,TARRANT,439,1436,4391436,7980,2500,606,1894,124,1157,625,1728,1739,486,1253,96,773,383,1134
439,TARRANT,439,4399,4394399,8521,343,248,95,16,21,51,72,290,216,74,11,15,44,59
439,TARRANT,439,2220,4392220,8103,3381,2228,1153,374,332,383,694,2647,1843,804,276,234,244,473
445,TERRY,445,0301,4450301,8644,2833,675,2158,36,161,1973,2092,2025,525,1500,26,104,1350,1445
473,WALLER,473,0210,4730210,9185,835,316,519,19,31,450,481,601,261,340,16,23,285,308
135,ECTOR,135,0308,1350308,3234,1931,686,1245,56,113,1057,1148,1355,527,828,33,67,699,756
201,HARRIS,201,0517,2010517,4734,6760,1210,5550,455,674,4386,4976,4862,1035,3827,332,468,2984,3407
201,HARRIS,201,1057,2011057,5275,26,0,26,0,2,24,26,18,0,18,0,2,16,18
203,HARRISON,203,0015,2030015,5398,1570,1415,155,6,35,80,110,1152,1062,90,3,20,34,54
229,HUDSPETH,229,004S,229004S,5939,67,30,37,3,0,32,32,57,29,28,3,0,23,23
375,POTTER,375,0424,3750424,7439,3350,629,2721,163,1478,1094,2496,2155,527,1628,94,869,649,1497
19,BANDERA,19,0102,190102,137,3173,2417,756,21,41,589,629,2594,2040,554,21,23,424,447
29,BEXAR,29,4073,294073,884,3092,977,2115,19,119,1949,2045,2288,794,1494,10,94,1358,1439
29,BEXAR,29,1135,291135,386,8,0,8,0,4,4,8,5,0,5,0,4,1,5
29,BEXAR,29,3031,293031,635,50,13,37,2,7,30,34,28,8,20,0,3,18,18
39,BRAZORIA,39,0020,390020,1133,2501,1529,972,21,161,743,888,1955,1262,693,12,135,504,627
55,CALDWELL,55,0206,550206,1382,2160,661,1499,20,291,1159,1424,1607,567,1040,12,216,768,980
479,WEBB,479,0414,4790414,9291,2881,48,2833,4,4,2824,2824,1921,34,1887,1,1,1881,1881
491,WILLIAMSON,491,0484,4910484,9540,5528,2633,2895,1036,708,1130,1793,3711,1910,1801,619,464,676,1110
209,HAYS,209,0228,2090228,5461,3414,1124,2290,214,233,1829,2026,2527,908,1619,166,175,1260,1413
215,HIDALGO,215,0158,2150158,5710,10125,316,9809,124,89,9591,9630,6610,212,6398,103,55,6235,6269
231,HUNT,231,0321,2310321,5959,2455,2030,425,22,35,250,279,2039,1732,307,16,19,169,188
255,KARNES,255,0002,2550002,6208,191,159,32,1,3,29,30,169,144,25,1,3,23,24
453,TRAVIS,453,0212,4530212,8793,4281,2871,1410,356,224,757,942,3868,2623,1245,307,205,660,832
457,TYLER,457,0018,4570018,9042,1588,1282,306,17,154,89,236,1278,1075,203,13,94,61,148
85,COLLIN,85,0002,850002,1631,8196,3476,4720,363,1653,2534,4107,6248,2965,3283,283,1109,1703,2776
87,COLLINGSWORTH,87,0202,870202,1880,101,52,49,3,3,47,47,70,39,31,2,0,31,31
201,HARRIS,201,0497,2010497,4714,2719,166,2553,19,1042,1496,2523,1842,139,1703,11,713,968,1678
201,HARRIS,201,0248,2010248,4465,5537,546,4991,43,791,4171,4879,3931,440,3491,22,576,2871,3409
201,HARRIS,201,0994,2010994,5212,5181,920,4261,848,2747,731,3396,4489,843,3646,738,2362,586,2890
201,HARRIS,201,0745,2010745,4963,4447,2213,2234,343,493,1311,1762,3542,1907,1635,266,362,911,1257
29,BEXAR,29,3137,293137,741,5637,2178,3459,583,451,2448,2807,3722,1490,2232,382,284,1556,1797
29,BEXAR,29,3172,293172,778,972,263,709,98,66,552,604,737,216,521,75,43,400,437
41,BRAZOS,41,0048,410048,1239,404,231,173,5,12,150,159,296,189,107,1,9,95,102
41,BRAZOS,41,0085,410085,1276,0,0,0,0,0,0,0,0,0,0,0,0,0,0
113,DALLAS,113,2523,1132523,2401,2627,1234,1393,841,217,298,507,2337,1096,1241,758,191,251,437
113,DALLAS,113,4673,1134673,2899,0,0,0,0,0,0,0,0,0,0,0,0,0,0
491,WILLIAMSON,491,0146,4910146,9397,7927,4386,3541,1126,774,1434,2151,6431,3681,2750,917,601,1042,1607
311,MCMULLEN,311,0004,3110004,6729,151,88,63,5,5,52,55,130,77,53,4,2,46,48
355,NUECES,355,0111,3550111,7227,1981,558,1423,10,72,1331,1388,1364,442,922,8,50,852,894
423,SMITH,423,0053,4230053,7774,621,438,183,2,102,69,170,472,354,118,1,73,34,107
439,TARRANT,439,3166,4393166,8272,7236,2350,4886,323,1745,2737,4373,5173,1984,3189,246,1115,1730,2783
453,TRAVIS,453,0355,4530355,8899,1098,838,260,60,25,151,169,999,776,223,47,18,135,150
491,WILLIAMSON,491,0245,4910245,9434,4134,3053,1081,260,146,558,691,2899,2192,707,175,88,347,434
141,EL PASO,141,0133,1410133,3446,3907,97,3810,38,114,3704,3769,3144,87,3057,19,76,2977,3034
171,GILLESPIE,171,0005,1710005,3944,2283,1897,386,4,24,281,296,1836,1580,256,2,9,178,181
201,HARRIS,201,0888,2010888,5106,4872,690,4182,171,1915,2081,3923,3333,542,2791,127,1294,1351,2605
201,HARRIS,201,0851,2010851,5069,7450,3347,4103,624,1140,2300,3362,5766,2760,3006,491,859,1587,2411
215,HIDALGO,215,0052,2150052,5604,5830,489,5341,454,118,4787,4875,4265,409,3856,322,75,3465,3525
215,HIDALGO,215,0015,2150015,5567,1599,102,1497,7,5,1478,1478,1151,89,1062,3,3,1050,1050
1,ANDERSON,1,0008,10008,8,926,295,631,13,308,322,612,735,256,479,7,243,233,465
109,CULBERSON,109,03-5,10903-5,2009,501,124,377,15,9,350,356,395,119,276,12,7,255,260
113,DALLAS,113,2053,1132053,2258,5935,1653,4282,674,1394,2200,3535,5046,1582,3464,620,1208,1604,2767
121,DENTON,121,4166,1214166,3091,3673,1847,1826,129,520,1157,1625,2931,1596,1335,104,383,811,1170
121,DENTON,121,2081,1212081,3005,7330,2904,4426,2932,714,702,1379,4581,1913,2668,1749,475,411,863
137,EDWARDS,137,0004,1370004,3254,362,116,246,5,3,236,236,290,101,189,3,2,182,182
375,POTTER,375,0121,3750121,7419,3396,2161,1235,134,325,714,1026,2604,1796,808,88,204,459,658
397,ROCKWALL,397,004F,397004F,7582,890,498,392,28,29,321,345,647,377,270,16,22,213,232
409,SAN PATRICIO,409,0124,4090124,7668,5694,1129,4565,45,173,4362,4472,4247,928,3319,29,107,3167,3252
439,TARRANT,439,4006,4394006,8415,1877,845,1032,53,625,348,954,1586,783,803,43,464,283,741
449,TITUS,449,0014,4490014,8664,3580,1186,2394,32,538,1784,2304,2542,974,1568,11,378,1136,1507
141,EL PASO,141,0027,1410027,3340,3373,594,2779,123,149,2536,2655,2714,518,2196,109,117,1986,2085
187,GUADALUPE,187,0203,1870203,4087,1913,544,1369,29,162,1176,1322,1440,482,958,14,128,805,924
201,HARRIS,201,0119,2010119,4336,2707,913,1794,196,468,1132,1559,1837,686,1151,114,299,731,1008
273,KLEBERG,273,0042,2730042,6337,1848,136,1712,18,50,1650,1682,1320,100,1220,13,29,1180,1205
303,LUBBOCK,303,0109,3030109,6586,3772,2963,809,123,96,513,597,2854,2324,530,91,61,305,364
365,PANOLA,365,0026,3650026,7333,206,151,55,0,39,12,50,152,111,41,0,33,6,39
29,BEXAR,29,4179,294179,990,4111,1638,2473,206,321,1926,2193,3252,1415,1837,171,232,1405,1605
29,BEXAR,29,4216,294216,1027,1794,152,1642,12,46,1578,1607,1258,121,1137,6,25,1092,1112
113,DALLAS,113,1099,1131099,2072,210,30,180,2,29,155,178,116,17,99,0,10,91,99
113,DALLAS,113,3609,1133609,2613,4670,581,4089,65,3126,904,3978,3572,537,3035,57,2398,578,2946
113,DALLAS,113,3965,1133965,2650,5156,2108,3048,569,1311,1132,2382,3785,1663,2122,422,900,758,1626
157,FORT BEND,157,3020,1573020,3695,4332,2269,2063,676,302,1026,1299,3416,1902,1514,508,206,724,913
339,MONTGOMERY,339,0043D,3390043D,6941,14,8,6,0,2,2,4,8,4,4,0,0,2,2
439,TARRANT,439,1605,4391605,8023,0,0,0,0,0,0,0,0,0,0,0,0,0,0
439,TARRANT,439,1738,4391738,8060,45,37,8,2,0,4,4,34,30,4,2,0,0,0
441,TAYLOR,441,0102,4410102,8601,4344,2657,1687,70,313,1241,1519,3360,2198,1162,48,179,847,1019
157,FORT BEND,157,3126,1573126,3732,1475,253,1222,865,249,116,349,1000,176,824,591,155,73,222
201,HARRIS,201,1100,2011100,5318,1572,478,1094,105,270,720,969,1206,403,803,85,204,504,695
201,HARRIS,201,0056,2010056,4273,2446,1134,1312,189,152,940,1069,1973,982,991,154,122,690,800
201,HARRIS,201,1137,2011137,5355,6078,563,5515,299,2618,2684,5163,4055,438,3617,213,1612,1806,3359
285,LAVACA,285,0102,2850102,6400,2070,1539,531,6,263,246,506,1583,1208,375,5,191,166,356
339,MONTGOMERY,339,0079,3390079,6978,3523,2261,1262,170,358,676,1012,2716,1870,846,120,186,480,655
5,ANGELINA,5,0024,50024,51,4805,2803,2002,63,609,1201,1794,3345,2093,1252,40,375,739,1108
29,BEXAR,29,1050,291050,300,1485,123,1362,10,23,1321,1339,1114,112,1002,10,20,966,984
85,COLLIN,85,0088,850088,1717,5448,1331,4117,394,1705,2023,3650,4359,1203,3156,339,1292,1505,2754
97,COOKE,97,0017,970017,1966,548,508,40,1,3,14,17,426,406,20,0,0,8,8
113,DALLAS,113,3027,1133027,2464,1901,26,1875,4,1471,429,1871,1443,20,1423,1,1172,269,1420
113,DALLAS,113,2004,1132004,2215,2374,1911,463,135,75,217,283,1768,1449,319,87,45,156,197
303,LUBBOCK,303,0029,3030029,6543,7048,1353,5695,73,1214,4453,5544,5021,1162,3859,58,752,3028,3735
325,MEDINA,325,002B,325002B,6792,4083,2427,1656,54,64,1450,1490,3193,1993,1200,33,36,1058,1088
439,TARRANT,439,4128,4394128,8458,6407,3465,2942,130,493,2125,2564,4828,2886,1942,94,297,1378,1656
439,TARRANT,439,2612,4392612,8209,0,0,0,0,0,0,0,0,0,0,0,0,0,0
453,TRAVIS,453,0101,4530101,8707,4278,1460,2818,159,1019,1647,2593,3256,1299,1957,127,714,1084,1765
453,TRAVIS,453,0421,4530421,8956,4166,2606,1560,410,241,883,1071,4037,2555,1482,397,229,830,1010
167,GALVESTON,167,0333,1670333,3881,5619,3596,2023,609,384,949,1308,3707,2405,1302,398,259,563,817
187,GUADALUPE,187,0407,1870407,4130,2872,1878,994,17,116,801,902,2199,1526,673,12,88,503,588
201,HARRIS,201,0411,2010411,4628,6917,494,6423,82,405,5962,6323,4796,427,4369,51,320,4006,4302
201,HARRIS,201,0162,2010162,4379,4610,252,4358,32,147,4216,4305,3257,217,3040,26,105,2925,3000
245,JEFFERSON,245,0017,2450017,6045,4153,1443,2710,291,1791,583,2344,3216,1268,1948,210,1295,399,1684
265,KERR,265,0202,2650202,6294,3291,2116,1175,36,34,1003,1027,2555,1773,782,20,23,657,677
21,BASTROP,21,1006,211006,151,7877,2439,5438,44,550,4754,5255,5830,2067,3763,31,435,3215,3629
27,BELL,27,0113,270113,200,7371,3701,3670,192,745,2657,3295,5380,3015,2365,124,425,1723,2109
27,BELL,27,0106,270106,194,7834,2110,5724,417,3377,2001,5105,5672,1709,3963,315,2271,1322,3474
29,BEXAR,29,3088,293088,692,5893,2709,3184,702,515,1957,2396,4575,2267,2308,496,368,1406,1736
85,COLLIN,85,0188,850188,1817,240,123,117,24,14,65,74,183,104,79,8,13,44,53
85,COLLIN,85,0194,850194,1823,31,21,10,0,4,5,9,24,17,7,0,2,4,6
439,TARRANT,439,3529,4393529,8358,3891,2369,1522,1039,144,259,393,2583,1686,897,598,87,156,240
453,TRAVIS,453,0304,4530304,8856,5160,3786,1374,386,160,707,850,4889,3628,1261,364,132,650,772
453,TRAVIS,453,0293,4530293,8850,6230,4272,1958,870,223,732,942,4688,3326,1362,606,150,515,658
249,JIM WELLS,249,0008,2490008,6145,5421,2118,3303,9,44,3129,3163,3987,1671,2316,4,31,2180,2210
249,JIM WELLS,249,0014,2490014,6151,295,48,247,5,2,236,237,201,44,157,1,1,149,149
309,MCLENNAN,309,0059,3090059,6692,5457,3999,1458,82,274,952,1195,4118,3142,976,62,177,605,770
309,MCLENNAN,309,0053B,3090053B,6686,0,0,0,0,0,0,0,0,0,0,0,0,0,0
439,TARRANT,439,3336,4393336,8315,6617,2086,4531,2071,1233,1097,2261,5203,1813,3390,1609,868,780,1618
439,TARRANT,439,3330,4393330,8309,1369,1077,292,94,47,118,163,1120,909,211,72,36,81,116
113,DALLAS,113,2315,1132315,2364,329,143,186,53,78,49,124,310,138,172,43,77,45,119
113,DALLAS,113,2308,1132308,2358,1722,594,1128,452,341,301,638,1508,556,952,377,293,251,540
179,GRAY,179,0002,1790002,3981,5876,2965,2911,34,514,2225,2722,4687,2473,2214,24,471,1609,2066
181,GRAYSON,181,0101,1810101,3987,4469,1797,2672,39,520,1956,2445,3189,1435,1754,30,370,1224,1577
201,HARRIS,201,0311,2010311,4528,8141,850,7291,2441,686,4189,4801,6278,761,5517,2125,553,2855,3350
201,HARRIS,201,0305,2010305,4522,9288,1433,7855,574,1734,5518,7131,6538,1124,5414,437,1142,3803,4880
29,BEXAR,29,1093,291093,343,2924,823,2101,170,415,1486,1871,2460,738,1722,146,350,1195,1525
29,BEXAR,29,2179,292179,592,243,45,198,46,41,112,152,167,34,133,27,28,79,106
61,CAMERON,61,0013,610013,1425,1443,31,1412,5,4,1400,1402,1030,22,1008,2,2,1000,1002
85,COLLIN,85,0045,850045,1674,4414,2708,1706,489,642,502,1117,3594,2322,1272,360,471,380,833
113,DALLAS,113,40A2,11340A2,2756,0,0,0,0,0,0,0,0,0,0,0,0,0,0
113,DALLAS,113,3070,1133070,2507,3909,109,3800,26,2929,870,3761,2900,86,2814,21,2246,551,2778
329,MIDLAND,329,0306,3290306,6835,7783,559,7224,96,1134,5984,7065,5589,454,5135,48,900,4159,5034
351,NEWTON,351,0003,3510003,7084,657,600,57,3,24,10,31,500,474,26,2,10,7,15
439,TARRANT,439,1206,4391206,7917,3937,2916,1021,71,128,691,806,3105,2427,678,51,83,434,512
439,TARRANT,439,2438,4392438,8166,5331,1153,4178,295,2340,1559,3837,4102,969,3133,252,1785,1085,2838
453,TRAVIS,453,0480,4530480,8999,3287,330,2957,17,239,2712,2921,2232,305,1927,15,177,1744,1905
479,WEBB,479,0238,4790238,9248,600,26,574,3,2,566,566,394,21,373,3,0,366,366
149,FAYETTE,149,0204,1490204,3589,1754,1447,307,8,30,223,253,1451,1243,208,7,26,139,165
167,GALVESTON,167,0137,1670137,3838,5284,3409,1875,491,441,825,1239,3518,2341,1177,348,277,493,765
201,HARRIS,201,0702,2010702,4920,1401,20,1381,12,254,1125,1363,1051,16,1035,7,234,800,1022
201,HARRIS,201,0454,2010454,4671,3588,59,3529,22,2487,1045,3502,2653,46,2607,15,1955,655,2590
215,HIDALGO,215,0201,2150201,5753,1963,178,1785,260,34,1512,1524,1370,143,1227,190,19,1024,1031
239,JACKSON,239,0008,2390008,6002,830,557,273,10,10,236,245,626,449,177,9,7,148,155
29,BEXAR,29,4173,294173,984,3033,1097,1936,130,456,1353,1775,2387,992,1395,87,318,954,1262
29,BEXAR,29,2031,292031,443,3888,130,3758,17,126,3643,3714,2520,74,2446,7,62,2380,2418
65,CARSON,65,0402,650402,1525,408,359,49,3,7,24,29,323,291,32,0,4,14,17
113,DALLAS,113,3603,1133603,2607,278,69,209,7,170,28,198,235,68,167,4,143,18,161
113,DALLAS,113,1093,1131093,2066,3941,149,3792,57,1250,2495,3717,2783,127,2656,45,938,1680,2603
121,DENTON,121,4222,1214222,3148,6044,3640,2404,209,758,1251,1962,4044,2541,1503,141,456,768,1204
339,MONTGOMERY,339,0084,3390084,6984,10209,4231,5978,1175,1484,3106,4481,7886,3579,4307,911,1012,2182,3131
391,REFUGIO,391,0001,3910001,7525,943,231,712,4,146,584,700,684,192,492,0,95,404,486
439,TARRANT,439,1753,4391753,8066,0,0,0,0,0,0,0,0,0,0,0,0,0,0
441,TAYLOR,441,0108,4410108,8607,1747,1394,353,29,54,211,259,1363,1123,240,17,38,132,166
469,VICTORIA,469,0028,4690028,9148,706,461,245,5,11,211,220,565,387,178,4,4,154,158
201,HARRIS,201,0554,2010554,4771,6026,408,5618,337,1736,3651,5243,4248,338,3910,317,1337,2310,3573
201,HARRIS,201,1094,2011094,5312,0,0,0,0,0,0,0,0,0,0,0,0,0,0
201,HARRIS,201,0603,2010603,4820,5799,2165,3634,370,920,2325,3177,4295,1756,2539,268,629,1601,2201
221,HOOD,221,0408,2210408,5853,4195,3273,922,63,74,596,654,3375,2751,624,40,42,368,406
227,HOWARD,227,0016,2270016,5902,464,181,283,9,45,223,264,333,136,197,9,36,144,179
291,LIBERTY,291,0006,2910006,6443,1566,1144,422,8,81,270,349,1181,899,282,8,57,155,212
131,DUVAL,131,0006,1310006,3197,192,15,177,1,1,174,175,147,12,135,1,1,132,133
157,FORT BEND,157,3135,1573135,3738,10817,2209,8608,7295,488,770,1228,7677,1684,5993,5082,340,504,832
157,FORT BEND,157,2152,1572152,3689,2179,1017,1162,213,519,374,882,1616,784,832,157,398,233,626
201,HARRIS,201,0062,2010062,4279,4576,111,4465,22,107,4364,4431,3414,97,3317,17,84,3239,3293
201,HARRIS,201,1143,2011143,5361,0,0,0,0,0,0,0,0,0,0,0,0,0,0
201,HARRIS,201,0014,2010014,4230,2597,1754,843,245,170,387,548,2012,1399,613,187,127,260,381
29,BEXAR,29,4162,294162,973,4322,1273,3049,195,766,2125,2783,3154,1057,2097,129,495,1445,1891
29,BEXAR,29,1059,291059,309,1820,148,1672,18,168,1491,1645,1267,140,1127,13,131,975,1102
29,BEXAR,29,3037,293037,641,143,77,66,27,12,31,42,101,52,49,15,9,23,32
43,BREWSTER,43,0005,430005,1305,173,136,37,1,2,33,34,159,127,32,1,1,29,30
85,COLLIN,85,0008,850008,1637,5813,3017,2796,69,118,2475,2567,4333,2545,1788,48,76,1536,1604
145,FALLS,145,0101,1450101,3558,1415,431,984,24,535,430,935,1046,374,672,18,352,284,631
469,VICTORIA,469,0011,4690011,9131,521,334,187,4,20,152,170,412,264,148,3,14,119,132
491,WILLIAMSON,491,0308,4910308,9463,1059,825,234,32,18,156,173,872,703,169,24,12,106,118
225,HOUSTON,225,0006,2250006,5882,1698,1123,575,18,449,67,513,1340,908,432,16,337,41,377
381,RANDALL,381,0230,3810230,7471,6658,5038,1620,100,279,1038,1279,5201,4093,1108,72,187,666,840
427,STARR,427,0006,4270006,7803,7475,124,7351,6,13,7323,7326,5307,82,5225,5,9,5210,5212
439,TARRANT,439,4155,4394155,8467,7923,889,7034,675,255,6095,6309,5492,710,4782,419,165,4184,4332
439,TARRANT,439,2314,4392314,8135,4560,3097,1463,302,466,620,1052,3700,2656,1044,224,328,421,729
453,TRAVIS,453,0221,4530221,8799,4843,3505,1338,290,134,814,929,4003,2936,1067,232,91,654,734
167,GALVESTON,167,0364,1670364,3890,4239,2790,1449,294,305,783,1065,3153,2184,969,194,187,515,700
201,HARRIS,201,0006,2010006,4222,8814,2294,6520,292,2862,3378,6070,6379,1945,4434,224,1916,2277,4095
201,HARRIS,201,0337,2010337,4554,3284,157,3127,55,1199,1927,3067,2358,142,2216,43,878,1329,2166
201,HARRIS,201,1000,2011000,5218,1112,31,1081,94,363,645,988,843,29,814,76,275,470,735
201,HARRIS,201,0669,2010669,4886,5758,2734,3024,485,1445,1046,2446,4621,2388,2233,372,1028,772,1773
213,HENDERSON,213,2PSN,2132PSN,5550,3583,3012,571,17,46,379,423,2909,2525,384,5,16,248,263
29,BEXAR,29,4139,294139,950,22,4,18,1,4,14,18,16,4,12,0,4,8,12
29,BEXAR,29,1036,291036,286,6823,841,5982,165,476,5393,5762,4779,718,4061,118,324,3597,3883
29,BEXAR,29,3014,293014,618,795,304,491,23,30,445,465,645,265,380,18,21,339,358
201,HARRIS,201,1023,2011023,5241,2259,80,2179,43,447,1717,2131,1619,64,1555,32,328,1216,1521
201,HARRIS,201,0029,2010029,4245,6488,357,6131,63,65,6007,6051,4655,318,4337,44,32,4256,4278
201,HARRIS,201,0360,2010360,4577,6015,3343,2672,1301,396,858,1236,5001,2941,2060,956,319,683,997
467,VAN ZANDT,467,002A,467002A,9108,6072,5165,907,74,153,517,663,4576,4000,576,49,99,295,392
355,NUECES,355,0001,3550001,7116,2495,1270,1225,65,140,991,1111,2313,1231,1082,62,115,866,976
377,PRESIDIO,377,0006,3770006,7448,85,24,61,2,1,57,58,49,19,30,1,0,27,27
423,SMITH,423,0059,4230059,7780,4769,3403,1366,361,469,432,894,3770,2829,941,241,332,290,617
439,TARRANT,439,4097,4394097,8444,2482,439,2043,76,95,1857,1941,1792,350,1442,57,49,1314,1360
439,TARRANT,439,2246,4392246,8112,1405,1033,372,77,86,174,253,1173,903,270,52,66,129,191
453,TRAVIS,453,0185,4530185,8776,1949,505,1444,38,97,1297,1372,1481,457,1024,35,52,913,965
201,HARRIS,201,0691,2010691,4909,7183,4009,3174,575,644,1877,2494,5043,2972,2071,400,416,1176,1586
215,HIDALGO,215,0021,2150021,5573,988,23,965,4,10,956,961,700,15,685,4,2,680,681
227,HOWARD,227,0026,2270026,5905,768,317,451,11,53,384,432,534,264,270,6,20,242,260
257,KAUFMAN,257,0016,2570016,6237,5165,4135,1030,74,178,610,776,3984,3296,688,53,117,395,510
303,LUBBOCK,303,0058,3030058,6569,2189,1357,832,198,101,504,595,1812,1179,633,167,75,365,433
323,MAVERICK,323,004A,323004A,6784,2934,99,2835,17,14,2815,2818,2153,71,2082,9,4,2068,2069
29,BEXAR,29,1013,291013,263,4354,146,4208,8,44,4170,4196,3297,123,3174,7,35,3143,3164
85,COLLIN,85,0223,850223,1852,2975,1627,1348,853,190,247,425,1947,1124,823,522,115,140,252
113,DALLAS,113,4608,1134608,2848,8592,1765,6827,1087,2497,3218,5613,6583,1590,4993,831,1844,2291,4067
113,DALLAS,113,3079,1133079,2516,2496,343,2153,19,239,1878,2108,1596,271,1325,12,177,1121,1293
113,DALLAS,113,1726,1131726,2184,5236,1092,4144,152,576,3377,3915,3707,959,2748,99,412,2208,2599
127,DIMMIT,127,0001,1270001,3180,2236,253,1983,35,50,1891,1922,1606,209,1397,25,36,1324,1352
141,EL PASO,141,0199,1410199,3512,1887,306,1581,45,53,1499,1532,1412,278,1134,33,26,1078,1096
167,GALVESTON,167,0150,1670150,3844,4099,2085,2014,80,463,1350,1792,3176,1751,1425,58,328,939,1255
193,HAMILTON,193,0004,1930004,4176,247,204,43,0,6,34,39,194,166,28,0,0,24,24
473,WALLER,473,0102,4730102,9177,4858,1497,3361,47,1626,1680,3250,3659,1280,2379,34,1222,1095,2291
491,WILLIAMSON,491,0402,4910402,9509,8395,3713,4682,308,1366,2987,4216,5763,2690,3073,191,918,1881,2736
113,DALLAS,113,4631,1134631,2871,2288,972,1316,193,190,911,1081,1786,833,953,156,141,635,764
133,EASTLAND,133,0003,1330003,3203,2686,1952,734,33,125,525,639,2140,1605,535,22,108,364,466
141,EL PASO,141,0220,1410220,3535,1791,57,1734,16,28,1621,1632,1419,46,1373,9,14,1280,1287
167,GALVESTON,167,0218,1670218,3867,4628,2449,2179,134,435,1532,1942,3796,2165,1631,97,302,1153,1441
199,HARDIN,199,0002,1990002,4199,7058,6046,1012,53,359,395,744,5396,4739,657,35,205,248,452
201,HARRIS,201,0646,2010646,4863,4631,420,4211,1438,1162,1661,2759,3598,332,3266,1179,905,1200,2073
201,HARRIS,201,0977,2010977,5195,4228,276,3952,608,519,2831,3319,3015,231,2784,496,404,1890,2269
201,HARRIS,201,0314,2010314,4531,3405,1418,1987,781,581,609,1160,2465,1078,1387,556,388,415,796
439,TARRANT,439,4245A,4394245A,8490,530,32,498,11,76,416,477,347,25,322,7,47,265,305
453,TRAVIS,453,0250,4530250,8822,4018,1428,2590,427,558,1573,2074,3234,1277,1957,336,421,1169,1551
469,VICTORIA,469,0034,4690034,9154,2266,237,2029,5,332,1700,2011,1649,176,1473,3,253,1222,1458
491,WILLIAMSON,491,0346,4910346,9486,1697,1457,240,28,16,161,172,1427,1253,174,16,14,107,116
19,BANDERA,19,0305,190305,140,3474,2543,931,37,52,712,754,2904,2207,697,28,41,521,554
29,BEXAR,29,2065B,292065B,478,226,49,177,8,27,143,164,151,39,112,1,17,94,107
29,BEXAR,29,3198,293198,804,1112,356,756,313,23,408,429,788,278,510,209,18,273,290
39,BRAZORIA,39,0029,390029,1142,5486,1423,4063,1693,1374,1048,2354,3973,1080,2893,1203,990,693,1652
85,COLLIN,85,0177,850177,1806,4417,2552,1865,597,662,518,1150,3755,2280,1475,458,508,404,901
113,DALLAS,113,3033,1133033,2470,1193,49,1144,9,606,539,1133,782,42,740,4,408,329,734
453,TRAVIS,453,0427,4530427,8962,5999,2254,3745,375,973,2343,3251,5199,2116,3083,356,766,1891,2612
453,TRAVIS,453,0435,4530435,8968,3251,1465,1786,147,228,1384,1585,2797,1351,1446,128,192,1091,1264
507,ZAVALA,507,0004,5070004,9632,1487,182,1305,5,18,1287,1298,1075,149,926,4,9,915,922
215,HIDALGO,215,0167,2150167,5719,811,149,662,17,6,639,643,639,121,518,14,3,500,501
279,LAMB,279,0012,2790012,6383,354,249,105,3,5,96,99,243,180,63,0,1,59,60
339,MONTGOMERY,339,0071,3390071,6970,6887,4754,2133,641,209,1131,1313,4845,3415,1430,431,139,750,875
347,NACOGDOCHES,347,0043,3470043,7047,2098,1291,807,20,257,470,722,1560,1052,508,14,163,282,442
407,SAN JACINTO,407,0001,4070001,7634,4326,3275,1051,26,546,345,878,3541,2753,788,22,423,219,634
439,TARRANT,439,3286,4393286,8298,1431,992,439,266,60,69,121,985,738,247,143,30,36,63
113,DALLAS,113,2513,1132513,2393,4164,1737,2427,961,803,628,1415,3298,1443,1855,799,564,454,1015
121,DENTON,121,3133,1213133,3057,7102,4033,3069,690,801,1450,2196,5446,3303,2143,511,544,955,1468
157,FORT BEND,157,3096,1573096,3721,5898,1152,4746,1687,1944,1133,2995,4690,967,3723,1410,1441,854,2253
201,HARRIS,201,0168,2010168,4385,995,39,956,1,491,466,951,751,22,729,0,411,319,724
201,HARRIS,201,0174,2010174,4391,4731,2961,1770,844,242,633,853,3899,2551,1348,626,191,476,653
201,HARRIS,201,0837,2010837,5055,344,164,180,132,18,27,45,302,142,160,117,16,24,40
21,BASTROP,21,3018,213018,163,2682,1645,1037,30,135,803,919,1998,1344,654,10,98,482,574
29,BEXAR,29,4016,294016,827,4008,373,3635,36,119,3502,3581,3209,325,2884,26,79,2783,2836
39,BRAZORIA,39,0052,390052,1165,4394,2482,1912,413,453,1013,1442,3250,1906,1344,308,329,665,986
61,CAMERON,61,0079,610079,1491,6790,1028,5762,227,130,5415,5507,5023,916,4107,178,77,3839,3899
85,COLLIN,85,0200,850200,1829,2517,1767,750,40,201,434,628,1868,1369,499,29,117,299,414
85,COLLIN,85,0077,850077,1706,5229,2500,2729,1091,784,793,1541,3960,2014,1946,853,528,515,1021
201,HARRIS,201,0151,2010151,4368,1611,30,1581,22,662,902,1546,1204,28,1176,21,551,602,1146
201,HARRIS,201,0814,2010814,5032,4927,482,4445,841,2655,1010,3587,3410,391,3019,675,1672,708,2330
215,HIDALGO,215,0144,2150144,5696,94,4,90,1,2,88,88,64,4,60,1,0,59,59
409,SAN PATRICIO,409,0113,4090113,7657,4160,1207,2953,117,85,2699,2763,2859,866,1993,82,49,1819,1860
439,TARRANT,439,3367,4393367,8321,2421,1785,636,110,128,341,461,1858,1425,433,85,91,210,297
453,TRAVIS,453,0460,4530460,8985,6318,736,5582,74,683,4853,5451,4533,642,3891,55,490,3336,3781
113,DALLAS,113,3056,1133056,2493,2474,171,2303,15,1810,487,2277,2037,159,1878,11,1577,294,1859
113,DALLAS,113,2404,1132404,2370,4463,1033,3430,452,443,2511,2927,3334,920,2414,372,305,1704,2002
121,DENTON,121,2110,1212110,3034,3770,1755,2015,762,329,850,1151,3001,1500,1501,606,237,582,805
121,DENTON,121,9203,1219203,3157,0,0,0,0,0,0,0,0,0,0,0,0,0,0
157,FORT BEND,157,3046,1573046,3704,4771,1787,2984,1731,506,750,1211,3780,1484,2296,1370,357,544,871
157,FORT BEND,157,3029,1573029,3698,2380,1522,858,260,134,434,557,1939,1297,642,206,90,313,395
25,BEE,25,0017,250017,186,1839,421,1418,20,78,1309,1371,1377,341,1036,20,59,947,993
29,BEXAR,29,4039,294039,850,2551,89,2462,24,1157,1331,2406,1790,71,1719,13,903,818,1678
29,BEXAR,29,4208,294208,1019,4,3,1,0,0,1,1,4,3,1,0,0,1,1
29,BEXAR,29,2020,292020,432,6861,230,6631,255,653,5766,6358,4614,166,4448,136,501,3831,4300
37,BOWIE,37,004C,37004C,1096,1816,622,1194,77,979,116,1087,1405,545,860,57,706,76,776
63,CAMP,63,1001,631001,1514,3187,1622,1565,21,491,998,1464,2319,1291,1028,17,364,598,953
259,KENDALL,259,1030,2591030,6260,385,289,96,2,13,70,82,270,225,45,2,0,34,34
289,LEON,289,0005,2890005,6429,617,562,55,2,10,30,40,492,457,35,0,4,21,25
339,MONTGOMERY,339,0029,3390029,6924,7202,5548,1654,72,190,1109,1275,5258,4193,1065,52,117,694,803
351,NEWTON,351,0010,3510010,7093,602,559,43,3,18,19,35,475,448,27,2,8,12,20
423,SMITH,423,0036,4230036,7757,6815,1518,5297,53,2835,2364,5158,5331,1391,3940,41,2217,1617,3820
439,TARRANT,439,4044,4394044,8421,6698,3848,2850,316,764,1651,2334,4613,2843,1770,207,473,977,1428
85,COLLIN,85,0054,850054,1683,5677,2291,3386,1083,1011,1175,2138,4513,1969,2544,869,722,834,1540
113,DALLAS,113,1720,1131720,2178,4897,1635,3262,212,693,2326,2979,3786,1452,2334,135,515,1621,2119
113,DALLAS,113,2223,1132223,2347,2302,1817,485,200,29,183,206,1597,1279,318,119,21,124,144
121,DENTON,121,2087,1212087,3011,6683,3153,3530,825,745,1829,2540,4998,2454,2544,616,533,1283,1790
201,HARRIS,201,0714,2010714,4932,1411,88,1323,9,32,1280,1304,974,76,898,7,23,871,889
215,HIDALGO,215,0044,2150044,5596,7982,159,7823,15,19,7768,7781,4895,87,4808,12,8,4772,4779
29,BEXAR,29,4185,294185,996,8,0,8,0,2,6,8,3,0,3,0,2,1,3
29,BEXAR,29,4062,294062,873,1400,187,1213,6,302,913,1199,987,167,820,4,201,615,810
29,BEXAR,29,2043,292043,455,4270,136,4134,28,180,3940,4080,3160,106,3054,15,113,2925,3021
29,BEXAR,29,1082,291082,332,5691,817,4874,157,372,4397,4695,4204,694,3510,118,248,3140,3361
39,BRAZORIA,39,0006,390006,1119,2398,1604,794,28,80,596,664,1786,1273,513,18,42,373,408
67,CASS,67,0016,670016,1537,692,570,122,3,49,41,90,527,431,96,3,40,26,66
439,TARRANT,439,3177,4393177,8275,3323,2528,795,161,148,393,536,2664,2117,547,109,105,265,367
263,KENT,263,0201,2630201,6283,46,45,1,0,0,1,1,31,31,0,0,0,0,0
285,LAVACA,285,0311,2850311,6406,1375,951,424,7,71,347,397,1061,787,274,5,44,216,251
339,MONTGOMERY,339,0049,3390049,6947,3240,2240,1000,198,86,618,692,2417,1770,647,124,57,401,455
349,NAVARRO,349,0304,3490304,7070,1161,931,230,9,33,131,163,929,766,163,7,24,83,106
401,RUSK,401,0405,4010405,7611,1808,1155,653,30,187,390,573,1345,911,434,22,126,249,371
423,SMITH,423,0013,4230013,7734,2676,47,2629,8,1658,972,2611,1940,33,1907,2,1328,572,1893
85,COLLIN,85,0154,850154,1783,1699,1258,441,60,88,250,324,1246,969,277,37,58,150,203
85,COLLIN,85,0031,850031,1660,2619,1928,691,236,164,244,397,2005,1540,465,165,106,164,263
113,DALLAS,113,2140,1132140,2324,3776,299,3477,711,1041,1743,2749,2699,278,2421,456,810,1156,1948
113,DALLAS,113,4625,1134625,2865,4399,1437,2962,458,756,1754,2448,3457,1286,2171,383,554,1201,1718
113,DALLAS,113,1743,1131743,2201,6906,2357,4549,575,1495,2376,3830,5256,2031,3225,434,1108,1579,2671
215,HIDALGO,215,0190,2150190,5742,1025,186,839,10,6,819,821,721,175,546,8,2,528,530
45,BRISCOE,45,0003,450003,1311,348,242,106,2,6,85,90,273,194,79,1,3,61,64
71,CHAMBERS,71,0009,710009,1560,565,351,214,77,19,96,114,445,286,159,58,15,67,81
85,COLLIN,85,0014,850014,1643,8369,1734,6635,5628,554,382,910,5905,1453,4452,3716,426,257,675
89,COLORADO,89,0304,890304,1892,670,555,115,2,14,87,98,563,478,85,1,5,65,69
113,DALLAS,113,4656,1134656,2888,284,35,249,59,19,171,187,205,33,172,52,10,108,117
113,DALLAS,113,3921,1133921,2639,12272,3199,9073,95,2362,6530,8823,8336,2625,5711,59,1585,3955,5520
325,MEDINA,325,004C,325004C,6801,4168,829,3339,23,70,3209,3249,3100,718,2382,11,49,2288,2322
355,NUECES,355,0100,3550100,7216,2165,450,1715,17,62,1631,1676,1605,388,1217,15,41,1156,1192
395,ROBERTSON,395,0013,3950013,7548,245,222,23,1,0,17,17,188,172,16,0,0,11,11
425,SOMERVELL,425,0004,4250004,7797,2368,1872,496,10,15,397,406,1796,1471,325,4,7,258,262
121,DENTON,121,1047,1211047,2971,5933,2567,3366,385,1896,1007,2817,4139,1941,2198,260,1246,620,1834
135,ECTOR,135,0203,1350203,3220,7313,3984,3329,191,575,2469,2978,5809,3327,2482,165,423,1787,2184
209,HAYS,209,0330,2090330,5473,413,227,186,12,24,137,156,338,194,144,10,20,101,117
225,HOUSTON,225,0012,2250012,5888,171,132,39,0,11,17,27,139,113,26,0,5,10,15
255,KARNES,255,0014,2550014,6220,1736,334,1402,18,47,1320,1360,1312,271,1041,9,34,985,1013
293,LIMESTONE,293,0205,2930205,6469,934,344,590,4,183,396,566,656,282,374,3,131,230,358
9,ARCHER,9,0003,90003,77,528,402,126,2,7,99,105,400,328,72,1,4,53,56
29,BEXAR,29,3020,293020,624,3332,2413,919,133,63,704,753,2725,2052,673,84,45,522,562
29,BEXAR,29,4145,294145,956,26,11,15,5,5,5,10,24,11,13,5,3,5,8
29,BEXAR,29,1156,291156,409,4222,1276,2946,228,485,2293,2673,2979,994,1985,152,295,1525,1776
95,CONCHO,95,0205,950205,1952,293,166,127,3,4,115,118,256,157,99,3,3,89,91
113,DALLAS,113,2099,1132099,2284,4330,2819,1511,391,352,683,1011,4094,2757,1337,347,290,599,874
453,TRAVIS,453,0194,4530194,8782,4066,1541,2525,1014,520,999,1458,3161,1276,1885,775,353,734,1056
467,VAN ZANDT,467,003C,467003C,9114,6307,4858,1449,38,251,984,1220,4767,3809,958,31,165,621,782
245,JEFFERSON,245,0086,2450086,6114,2895,1245,1650,164,1261,234,1461,2302,1117,1185,124,888,163,1036
303,LUBBOCK,303,0066,3030066,6575,3202,2402,800,171,126,429,541,2658,2053,605,141,83,304,382
339,MONTGOMERY,339,0014,3390014,6907,8970,3674,5296,192,385,4520,4857,6437,2890,3547,144,286,2956,3222
353,NOLAN,353,0004,3530004,7110,3426,1275,2151,38,357,1774,2069,2512,1025,1487,23,224,1222,1425
439,TARRANT,439,1151,4391151,7903,2565,687,1878,81,1365,411,1758,1916,598,1318,70,951,273,1220
439,TARRANT,439,2726,4392726,8235,3993,911,3082,835,1230,1013,2207,2986,758,2228,609,904,688,1576
113,DALLAS,113,2042,1132042,2247,3936,2923,1013,298,240,402,632,2961,2256,705,208,174,264,436
113,DALLAS,113,32T1,11332T1,2579,0,0,0,0,0,0,0,0,0,0,0,0,0,0
147,FANNIN,147,0006,1470006,3575,1005,882,123,6,20,55,73,770,683,87,5,12,30,41
167,GALVESTON,167,0428,1670428,3907,4592,3635,957,54,52,688,731,3606,2924,682,39,25,483,506
201,HARRIS,201,0569,2010569,4786,8985,3995,4990,1832,1296,1762,2983,7904,3646,4258,1543,1085,1498,2541
215,HIDALGO,215,0230,2150230,5782,1724,222,1502,99,33,1366,1393,1218,178,1040,64,23,947,968
157,FORT BEND,157,3127A,1573127A,3733,4269,1127,3142,1963,728,450,1168,3360,914,2446,1546,546,331,870
201,HARRIS,201,0812,2010812,5030,0,0,0,0,0,0,0,0,0,0,0,0,0,0
5,ANGELINA,5,0025,50025,52,3654,2568,1086,28,291,705,982,2755,2037,718,17,193,452,642
121,DENTON,121,1039,1211039,2963,1669,420,1249,760,345,129,459,1038,270,768,461,214,71,281
39,BRAZORIA,39,0067,390067,1180,5040,847,4193,956,2431,865,3212,3684,661,3023,661,1761,614,2329
85,COLLIN,85,0232,850232,1861,5369,3017,2352,506,857,841,1678,3690,2175,1515,338,549,521,1065
339,MONTGOMERY,339,0009,3390009,6902,2768,2047,721,39,279,309,564,2087,1599,488,29,190,179,368
113,DALLAS,113,2008,1132008,2219,1535,1285,250,97,32,82,105,1228,1036,192,73,24,56,79
215,HIDALGO,215,0222,2150222,5774,10,1,9,0,1,9,9,7,1,6,0,0,6,6
37,BOWIE,37,0030,370030,1091,3952,2778,1174,38,730,285,1004,3021,2162,859,27,539,181,714
453,TRAVIS,453,0403,4530403,8943,3810,1503,2307,167,312,1786,2063,3312,1395,1917,142,249,1482,1714
399,RUNNELS,399,0001,3990001,7583,2489,1413,1076,22,75,926,985,1886,1133,753,15,44,634,674
121,DENTON,121,1065,1211065,2989,2262,1038,1224,56,341,770,1089,1717,872,845,35,239,517,749
245,JEFFERSON,245,0041,2450041,6069,276,205,71,4,3,56,59,218,162,56,4,3,46,49
361,ORANGE,361,0022,3610022,7277,1618,1456,162,11,12,98,110,1283,1153,130,8,11,80,91
141,EL PASO,141,0134,1410134,3447,2065,103,1962,13,16,1930,1937,1660,89,1571,12,8,1546,1550
201,HARRIS,201,1144,2011144,5362,2375,1587,788,178,111,447,538,1707,1197,510,125,77,265,330
113,DALLAS,113,3031,1133031,2468,2783,383,2400,17,410,1967,2360,1781,297,1484,6,282,1172,1448
275,KNOX,275,0201,2750201,6341,278,218,60,6,8,45,52,207,182,25,1,2,19,21
113,DALLAS,113,3074,1133074,2511,2176,97,2079,8,279,1802,2062,1465,89,1376,3,184,1186,1362
201,HARRIS,201,0209,2010209,4426,10921,552,10369,156,3862,6482,10157,7079,413,6666,113,2571,4020,6503
67,CASS,67,0009,670009,1532,1391,1001,390,13,271,45,312,1150,837,313,12,225,29,253
469,VICTORIA,469,0029,4690029,9149,3463,2017,1446,152,196,1032,1215,2669,1678,991,115,130,694,821
201,HARRIS,201,1101,2011101,5319,1990,1178,812,533,75,182,251,1622,977,645,446,58,128,184
355,NUECES,355,0118,3550118,7234,4492,876,3616,59,307,3252,3520,3546,772,2774,41,240,2469,2692
29,BEXAR,29,2181B,292181B,596,283,94,189,18,24,141,158,177,62,115,11,13,88,95
201,HARRIS,201,0252,2010252,4469,2915,42,2873,13,1932,937,2854,2218,39,2179,11,1585,582,2162
29,BEXAR,29,3035,293035,639,1186,468,718,164,74,489,550,977,426,551,121,51,378,425
473,WALLER,473,0417,4730417,9192,0,0,0,0,0,0,0,0,0,0,0,0,0,0
141,EL PASO,141,0091,1410091,3404,1200,165,1035,26,113,916,1015,1052,149,903,14,105,789,885
113,DALLAS,113,3112,1133112,2554,74,10,64,9,45,17,57,48,8,40,8,26,11,34
79,COCHRAN,79,0306,790306,1618,559,217,342,5,8,332,338,411,178,233,4,4,228,231
461,UPTON,461,0001,4610001,9063,637,425,212,10,21,180,195,458,317,141,9,19,118,132
439,TARRANT,439,2618,4392618,8213,84,37,47,3,37,6,43,47,21,26,0,24,1,25
201,HARRIS,201,0166,2010166,4383,2013,991,1022,137,135,743,857,1639,863,776,108,100,556,643
265,KERR,265,0303,2650303,6298,1719,1439,280,27,14,217,226,1565,1352,213,20,7,166,170
439,TARRANT,439,1083,4391083,7875,3061,169,2892,42,793,2080,2845,1994,135,1859,25,499,1344,1836
121,DENTON,121,4184,1214184,3109,5623,4295,1328,172,275,708,970,4056,3179,877,110,188,451,636
467,VAN ZANDT,467,001D,467001D,9106,2159,1781,378,14,45,215,260,1672,1388,284,9,23,163,186
439,TARRANT,439,2450,4392450,8170,4864,908,3956,1065,1439,1458,2843,3537,730,2807,803,971,1012,1957
203,HARRISON,203,0022,2030022,5405,3769,1090,2679,33,1633,984,2592,2826,930,1896,27,1191,650,1831
73,CHEROKEE,73,0023,730023,1575,1340,1173,167,3,40,94,132,1025,921,104,1,20,58,78
61,CAMERON,61,0060,610060,1472,2758,175,2583,9,16,2559,2566,1942,147,1795,9,10,1778,1785
245,JEFFERSON,245,0018,2450018,6046,2866,69,2797,17,2642,154,2779,1896,54,1842,14,1753,85,1829
201,HARRIS,201,0123,2010123,4340,2511,1317,1194,273,382,529,881,2336,1257,1079,250,354,455,788
453,TRAVIS,453,0236,4530236,8811,6518,3840,2678,1137,297,1147,1395,5406,3240,2166,961,225,887,1091
245,JEFFERSON,245,0061,2450061,6089,3971,1297,2674,246,644,1803,2399,2950,1110,1840,185,466,1193,1628
141,EL PASO,141,0031,1410031,3344,4555,734,3821,192,215,3407,3582,3711,695,3016,167,185,2644,2802
29,BEXAR,29,2080,292080,493,2705,347,2358,12,117,2224,2320,2004,306,1698,7,78,1602,1667
191,HALL,191,0402,1910402,4174,319,180,139,3,15,121,135,241,157,84,1,12,71,82
343,MORRIS,343,0303,3430303,7025,1582,1275,307,12,121,116,236,1265,1043,222,7,100,68,168
465,VAL VERDE,465,0013,4650013,9089,2257,1283,974,98,174,718,842,1835,1082,753,85,132,518,626
201,HARRIS,201,0063,2010063,4280,3841,2347,1494,41,195,1174,1360,2985,1948,1037,30,138,798,930
201,HARRIS,201,0892,2010892,5110,2530,919,1611,207,735,627,1335,2286,873,1413,184,640,539,1160
113,DALLAS,113,2005,1132005,2216,1267,893,374,53,60,242,297,987,730,257,38,40,159,199
201,HARRIS,201,0001,2010001,4217,1979,1140,839,193,148,454,593,1644,959,685,157,118,369,482
29,BEXAR,29,1051,291051,301,3743,516,3227,21,85,3137,3195,2834,460,2374,18,54,2301,2344
201,HARRIS,201,0998,2010998,5216,24,0,24,5,6,14,19,9,0,9,5,2,2,4
113,DALLAS,113,2316,1132316,2365,2625,1254,1371,114,71,1143,1204,2152,1118,1034,89,55,849,899
121,DENTON,121,9101,1219101,3152,0,0,0,0,0,0,0,0,0,0,0,0,0,0
113,DALLAS,113,2116,1132116,2302,323,233,90,29,17,27,44,322,232,90,29,17,27,44
453,TRAVIS,453,0353,4530353,8897,4436,3483,953,261,114,494,597,3766,3035,731,191,89,375,462
113,DALLAS,113,2607,1132607,2408,16,7,9,1,1,8,8,9,7,2,1,1,1,1
113,DALLAS,113,1715,1131715,2173,4700,579,4121,38,244,3842,4055,3240,492,2748,33,170,2538,2695
51,BURLESON,51,0215,510215,1343,910,547,363,6,63,256,311,669,420,249,5,30,182,209
201,HARRIS,201,0806,2010806,5024,5838,2365,3473,895,916,1630,2484,3896,1693,2203,588,574,1006,1543
41,BRAZOS,41,0046,410046,1237,830,296,534,6,66,450,515,627,261,366,6,51,300,350
439,TARRANT,439,1607,4391607,8024,0,0,0,0,0,0,0,0,0,0,0,0,0,0
453,TRAVIS,453,0425,4530425,8960,5325,2342,2983,273,504,2200,2632,4731,2232,2499,247,450,1786,2175
201,HARRIS,201,0935,2010935,5153,6523,1472,5051,346,2543,2212,4646,4938,1318,3620,261,1804,1571,3306
29,BEXAR,29,1114,291114,364,296,11,285,2,5,280,283,183,10,173,2,5,168,171
61,CAMERON,61,0017,610017,1429,12415,319,12096,33,32,12004,12022,8127,209,7918,24,21,7861,7875
113,DALLAS,113,2094,1132094,2279,2098,1139,959,182,413,355,746,1948,1112,836,167,343,299,641
135,ECTOR,135,0312,1350312,3238,2556,1113,1443,28,123,1243,1353,1871,882,989,16,95,828,920
187,GUADALUPE,187,0204,1870204,4088,3188,634,2554,65,285,2214,2451,2262,509,1753,46,170,1526,1676
201,HARRIS,201,0869,2010869,5087,1265,30,1235,33,656,567,1183,851,24,827,20,447,378,802
189,HALE,189,0206,1890206,4151,322,19,303,4,28,273,294,250,17,233,4,21,206,225
135,ECTOR,135,0109,1350109,3215,397,250,147,2,12,127,136,294,202,92,0,5,80,84
439,TARRANT,439,2304,4392304,8127,2844,1839,1005,299,294,338,621,2296,1572,724,226,211,214,422
241,JASPER,241,0021,2410021,6023,2491,1240,1251,29,898,280,1174,1880,1006,874,23,623,191,810
355,NUECES,355,0076,3550076,7191,1759,92,1667,5,33,1626,1647,1313,75,1238,1,29,1207,1227
351,NEWTON,351,0007,3510007,7088,237,197,40,2,31,2,32,194,159,35,2,26,1,27
29,BEXAR,29,2018,292018,430,1764,71,1693,14,24,1656,1666,1369,57,1312,10,18,1279,1289
257,KAUFMAN,257,0034,2570034,6255,4067,2282,1785,56,422,1205,1622,2952,1755,1197,42,325,745,1069
231,HUNT,231,0322,2310322,5960,2395,1663,732,18,29,504,531,1834,1332,502,9,21,336,356
365,PANOLA,365,0003,3650003,7320,1824,1362,462,10,260,167,419,1337,1028,309,5,189,98,284
53,BURNET,53,0017,530017,1366,2566,2021,545,33,49,397,439,1981,1644,337,24,31,230,258
453,TRAVIS,453,0481,4530481,9000,7888,1323,6565,158,794,5609,6297,5431,1119,4312,111,561,3612,4121
439,TARRANT,439,1380,4391380,7961,2569,1171,1398,113,762,506,1225,2165,1046,1119,97,608,390,973
439,TARRANT,439,3040,4393040,8256,4932,3515,1417,357,268,644,891,3931,2934,997,232,176,457,628
249,JIM WELLS,249,0015,2490015,6152,2609,322,2287,11,25,2260,2265,1877,271,1606,11,12,1588,1589
139,ELLIS,139,1044,1391044,3298,847,529,318,12,80,215,288,606,409,197,6,42,143,185
201,HARRIS,201,0995,2010995,5213,3698,263,3435,249,1456,1745,3183,2811,223,2588,229,1209,1164,2365
55,CALDWELL,55,0300,550300,1383,1865,376,1489,12,370,1109,1460,1524,334,1190,7,323,857,1164
439,TARRANT,439,1749,4391749,8064,0,0,0,0,0,0,0,0,0,0,0,0,0,0
351,NEWTON,351,0004,3510004,7085,197,137,60,1,45,6,51,149,121,28,1,20,3,23
139,ELLIS,139,1001,1391001,3255,3596,744,2852,29,1772,1019,2727,2443,550,1893,23,1209,613,1812
201,HARRIS,201,0952,2010952,5170,2034,186,1848,49,423,1406,1791,1192,134,1058,30,226,813,1024
453,TRAVIS,453,0422,4530422,8957,6110,1931,4179,576,1415,2101,3450,5348,1678,3670,503,1204,1887,3046
347,NACOGDOCHES,347,0032,3470032,7042,4881,2951,1930,210,1109,547,1609,4108,2612,1496,163,858,412,1244
471,WALKER,471,0403A,4710403A,9172,2237,1344,893,5,202,622,821,1728,1094,634,5,162,414,576
361,ORANGE,361,0002,3610002,7257,2618,961,1657,27,1273,327,1571,2091,818,1273,16,991,234,1211
141,EL PASO,141,0028,1410028,3341,591,14,577,3,12,573,576,493,9,484,1,7,480,483
61,CAMERON,61,0014,610014,1426,6172,193,5979,23,17,5922,5932,4228,144,4084,15,8,4041,4047
439,TARRANT,439,3364,4393364,8319,1954,1015,939,158,397,353,732,1526,860,666,114,279,238,507
285,LAVACA,285,0231,2850231,6404,2076,1603,473,27,156,274,421,1633,1317,316,20,98,180,276
339,MONTGOMERY,339,0061,3390061,6959,6462,4502,1960,683,207,938,1131,4790,3457,1333,456,144,628,769
201,HARRIS,201,0826,2010826,5044,582,319,263,98,30,128,154,383,231,152,62,12,72,82
439,TARRANT,439,2225,4392225,8107,7694,502,7192,292,2272,4641,6853,5104,426,4678,235,1475,2957,4401
251,JOHNSON,251,0033,2510033,6192,5687,3572,2115,15,133,1786,1899,4033,2724,1309,12,92,1060,1146
201,HARRIS,201,0272,2010272,4489,6545,1582,4963,558,1577,2831,4303,5285,1414,3871,405,1248,2207,3379
245,JEFFERSON,245,0038,2450038,6066,3182,2522,660,96,77,419,482,2440,2026,414,61,49,240,284
123,DEWITT,123,0401,1230401,3172,3296,2055,1241,17,285,896,1154,2491,1672,819,11,185,574,745
113,DALLAS,113,3054,1133054,2491,2917,121,2796,16,2189,592,2763,2390,103,2287,14,1892,374,2257
439,TARRANT,439,1291,4391291,7938,3526,155,3371,18,1776,1593,3319,2491,123,2368,14,1405,945,2326
41,BRAZOS,41,0109,410109,1300,0,0,0,0,0,0,0,0,0,0,0,0,0,0
261,KENEDY,261,0003,2610003,6278,78,8,70,2,3,68,69,64,8,56,1,1,56,56
113,DALLAS,113,3011,1133011,2448,1924,1121,803,242,261,283,530,1854,1097,757,234,236,261,491
59,CALLAHAN,59,0005,590005,1409,164,140,24,2,4,13,17,125,116,9,2,2,4,6
175,GOLIAD,175,0032,1750032,3962,766,631,135,8,6,101,106,619,525,94,4,3,68,70
453,TRAVIS,453,0490,4530490,9003,7086,1903,5183,135,813,4202,4930,4949,1598,3351,108,553,2648,3157
201,HARRIS,201,0021,2010021,4237,1685,560,1125,189,583,348,921,1481,531,950,162,511,269,773
439,TARRANT,439,2360,4392360,8150,5061,3378,1683,330,689,587,1239,3898,2734,1164,205,488,409,883
201,HARRIS,201,0103,2010103,4320,5438,1248,4190,547,1155,2499,3573,3638,883,2755,382,782,1579,2329
139,ELLIS,139,1027,1391027,3281,3658,2358,1300,63,493,668,1150,2791,1913,878,48,342,430,764
29,BEXAR,29,1154C,291154C,407,47,12,35,4,6,24,30,30,7,23,4,1,17,18
29,BEXAR,29,3015,293015,619,2876,767,2109,83,158,1893,2008,2197,675,1522,70,96,1362,1436
229,HUDSPETH,229,04NW,22904NW,5940,67,39,28,0,0,23,23,59,39,20,0,0,15,15
439,TARRANT,439,1022,4391022,7855,1654,917,737,35,143,507,638,1281,772,509,26,99,339,432
113,DALLAS,113,2054,1132054,2259,7401,1745,5656,512,1972,3144,5053,6039,1643,4396,456,1572,2327,3855
201,HARRIS,201,1041,2011041,5259,1439,173,1266,172,709,396,1093,1127,157,970,142,525,303,821
453,TRAVIS,453,0400,4530400,8940,2501,1828,673,202,113,312,417,2451,1802,649,191,111,301,406
453,TRAVIS,453,0455,4530455,8983,2829,1471,1358,222,173,969,1101,2336,1267,1069,180,120,755,848
355,NUECES,355,0059,3550059,7174,2355,866,1489,65,98,1322,1396,1867,751,1116,47,70,979,1037
187,GUADALUPE,187,0109,1870109,4068,973,640,333,9,33,260,286,763,556,207,5,17,152,168
113,DALLAS,113,1408,1131408,2153,22,3,19,0,1,18,19,18,3,15,0,1,14,15
29,BEXAR,29,1136,291136,387,493,94,399,20,53,352,386,334,66,268,14,37,228,255
355,NUECES,355,0016,3550016,7131,1521,577,944,66,28,838,861,995,390,605,45,17,542,556
29,BEXAR,29,2038,292038,450,1922,561,1361,28,86,1248,1312,1587,501,1086,24,62,1000,1048
459,UPSHUR,459,0004,4590004,9046,1831,1413,418,14,168,159,322,1282,1020,262,10,128,79,207
225,HOUSTON,225,0001,2250001,5877,1931,815,1116,21,635,414,1044,1461,690,771,15,450,265,715
29,BEXAR,29,1094,291094,344,6156,766,5390,229,690,4537,5110,3932,583,3349,170,396,2786,3137
29,BEXAR,29,1031,291031,281,3035,137,2898,16,53,2829,2867,2290,118,2172,12,37,2112,2143
113,DALLAS,113,1738,1131738,2196,6499,2269,4230,490,2030,1657,3597,5013,1991,3022,391,1412,1136,2501
239,JACKSON,239,0009,2390009,6003,797,595,202,15,19,142,158,642,501,141,11,15,96,109
439,TARRANT,439,1207,4391207,7918,4391,1832,2559,102,1441,969,2361,3330,1610,1720,69,957,631,1574
429,STEPHENS,429,0001,4290001,7812,2014,1339,675,31,60,521,570,1536,1093,443,19,39,326,361
113,DALLAS,113,1124,1131124,2090,58,10,48,0,4,44,48,30,4,26,0,0,26,26
245,JEFFERSON,245,0081,2450081,6109,1139,14,1125,10,936,179,1110,834,10,824,8,708,107,813
197,HARDEMAN,197,0001,1970001,4194,881,612,269,16,54,200,242,695,509,186,11,36,128,161
349,NAVARRO,349,0301,3490301,7068,657,258,399,12,90,248,331,491,227,264,7,53,163,215
27,BELL,27,0214,270214,218,7589,2757,4832,486,2570,1848,4180,5067,2020,3047,299,1522,1160,2580
439,TARRANT,439,1437,4391437,7981,975,400,575,73,153,343,486,759,354,405,56,121,215,332
113,DALLAS,113,2505,1132505,2385,3402,1880,1522,289,400,785,1162,2805,1625,1180,253,296,578,861
29,BEXAR,29,2163,292163,576,3676,1234,2442,270,236,1929,2127,2951,1045,1906,220,180,1472,1633
41,BRAZOS,41,0066,410066,1257,2192,1135,1057,149,272,607,844,1781,1009,772,113,203,418,611
467,VAN ZANDT,467,002B,467002B,9109,2254,1947,307,10,31,189,218,1815,1601,214,8,24,111,135
141,EL PASO,141,0011,1410011,3324,5855,825,5030,195,179,4709,4831,4443,700,3743,143,108,3505,3592
201,HARRIS,201,0146,2010146,4363,3112,1655,1457,299,320,804,1113,2364,1341,1023,209,239,520,754
251,JOHNSON,251,0013,2510013,6172,3720,2873,847,44,55,598,641,2941,2338,603,33,38,398,431
439,TARRANT,439,3183,4393183,8276,6598,2715,3883,1191,1130,1322,2378,4999,2246,2753,892,727,947,1634
113,DALLAS,113,2138,1132138,2322,4095,401,3694,410,890,2406,3268,2933,361,2572,258,700,1616,2302
201,HARRIS,201,0978,2010978,5196,385,119,266,34,30,203,225,269,105,164,26,18,120,138
257,KAUFMAN,257,0014,2570014,6235,5334,1959,3375,357,1656,1289,2903,3490,1385,2105,239,997,778,1765
439,TARRANT,439,1676,4391676,8044,674,273,401,15,140,238,366,525,233,292,14,102,166,264
187,GUADALUPE,187,0408,1870408,4131,3019,1711,1308,87,130,1034,1143,2144,1290,854,68,82,658,730
29,BEXAR,29,2100,292100,513,2282,288,1994,35,88,1882,1948,1671,251,1420,26,53,1333,1378
453,TRAVIS,453,0350,4530350,8894,6883,3503,3380,1401,381,1476,1834,5567,3002,2565,1064,275,1120,1378
343,MORRIS,343,0202,3430202,7022,1340,1131,209,7,87,95,181,1087,953,134,5,56,55,111
131,DUVAL,131,0001,1310001,3192,2400,116,2284,18,20,1995,2001,1724,93,1631,14,13,1424,1430
201,HARRIS,201,0889,2010889,5107,355,153,202,24,87,97,171,326,148,178,23,70,87,148
29,BEXAR,29,1091,291091,341,4267,280,3987,65,108,3825,3894,3023,241,2782,44,78,2652,2711
453,TRAVIS,453,0394,4530394,8937,4316,2578,1738,896,247,508,731,3171,1957,1214,675,152,308,454
453,TRAVIS,453,0452,4530452,8980,4367,2046,2321,364,353,1564,1865,3202,1571,1631,264,238,1081,1289
201,HARRIS,201,0932,2010932,5150,0,0,0,0,0,0,0,0,0,0,0,0,0,0
49,BROWN,49,0105,490105,1320,2427,1839,588,21,93,426,503,1875,1479,396,18,43,285,324
135,ECTOR,135,0309,1350309,3235,2354,903,1451,27,160,1246,1386,1728,748,980,17,99,834,932
245,JEFFERSON,245,0058,2450058,6086,807,594,213,37,25,111,135,616,481,135,31,14,64,77
113,DALLAS,113,2051,1132051,2256,3538,2492,1046,148,236,596,808,2531,1849,682,101,162,381,530
349,NAVARRO,349,0205,3490205,7065,1467,1236,231,12,27,146,173,1207,1066,141,7,17,88,105
191,HALL,191,0301,1910301,4171,187,113,74,1,15,49,62,138,82,56,0,13,37,49
439,TARRANT,439,1491,4391491,8001,20,8,12,0,6,9,12,13,8,5,0,3,4,5
355,NUECES,355,0036,3550036,7151,1200,202,998,10,21,963,974,915,171,744,7,12,716,725
439,TARRANT,439,2307,4392307,8130,5112,2739,2373,653,885,737,1578,3915,2240,1675,457,620,487,1097
201,HARRIS,201,0083,2010083,4300,5966,1364,4602,363,1754,2480,4169,4278,1087,3191,277,1267,1627,2863
141,EL PASO,141,0008,1410008,3321,3282,1451,1831,55,47,1700,1724,2563,1196,1367,41,27,1261,1282
29,BEXAR,29,2015,292015,427,3683,107,3576,11,65,3529,3560,2652,75,2577,7,26,2546,2563
355,NUECES,355,0079,3550079,7194,2018,180,1838,6,190,1646,1819,1451,158,1293,3,131,1153,1279
141,EL PASO,141,0051,1410051,3364,3788,915,2873,165,446,2328,2680,3042,827,2215,138,351,1740,2044
201,HARRIS,201,0041,2010041,4257,2770,740,2030,163,880,957,1808,1990,579,1411,109,635,627,1252
439,TARRANT,439,2147,4392147,8087,1945,1236,709,61,193,400,576,1531,1047,484,36,150,249,391
113,DALLAS,113,2113,1132113,2299,19,9,10,1,3,5,7,17,9,8,1,1,5,5
201,HARRIS,201,1104,2011104,5322,3965,1596,2369,576,617,1132,1717,2749,1135,1614,390,377,770,1142
61,CAMERON,61,0080,610080,1492,5699,1527,4172,109,86,3941,4001,4231,1376,2855,89,47,2674,2712
245,JEFFERSON,245,0101,2450101,6129,14,10,4,0,1,3,4,14,10,4,0,1,3,4
41,BRAZOS,41,0069,410069,1260,5765,3965,1800,754,234,677,892,3756,2653,1103,501,139,376,503
29,BEXAR,29,1074,291074,324,52,3,49,0,0,48,48,37,3,34,0,0,34,34
455,TRINITY,455,0019,4550019,9023,1688,1196,492,11,134,314,448,1299,976,323,9,95,194,289
53,BURNET,53,0014,530014,1363,745,613,132,4,16,77,92,611,515,96,1,10,53,63
121,DENTON,121,4164,1214164,3089,7172,4491,2681,381,610,1521,2087,5660,3707,1953,303,454,1051,1491
439,TARRANT,439,1376,4391376,7958,4116,1779,2337,3,1601,767,2333,4086,1779,2307,3,1577,761,2303
257,KAUFMAN,257,0037,2570037,6258,4112,1456,2656,72,1589,939,2495,2550,984,1566,52,947,531,1466
113,DALLAS,113,2901,1132901,2428,3666,1280,2386,366,774,1197,1925,3201,1189,2012,326,641,989,1590
201,HARRIS,201,0975,2010975,5193,264,115,149,5,52,93,144,202,92,110,5,41,65,105
181,GRAYSON,181,0410,1810410,4025,3686,2536,1150,110,308,530,824,2920,2132,788,74,187,360,543
113,DALLAS,113,1159,1131159,2110,0,0,0,0,0,0,0,0,0,0,0,0,0,0
453,TRAVIS,453,0265,4530265,8834,2959,1746,1213,282,239,654,863,2613,1568,1045,235,194,582,750
339,MONTGOMERY,339,0026,3390026,6919,6826,2887,3939,82,239,3433,3643,4804,2287,2517,66,142,2151,2285
201,HARRIS,201,0743,2010743,4961,746,71,675,6,36,627,653,537,65,472,4,18,446,461
233,HUTCHINSON,233,0041,2330041,5983,84,67,17,0,5,8,13,63,50,13,0,4,5,9
439,TARRANT,439,1133,4391133,7898,2985,1475,1510,39,162,1269,1415,2289,1257,1032,25,109,868,966
27,BELL,27,0401,270401,238,5169,1991,3178,295,1677,1185,2670,3778,1584,2194,216,1126,797,1808
187,GUADALUPE,187,0227,1870227,4111,943,549,394,4,48,322,364,751,474,277,1,34,223,254
29,BEXAR,29,2143,292143,556,3683,971,2712,143,359,2224,2507,2923,847,2076,102,283,1663,1906
113,DALLAS,113,3034,1133034,2471,2538,81,2457,15,1214,1248,2446,1826,76,1750,13,960,788,1741
37,BOWIE,37,018A,37018A,1111,130,92,38,3,28,3,31,101,65,36,2,27,3,30
23,BAYLOR,23,0004,230004,175,871,715,156,7,20,102,121,645,559,86,2,9,55,64
339,MONTGOMERY,339,0063B,3390063B,6962,73,64,9,0,0,5,5,61,53,8,0,0,4,4
201,HARRIS,201,0829,2010829,5047,125,60,65,10,23,41,53,94,47,47,9,15,28,37
29,BEXAR,29,2058,292058,470,4294,382,3912,27,63,3831,3874,3268,345,2923,18,39,2854,2890
141,EL PASO,141,0157,1410157,3470,960,23,937,7,8,922,930,724,18,706,3,3,698,701
461,UPTON,461,0004,4610004,9066,811,284,527,5,28,477,501,593,244,349,1,18,311,328
59,CALLAHAN,59,0002,590002,1406,2747,2266,481,32,83,245,324,2182,1845,337,28,60,165,221
201,HARRIS,201,0189,2010189,4406,2458,1668,790,228,73,459,517,1616,1139,477,119,44,299,335
113,DALLAS,113,2202,1132202,2342,2357,1968,389,181,32,134,165,1744,1478,266,117,18,99,117
255,KARNES,255,0009,2550009,6215,231,140,91,3,4,84,87,192,127,65,2,1,60,61
201,HARRIS,201,1061,2011061,5279,5696,629,5067,170,3104,1836,4831,4125,543,3582,141,2159,1300,3402
439,TARRANT,439,2536,4392536,8193,2832,1174,1658,274,868,481,1328,2358,1046,1312,244,664,356,1012
43,BREWSTER,43,0003,430003,1303,488,270,218,3,1,204,204,414,245,169,3,0,159,159
199,HARDIN,199,0017,1990017,4214,1620,1474,146,10,18,65,80,1207,1110,97,10,9,37,45
469,VICTORIA,469,0009,4690009,9129,1536,559,977,29,126,814,909,1136,457,679,23,87,553,628
61,CAMERON,61,0057,610057,1469,653,35,618,8,11,598,605,481,33,448,8,5,432,437
141,EL PASO,141,0094,1410094,3407,4582,576,4006,44,155,3814,3931,3523,509,3014,32,113,2855,2948
125,DICKENS,125,0002,1250002,3175,173,132,41,2,2,35,36,123,101,22,2,2,16,17
29,BEXAR,29,2120,292120,533,4021,1193,2828,294,442,2155,2545,2745,862,1883,202,280,1406,1671
113,DALLAS,113,2032,1132032,2239,3859,1918,1941,662,532,691,1201,3556,1835,1721,594,473,597,1051
139,ELLIS,139,1024,1391024,3278,3398,2064,1334,47,197,983,1147,2499,1603,896,33,110,669,770
39,BRAZORIA,39,0061,390061,1174,1448,873,575,58,31,453,475,1153,743,410,39,22,326,341
201,HARRIS,201,0126,2010126,4343,6344,4215,2129,217,233,1513,1730,4656,3239,1417,141,158,1001,1155
459,UPSHUR,459,0001,4590001,9043,2360,1871,489,9,185,187,370,1825,1468,357,7,139,121,259
355,NUECES,355,0013,3550013,7128,1497,40,1457,9,23,1442,1449,1147,33,1114,4,15,1104,1110
201,HARRIS,201,0060,2010060,4277,4209,2505,1704,521,262,872,1102,3674,2303,1371,421,200,694,882
29,BEXAR,29,2035,292035,447,1606,720,886,34,49,801,837,1425,664,761,27,38,690,720
113,DALLAS,113,2312,1132312,2362,470,77,393,21,36,335,366,380,64,316,21,35,260,291
465,VAL VERDE,465,0012B,4650012B,9086,432,24,408,1,5,402,406,290,24,266,1,5,260,264
355,NUECES,355,0056,3550056,7171,2610,278,2332,35,188,2131,2271,1695,196,1499,20,88,1378,1452
201,HARRIS,201,1038,2011038,5256,4414,2193,2221,193,857,1120,1938,2920,1496,1424,108,580,699,1258
143,ERATH,143,0041,1430041,3553,967,825,142,6,12,99,108,769,663,106,5,11,72,80
29,BEXAR,29,2077,292077,490,3297,1002,2295,107,202,1971,2139,2553,850,1703,81,144,1450,1579
113,DALLAS,113,2604,1132604,2405,5928,1623,4305,2358,1287,655,1887,4643,1440,3203,1791,896,487,1353
207,HASKELL,207,0010,2070010,5425,222,163,59,1,3,43,44,182,141,41,0,2,26,27
245,JEFFERSON,245,0078,2450078,6106,3044,810,2234,124,1525,568,2075,2203,676,1527,94,1021,390,1405
439,TARRANT,439,1597,4391597,8021,1419,98,1321,26,120,1176,1284,986,83,903,20,73,805,874
479,WEBB,479,0255,4790255,9255,3733,233,3500,100,148,3275,3400,2886,198,2688,74,142,2490,2611
453,TRAVIS,453,0330,4530330,8874,5551,3211,2340,575,298,1390,1639,4926,2968,1958,489,240,1154,1353
367,PARKER,367,0111,3670111,7340,2412,1854,558,29,68,366,424,1796,1426,370,25,38,221,254
141,EL PASO,141,0114,1410114,3427,8012,423,7589,128,251,7261,7446,6015,346,5669,90,171,5428,5566
201,HARRIS,201,1124,2011124,5342,0,0,0,0,0,0,0,0,0,0,0,0,0,0
61,CAMERON,61,0100,610100,1512,7120,339,6781,138,49,6591,6614,5137,268,4869,97,29,4739,4756
71,CHAMBERS,71,0004,710004,1555,5771,4307,1464,181,272,822,1079,4134,3186,948,112,171,518,679
271,KINNEY,271,0003,2710003,6321,695,159,536,4,23,497,517,551,134,417,4,20,382,402
201,HARRIS,201,0912,2010912,5130,2824,805,2019,174,780,1030,1796,2127,714,1413,136,521,722,1236
113,DALLAS,113,2028,1132028,2236,5,0,5,2,0,3,3,3,0,3,2,0,1,1
187,GUADALUPE,187,0224,1870224,4108,275,30,245,0,15,234,243,199,23,176,0,11,166,174
201,HARRIS,201,0955,2010955,5173,5179,2981,2198,609,222,1281,1480,3355,1998,1357,352,157,802,945
355,NUECES,355,0098,3550098,7214,2620,91,2529,42,216,2280,2481,1993,73,1920,35,193,1694,1875
141,EL PASO,141,0071,1410071,3384,2985,271,2714,23,38,2659,2682,2464,230,2234,15,27,2192,2210
113,DALLAS,113,2221,1132221,2345,4804,4251,553,226,26,183,205,3076,2767,309,116,15,118,130
139,ELLIS,139,1047,1391047,3301,576,345,231,11,19,179,197,420,274,146,8,12,113,124
249,JIM WELLS,249,0012,2490012,6149,3458,493,2965,25,29,2892,2910,2543,415,2128,16,15,2071,2081
113,DALLAS,113,2133,1132133,2319,352,151,201,8,114,78,189,290,151,139,8,69,61,127
339,MONTGOMERY,339,0102,3390102,7002,5629,4088,1541,266,305,802,1091,4409,3361,1048,189,211,527,729
439,TARRANT,439,1801,4391801,8067,0,0,0,0,0,0,0,0,0,0,0,0,0,0
41,BRAZOS,41,0089B,410089B,1280,2,0,2,0,0,2,2,0,0,0,0,0,0,0
201,HARRIS,201,0786,2010786,5004,4029,351,3678,24,82,3583,3641,2863,317,2546,19,57,2470,2510
131,DUVAL,131,0004,1310004,3195,157,31,126,0,0,125,125,122,31,91,0,0,90,90
251,JOHNSON,251,0036,2510036,6195,3253,1297,1956,35,153,1699,1834,2274,973,1301,26,98,1120,1214
439,TARRANT,439,1514,4391514,8004,0,0,0,0,0,0,0,0,0,0,0,0,0,0
439,TARRANT,439,1679,4391679,8047,0,0,0,0,0,0,0,0,0,0,0,0,0,0
453,TRAVIS,453,0210,4530210,8791,2347,1928,419,120,22,221,241,1770,1485,285,67,15,155,169
335,MITCHELL,335,0002,3350002,6876,3837,1362,2475,17,810,1651,2434,3401,1199,2202,13,750,1426,2168
201,HARRIS,201,0849,2010849,5067,4645,313,4332,195,403,3795,4105,3513,284,3229,172,316,2781,3029
201,HARRIS,201,0106,2010106,4323,865,110,755,12,27,714,737,613,91,522,7,21,490,509
245,JEFFERSON,245,0104,2450104,6132,81,59,22,1,8,13,21,72,59,13,0,3,10,13
339,MONTGOMERY,339,0082,3390082,6982,5886,3530,2356,321,357,1550,1890,4510,2862,1648,251,274,1023,1292
29,BEXAR,29,1008,291008,258,2587,766,1821,67,139,1614,1721,2167,685,1482,51,100,1306,1392
41,BRAZOS,41,0026,410026,1217,5164,3324,1840,143,608,988,1554,4013,2723,1290,109,404,681,1071
339,MONTGOMERY,339,0043B,3390043B,6939,16,8,8,0,1,6,7,10,3,7,0,1,5,6
121,DENTON,121,2102,1212102,3026,11168,2879,8289,949,3722,3569,7141,8588,2575,6013,769,2641,2485,5044
453,TRAVIS,453,0302,4530302,8854,4755,3631,1124,449,124,434,554,4570,3497,1073,430,120,418,536
29,BEXAR,29,2061,292061,473,2015,466,1549,364,165,1027,1166,1563,388,1175,279,117,775,881
439,TARRANT,439,2229,4392229,8110,3870,1940,1930,146,759,939,1663,2939,1617,1322,119,495,629,1103
121,DENTON,121,4206,1214206,3132,3054,2548,506,126,61,209,262,2385,2030,355,82,39,151,185
49,BROWN,49,0202,490202,1323,2658,1611,1047,19,198,758,936,2040,1329,711,12,131,514,631
113,DALLAS,113,2508,1132508,2388,6795,2719,4076,1065,1091,1849,2902,5593,2380,3213,895,879,1352,2202
201,HARRIS,201,1018,2011018,5236,0,0,0,0,0,0,0,0,0,0,0,0,0,0
29,BEXAR,29,1071,291071,321,3394,579,2815,102,310,2452,2690,2480,477,2003,78,194,1719,1897
347,NACOGDOCHES,347,0041,3470041,7045,2116,808,1308,60,791,419,1193,1493,661,832,42,513,247,753
113,DALLAS,113,1735,1131735,2193,7684,3074,4610,2065,1022,1436,2415,6043,2666,3377,1570,726,979,1688
29,BEXAR,29,1133,291133,384,74,6,68,12,18,51,62,49,6,43,4,10,33,37
39,BRAZORIA,39,0041,390041,1154,3187,1118,2069,804,734,517,1240,2367,864,1503,577,560,342,897
139,ELLIS,139,1004,1391004,3258,0,0,0,0,0,0,0,0,0,0,0,0,0,0
61,CAMERON,61,0037,610037,1449,4675,114,4561,9,19,4536,4544,3254,80,3174,8,12,3157,3163
201,HARRIS,201,1081,2011081,5299,550,15,535,39,92,404,491,429,10,419,38,74,307,379
55,CALDWELL,55,0303,550303,1386,1799,610,1189,21,58,1091,1140,1312,516,796,13,39,722,759
201,HARRIS,201,0044,2010044,4260,3799,564,3235,70,229,2924,3140,2980,472,2508,50,187,2253,2432
353,NOLAN,353,0002,3530002,7108,1535,1021,514,4,82,391,460,1166,843,323,3,44,243,283
439,TARRANT,439,2461,4392461,8173,5779,738,5041,482,2056,2506,4494,4181,628,3553,408,1388,1728,3097
329,MIDLAND,329,0105,3290105,6813,4000,1135,2865,132,207,2459,2629,2859,923,1936,98,141,1619,1750
141,EL PASO,141,0177,1410177,3490,828,268,560,27,18,511,525,708,256,452,17,16,415,427
201,HARRIS,201,0018,2010018,4234,1895,1010,885,439,147,264,398,1481,821,660,327,116,194,304
477,WASHINGTON,477,0205,4770205,9212,3852,2765,1087,138,493,401,875,3012,2322,690,106,317,228,539
453,TRAVIS,453,0375,4530375,8917,4542,3712,830,173,90,429,503,3648,3075,573,128,58,282,337
245,JEFFERSON,245,0015,2450015,6043,2684,164,2520,100,1165,1265,2405,2025,133,1892,80,934,878,1801
457,TYLER,457,0013,4570013,9037,1066,955,111,3,40,44,84,872,794,78,1,35,25,60
355,NUECES,355,0007,3550007,7122,1361,106,1255,15,157,1108,1239,1014,86,928,11,100,827,916
439,TARRANT,439,2217,4392217,8101,7309,2174,5135,243,2039,2800,4763,5186,1816,3370,193,1344,1773,3075
201,HARRIS,201,0989,2010989,5207,23,0,23,2,11,12,22,7,0,7,1,3,4,6
251,JOHNSON,251,0027,2510027,6186,3569,2889,680,29,104,438,532,2675,2216,459,25,74,270,342
201,HARRIS,201,0054,2010054,4271,2554,1658,896,243,117,502,606,2151,1448,703,186,88,401,481
139,ELLIS,139,1021,1391021,3275,2194,1491,703,12,97,531,624,1658,1169,489,8,75,355,429
439,TARRANT,439,2353,4392353,8144,2604,605,1999,181,692,1128,1788,1844,514,1330,143,460,711,1152
29,BEXAR,29,2071,292071,484,1711,41,1670,8,22,1650,1659,1252,32,1220,3,17,1206,1213
201,HARRIS,201,0097,2010097,4314,5131,3200,1931,76,458,1279,1709,3610,2317,1293,55,321,814,1127
199,HARDIN,199,0014,1990014,4211,1826,1555,271,10,59,117,176,1328,1142,186,8,41,71,112
463,UVALDE,463,0012,4630012,9080,4039,1117,2922,83,45,2782,2802,2917,957,1960,65,26,1849,1862
141,EL PASO,141,0065,1410065,3378,4815,1964,2851,274,1008,1447,2303,2915,1306,1609,151,535,809,1288
453,TRAVIS,453,0449,4530449,8977,5628,2900,2728,226,385,2047,2380,4397,2442,1955,167,272,1442,1694
201,HARRIS,201,0929,2010929,5147,0,0,0,0,0,0,0,0,0,0,0,0,0,0
113,DALLAS,113,3005,1133005,2442,2012,1094,918,147,455,289,738,1831,1070,761,145,314,270,581
29,BEXAR,29,1130,291130,381,7,0,7,0,4,2,6,2,0,2,0,1,0,1
355,NUECES,355,0092B,3550092B,7208,127,42,85,3,7,78,79,87,34,53,0,0,49,49
201,HARRIS,201,1032,2011032,5250,497,238,259,51,90,110,196,450,225,225,47,78,90,166
41,BRAZOS,41,0083,410083,1274,22,16,6,0,1,4,5,12,10,2,0,0,1,1
249,JIM WELLS,249,0006,2490006,6143,1809,191,1618,1,10,1421,1425,1348,141,1207,0,6,1061,1064
245,JEFFERSON,245,0012,2450012,6040,662,29,633,0,566,63,628,525,29,496,0,458,33,491
339,MONTGOMERY,339,0077,3390077,6976,5280,4507,773,103,87,459,536,4506,3915,591,83,60,346,401
113,DALLAS,113,1752,1131752,2210,4952,1997,2955,943,790,1144,1886,3884,1687,2197,741,549,826,1354
453,TRAVIS,453,0291,4530291,8848,1533,1110,423,192,36,174,208,1158,859,299,132,27,122,149
339,MONTGOMERY,339,0038,3390038,6933,5101,4045,1056,155,164,557,715,3932,3226,706,106,107,363,467
39,BRAZORIA,39,0075,390075,1188,5590,2779,2811,148,505,2096,2536,4206,2272,1934,95,351,1390,1715
239,JACKSON,239,0003,2390003,5997,2818,1862,956,49,143,685,812,2154,1494,660,31,100,459,554
27,BELL,27,0205,270205,209,9149,2175,6974,489,3845,2703,6212,6646,1820,4826,370,2630,1764,4233
29,BEXAR,29,1002,291002,252,1039,171,868,67,107,711,803,777,141,636,52,85,504,578
121,DENTON,121,2073,1212073,2997,6419,4102,2317,378,637,1122,1715,4966,3360,1606,258,444,762,1178
201,HARRIS,201,0843,2010843,5061,2620,209,2411,76,824,1554,2340,1970,179,1791,56,688,1075,1736
439,TARRANT,439,1076,4391076,7869,1454,1133,321,49,104,150,249,1117,887,230,29,82,107,184
439,TARRANT,439,1188,4391188,7912,949,43,906,4,591,304,890,724,37,687,2,468,205,672
113,DALLAS,113,1301,1131301,2124,5809,1322,4487,131,1046,3322,4301,4205,1161,3044,99,738,2174,2890
39,BRAZORIA,39,0012,390012,1125,5826,2382,3444,357,475,2553,2990,4289,1941,2348,237,316,1736,2039
453,TRAVIS,453,0391,4530391,8934,4437,3142,1295,570,106,540,636,2886,2107,779,344,69,317,384
329,MIDLAND,329,0408,3290408,6847,3345,2622,723,121,67,460,521,2508,1990,518,90,39,334,373
29,BEXAR,29,1088,291088,338,1646,48,1598,9,32,1567,1590,1241,44,1197,5,16,1177,1190
113,DALLAS,113,2048,1132048,2253,8044,3498,4546,561,1936,1981,3835,7069,3367,3702,511,1572,1542,3060
427,STARR,427,0009,4270009,7806,4347,36,4311,3,18,4297,4303,3115,30,3085,1,10,3074,3079
47,BROOKS,47,0004,470004,1317,1751,129,1622,10,12,1603,1607,1227,103,1124,8,4,1110,1114
453,TRAVIS,453,0143,4530143,8742,7037,1306,5731,405,2033,3360,5271,4936,1058,3878,287,1434,2175,3549
113,DALLAS,113,1088,1131088,2061,6607,617,5990,27,922,5094,5909,4669,577,4092,20,690,3418,4029
439,TARRANT,439,1482,4391482,7998,2393,171,2222,22,300,1924,2207,1599,136,1463,12,226,1230,1451
21,BASTROP,21,1001,211001,146,466,365,101,10,17,61,77,387,304,83,10,13,46,59
61,CAMERON,61,0094,610094,1506,2733,103,2630,9,32,2605,2611,1866,74,1792,4,19,1781,1785
453,TRAVIS,453,0325,4530325,8871,1463,576,887,702,18,125,142,969,388,581,460,11,80,91
41,BRAZOS,41,0020,410020,1211,12137,6609,5528,1437,816,3526,4014,11872,6517,5355,1393,784,3427,3889
201,HARRIS,201,1075,2011075,5293,0,0,0,0,0,0,0,0,0,0,0,0,0,0
245,JEFFERSON,245,0098,2450098,6126,1259,536,723,286,208,221,423,963,444,519,213,151,146,292
187,GUADALUPE,187,0102,1870102,4062,1571,894,677,23,105,555,641,1252,770,482,12,74,384,454
439,TARRANT,439,1277,4391277,7935,1943,992,951,81,523,301,810,1641,910,731,71,363,240,599
201,HARRIS,201,0140,2010140,4357,5214,1501,3713,542,2438,754,3139,4528,1431,3097,478,2038,600,2599
349,NAVARRO,349,0202,3490202,7062,2743,294,2449,9,368,2023,2369,1855,229,1626,8,296,1282,1569
201,HARRIS,201,0780,2010780,4998,2093,182,1911,25,80,1800,1869,1442,147,1295,23,53,1208,1258
355,NUECES,355,0050,3550050,7165,899,225,674,21,70,594,641,710,200,510,17,44,448,484
245,JEFFERSON,245,0035,2450035,6063,2049,1308,741,140,263,297,555,1692,1083,609,92,245,236,476
29,BEXAR,29,1025,291025,275,1416,85,1331,2,9,1323,1324,1005,53,952,2,6,944,945
129,DONLEY,129,0301,1290301,3189,401,319,82,5,29,30,56,315,261,54,3,14,21,34
333,MILLS,333,0004,3330004,6870,981,741,240,11,14,177,185,805,624,181,7,11,129,135
181,GRAYSON,181,0201,1810201,3996,5876,4019,1857,86,586,831,1393,4468,3262,1206,48,363,515,863
201,HARRIS,201,1138,2011138,5356,3090,304,2786,717,845,1247,2039,2178,221,1957,566,578,818,1367
121,DENTON,121,3136,1213136,3060,2827,1488,1339,451,315,550,835,2115,1210,905,295,224,365,576
339,MONTGOMERY,339,0099,3390099,6999,4812,3841,971,115,135,579,694,3646,3002,644,90,90,373,451
187,GUADALUPE,187,0311,1870311,4125,4711,2212,2499,225,496,1742,2162,3734,1897,1837,163,337,1267,1576
229,HUDSPETH,229,0002,2290002,5934,553,19,534,0,1,532,533,381,17,364,0,1,362,363
257,KAUFMAN,257,0008,2570008,6229,4388,1829,2559,84,671,1723,2363,3113,1474,1639,62,443,1054,1483
439,TARRANT,439,1175,4391175,7909,3312,1155,2157,784,689,632,1298,2397,891,1506,567,452,428,868
439,TARRANT,439,2606,4392606,8207,44,15,29,2,10,16,24,28,10,18,0,6,9,15
113,DALLAS,113,4054,1134054,2712,1501,35,1466,19,57,1400,1439,1079,30,1049,12,42,1001,1029
157,FORT BEND,157,2021,1572021,3648,982,739,243,12,20,173,188,776,597,179,9,10,134,141
215,HIDALGO,215,0011,2150011,5563,3259,63,3196,6,9,3161,3165,2287,46,2241,6,6,2224,2227
29,BEXAR,29,4092,294092,903,2571,1018,1553,66,419,1116,1463,1994,935,1059,51,278,717,983
113,DALLAS,113,4523,1134523,2818,653,188,465,65,267,131,395,521,171,350,46,210,88,296
439,TARRANT,439,4493,4394493,8537,2976,2080,896,228,167,429,585,2813,2009,804,206,141,385,520
491,WILLIAMSON,491,0391,4910391,9499,2156,1722,434,59,62,265,318,1759,1442,317,39,47,183,227
439,TARRANT,439,3570,4393570,8371,5565,2995,2570,784,630,1010,1599,3969,2270,1699,521,417,650,1054
29,BEXAR,29,3107,293107,711,1322,795,527,42,34,430,457,1024,652,372,26,19,312,327
215,HIDALGO,215,0177,2150177,5729,2114,111,2003,1,11,1990,1991,1431,86,1345,1,6,1334,1335
491,WILLIAMSON,491,0180,4910180,9410,6939,3049,3890,420,1061,2334,3305,5278,2535,2743,329,696,1615,2276
201,HARRIS,201,0473,2010473,4690,2394,1613,781,148,111,430,535,1887,1352,535,101,75,280,354
481,WHARTON,481,0103,4810103,9307,4454,1878,2576,29,515,1996,2472,3349,1546,1803,24,400,1332,1715
309,MCLENNAN,309,0033,3090033,6665,2168,1459,709,68,224,383,585,1683,1228,455,49,134,235,366
439,TARRANT,439,4191,4394191,8474,2453,1136,1317,179,148,953,1077,1839,964,875,142,74,610,682
157,FORT BEND,157,4002,1574002,3754,1025,75,950,16,435,496,924,794,61,733,9,367,351,717
201,HARRIS,201,0281,2010281,4498,3086,2123,963,450,177,306,469,2127,1493,634,281,123,199,317
297,LIVE OAK,297,0010,2970010,6499,499,313,186,3,4,162,165,404,261,143,3,0,128,128
401,RUSK,401,0302,4010302,7601,1904,708,1196,16,782,384,1149,1370,564,806,13,540,232,770
303,LUBBOCK,303,0050,3030050,6562,6437,629,5808,1799,3576,139,3713,6183,605,5578,1725,3431,134,3563
449,TITUS,449,0016,4490016,8666,4283,2230,2053,53,463,1500,1943,3186,1862,1324,34,330,916,1238
201,HARRIS,201,0576,2010576,4793,4225,239,3986,55,2639,1298,3899,3077,180,2897,45,1984,857,2829
303,LUBBOCK,303,0128,3030128,6602,2281,1773,508,38,55,368,417,1860,1516,344,26,37,240,277
7,ARANSAS,7,0002,70002,70,5697,2818,2879,135,86,2439,2514,4461,2391,2070,109,51,1731,1774
423,SMITH,423,0009,4230009,7730,782,111,671,10,208,450,651,535,84,451,6,159,277,435
325,MEDINA,325,003A,325003A,6794,1583,1048,535,8,18,487,496,1292,882,410,8,8,370,375
157,FORT BEND,157,1104,1571104,3625,8139,4411,3728,1200,1084,1414,2443,6028,3487,2541,826,722,934,1625
29,BEXAR,29,4029,294029,840,4311,275,4036,53,565,3496,3990,3219,248,2971,35,445,2536,2935
201,HARRIS,201,0344,2010344,4561,2037,41,1996,12,893,1111,1973,1482,33,1449,8,707,738,1434
393,ROBERTS,393,04-1,39304-1,7538,99,87,12,3,2,4,4,76,69,7,1,1,1,1
491,WILLIAMSON,491,0482,4910482,9539,4901,3054,1847,1073,202,488,676,3231,2143,1088,620,131,291,420
375,POTTER,375,0326,3750326,7435,5180,3273,1907,92,166,1456,1599,3930,2684,1246,69,96,920,1008
29,BEXAR,29,4132,294132,943,3569,890,2679,218,1312,1221,2430,2614,716,1898,157,938,824,1711
215,HIDALGO,215,0074,2150074,5626,2342,190,2152,45,36,2100,2112,1542,148,1394,25,10,1369,1370
91,COMAL,91,0305,910305,1922,5794,3191,2603,149,234,2085,2271,4148,2362,1786,107,146,1420,1535
215,HIDALGO,215,0200,2150200,5752,3303,378,2925,165,62,2691,2745,2510,325,2185,133,50,1982,2028
1,ANDERSON,1,0007,10007,7,2928,493,2435,35,1122,1274,2354,2048,379,1669,30,773,845,1601
485,WICHITA,485,0107,4850107,9327,5635,3719,1916,227,763,782,1480,4477,3110,1367,177,536,528,1027
441,TAYLOR,441,0104,4410104,8603,3281,2639,642,59,146,370,505,2535,2113,422,45,91,229,315
97,COOKE,97,0012,970012,1965,1448,1236,212,8,9,119,128,1114,976,138,2,6,69,75
159,FRANKLIN,159,0201,1590201,3794,806,659,147,7,16,91,107,606,506,100,6,5,61,66
167,GALVESTON,167,0278,1670278,3880,5415,4138,1277,31,60,973,1023,4228,3337,891,21,29,668,696
373,POLK,373,0016,3730016,7412,3982,2806,1176,60,260,753,994,3008,2219,789,42,165,488,645
379,RAINS,379,0306,3790306,7455,1743,1320,423,20,120,218,336,1376,1064,312,16,94,147,241
489,WILLACY,489,0005,4890005,9370,1239,69,1170,3,4,1165,1165,925,63,862,1,1,857,857
165,GAINES,165,0009,1650009,3837,1940,1163,777,18,26,718,738,1246,734,512,14,13,471,482
491,WILLIAMSON,491,0381,4910381,9496,3122,2968,154,16,10,74,83,3105,2968,137,16,5,69,74
215,HIDALGO,215,0114,2150114,5666,6486,1172,5314,123,75,5162,5179,4723,1086,3637,108,47,3504,3519
29,BEXAR,29,3168,293168,774,795,283,512,176,52,289,334,603,222,381,135,38,208,245
29,BEXAR,29,4089,294089,900,5797,1871,3926,409,1134,2388,3393,4150,1501,2649,282,746,1567,2252
215,HIDALGO,215,0031,2150031,5583,4145,318,3827,55,35,3750,3770,2882,294,2588,39,30,2527,2546
113,DALLAS,113,4520,1134520,2815,2242,340,1902,81,191,1628,1792,1599,279,1320,65,127,1111,1224
385,REAL,385,0005,3850005,7498,546,403,143,4,16,111,126,443,343,100,3,7,76,83
5,ANGELINA,5,0023,50023,50,1210,924,286,17,66,174,238,879,699,180,12,35,108,143
157,FORT BEND,157,2081,1572081,3668,2626,312,2314,346,1002,986,1956,1933,270,1663,280,697,695,1377
445,TERRY,445,0402,4450402,8646,405,284,121,0,0,118,118,260,191,69,0,0,66,66
85,COLLIN,85,0124,850124,1753,6341,2267,4074,2943,493,510,993,4853,2003,2850,2023,357,367,718
113,DALLAS,113,1068,1131068,2048,130,47,83,4,5,76,78,91,41,50,2,3,48,48
313,MADISON,313,0202,3130202,6731,2872,1737,1135,30,425,625,1047,2160,1401,759,27,295,396,688
397,ROCKWALL,397,004E,397004E,7581,4389,2284,2105,177,509,1346,1825,3123,1710,1413,108,339,881,1214
303,LUBBOCK,303,0138,3030138,6605,707,490,217,15,20,153,166,532,376,156,11,12,111,119
475,WARD,475,004E,475004E,9201,2264,841,1423,17,92,1297,1368,1702,686,1016,8,64,925,979
113,DALLAS,113,4072,1134072,2729,791,49,742,9,55,676,717,545,42,503,4,29,455,484
225,HOUSTON,225,0002,2250002,5878,2021,1263,758,12,456,262,711,1637,1079,558,8,374,152,523
85,COLLIN,85,0210,850210,1839,2464,979,1485,1090,192,173,360,1671,701,970,698,139,109,245
491,WILLIAMSON,491,0279,4910279,9453,172,91,81,22,16,39,55,137,75,62,21,13,28,41
303,LUBBOCK,303,0046,3030046,6559,4613,3127,1486,30,50,1263,1298,3204,2245,959,21,18,803,819
219,HOCKLEY,219,0043,2190043,5835,441,266,175,4,11,147,157,332,213,119,3,9,96,105
439,TARRANT,439,4202,4394202,8477,3950,1169,2781,42,73,2624,2687,2896,1002,1894,32,43,1776,1816
29,BEXAR,29,4046,294046,857,3955,1925,2030,219,616,1186,1725,3346,1752,1594,178,450,940,1345
201,HARRIS,201,0470,2010470,4687,2728,1284,1444,47,94,1242,1326,1973,1038,935,30,66,781,844
419,SHELBY,419,0008,4190008,7707,1830,869,961,8,454,483,932,1330,700,630,5,315,290,605
29,BEXAR,29,4135,294135,946,0,0,0,0,0,0,0,0,0,0,0,0,0,0
213,HENDERSON,213,01MN,21301MN,5540,1943,1627,316,14,87,119,201,1622,1366,256,10,73,84,157
141,EL PASO,141,0186,1410186,3499,1272,194,1078,27,95,972,1043,965,177,788,18,64,701,760
201,HARRIS,201,0642,2010642,4859,2465,1585,880,185,184,482,637,2048,1406,642,139,134,326,452
25,BEE,25,0001,250001,176,3209,1050,2159,52,101,1973,2065,2467,898,1569,47,66,1427,1491
405,SAN AUGUSTINE,405,0002,4050002,7624,411,196,215,9,181,32,207,347,170,177,6,147,25,169
113,DALLAS,113,3961,1133961,2646,4215,1794,2421,396,845,1081,1899,3025,1413,1612,273,546,690,1224
181,GRAYSON,181,0301,1810301,4006,4463,2760,1703,375,613,544,1137,3392,2245,1147,233,411,363,770
365,PANOLA,365,0018,3650018,7329,2457,2069,388,11,219,83,296,1935,1639,296,9,172,46,216
157,FORT BEND,157,3065A,1573065A,3711,8491,2012,6479,4755,1050,673,1682,6403,1601,4802,3526,791,457,1225
201,HARRIS,201,0559,2010559,4776,13317,1900,11417,1201,6322,4093,10080,10593,1697,8896,1015,4901,3081,7759
11,ARMSTRONG,11,0401,110401,93,196,156,40,2,10,24,30,155,130,25,1,5,14,16
85,COLLIN,85,0041,850041,1670,5387,3234,2153,756,579,702,1243,3667,2321,1346,490,355,406,748
143,ERATH,143,0020,1430020,3542,2451,1291,1160,16,35,1076,1102,1762,1050,712,6,24,650,667
83,COLEMAN,83,0003,830003,1627,1877,1367,510,19,62,381,437,1452,1119,333,13,36,236,269
309,MCLENNAN,309,0016,3090016,6648,4424,2260,2164,309,730,1040,1728,3323,1838,1485,239,485,678,1147
201,HARRIS,201,0516,2010516,4733,4690,1130,3560,703,1292,1562,2802,3583,1011,2572,550,920,1071,1962
201,HARRIS,201,0490,2010490,4707,3868,855,3013,264,1601,1185,2710,2974,754,2220,211,1181,835,1977
305,LYNN,305,0009,3050009,6622,101,65,36,2,1,34,35,62,40,22,1,0,21,21
439,TARRANT,439,4065,4394065,8431,5963,4258,1705,166,239,1128,1348,4635,3462,1173,124,172,722,888
493,WILSON,493,0415,4930415,9559,4623,3044,1579,69,157,1213,1355,3349,2257,1092,51,130,821,944
175,GOLIAD,175,0041,1750041,3963,450,367,83,1,11,64,72,366,301,65,0,11,47,55
85,COLLIN,85,0167,850167,1796,7404,2802,4602,3346,643,533,1154,5460,2199,3261,2352,457,386,828
153,FLOYD,153,0002,1530002,3605,1331,631,700,14,46,644,676,1013,540,473,5,29,442,462
113,DALLAS,113,4554,1134554,2835,142,13,129,3,55,69,124,96,13,83,1,37,43,80
201,HARRIS,201,0427,2010427,4644,4461,405,4056,444,752,2915,3597,3300,341,2959,360,579,2063,2589
423,SMITH,423,0029,4230029,7750,3044,2107,937,35,495,358,841,2247,1618,629,27,334,223,556
479,WEBB,479,0278,4790278,9264,34,8,26,0,0,26,26,33,8,25,0,0,25,25
29,BEXAR,29,4152,294152,963,3707,922,2785,89,802,1948,2631,2748,802,1946,64,545,1321,1821
85,COLLIN,85,0104,850104,1733,5905,1670,4235,433,2133,1626,3693,4686,1463,3223,341,1616,1207,2791
113,DALLAS,113,4119,1134119,2772,3,0,3,0,0,2,2,0,0,0,0,0,0,0
309,MCLENNAN,309,0078,3090078,6711,5531,3568,1963,64,384,1379,1740,4164,2842,1322,45,258,909,1161
439,TARRANT,439,4397,4394397,8520,833,340,493,8,23,445,463,647,316,331,8,18,284,301
167,GALVESTON,167,0398,1670398,3900,1027,294,733,33,179,509,674,770,241,529,20,151,349,490
113,DALLAS,113,4621,1134621,2861,8997,1396,7601,2143,2702,2714,5325,6523,1155,5368,1430,1945,1959,3846
201,HARRIS,201,0364,2010364,4581,4759,828,3931,171,368,3367,3699,3514,744,2770,135,247,2366,2594
231,HUNT,231,0101,2310101,5941,1788,1343,445,8,87,256,334,1327,1070,257,2,44,131,172
505,ZAPATA,505,0001,5050001,9622,3037,127,2910,9,9,2891,2897,2193,114,2079,6,3,2066,2069
439,TARRANT,439,4253,4394253,8494,987,675,312,27,74,195,268,935,656,279,26,65,172,236
205,HARTLEY,205,0301,2050301,5414,1151,861,290,12,17,246,258,867,678,189,10,12,158,166
439,TARRANT,439,4686,4394686,8583,0,0,0,0,0,0,0,0,0,0,0,0,0,0
215,HIDALGO,215,0157,2150157,5709,2605,54,2551,0,2,2544,2545,1829,38,1791,0,1,1789,1789
29,BEXAR,29,3127,293127,731,2822,1480,1342,374,141,828,939,1961,1098,863,225,101,520,606
113,DALLAS,113,1125,1131125,2091,5595,1052,4543,174,2225,2141,4308,4187,941,3246,127,1608,1494,3072
453,TRAVIS,453,0234,4530234,8809,4187,2705,1482,710,120,608,713,3457,2276,1181,587,90,463,543
201,HARRIS,201,0761,2010761,4979,2262,1616,646,282,73,266,332,1723,1273,450,200,49,184,229
39,BRAZORIA,39,0036,390036,1149,3877,1166,2711,140,166,2360,2500,2710,956,1754,95,123,1492,1603
181,GRAYSON,181,0205,1810205,4000,5439,4485,954,48,109,372,469,4370,3744,626,34,63,221,281
339,MONTGOMERY,339,0001,3390001,6894,4368,1856,2512,86,579,1763,2296,3075,1419,1656,61,351,1141,1486
27,BELL,27,0209,270209,213,6763,2458,4305,694,2291,1338,3444,4582,1709,2873,464,1561,823,2282
227,HOWARD,227,0046,2270046,5915,2280,841,1439,29,168,1245,1370,1591,640,951,22,87,819,889
201,HARRIS,201,0718,2010718,4936,4969,2622,2347,1179,242,869,1099,3815,2082,1733,884,175,609,781
435,SUTTON,435,0101,4350101,7830,812,163,649,7,3,635,638,599,144,455,5,0,446,446
121,DENTON,121,4182,1214182,3107,171,134,37,9,6,15,18,131,108,23,4,0,10,10
121,DENTON,121,2097,1212097,3021,6409,3107,3302,1483,838,926,1721,4954,2516,2438,1138,590,658,1227
339,MONTGOMERY,339,0042,3390042,6937,1629,1033,596,36,29,490,513,1248,854,394,29,21,316,332
201,HARRIS,201,0804,2010804,5022,9102,2580,6522,1377,1645,3454,5025,6764,2093,4671,1068,1102,2439,3508
223,HOPKINS,223,0025,2230025,5872,592,461,131,0,15,91,106,480,385,95,0,8,65,73
423,SMITH,423,0075,4230075,7787,4034,3563,471,47,105,242,340,3313,3021,292,31,62,136,197
453,TRAVIS,453,0300,4530300,8852,2956,1854,1102,400,170,484,642,2800,1787,1013,376,151,447,588
121,DENTON,121,3140,1213140,3064,6021,3635,2386,1625,191,450,623,4132,2602,1530,1035,131,274,392
453,TRAVIS,453,0121,4530121,8723,4435,508,3927,92,1675,2207,3816,3008,431,2577,67,1139,1374,2496
439,TARRANT,439,1377,4391377,7959,6849,3210,3639,418,2052,1157,3129,5559,2834,2725,318,1494,861,2318
41,BRAZOS,41,0001,410001,1192,3047,2232,815,45,142,486,616,2179,1626,553,27,100,334,428
131,DUVAL,131,0002,1310002,3193,1366,50,1316,10,8,1289,1295,1089,45,1044,3,2,1029,1030
343,MORRIS,343,0203,3430203,7023,1546,952,594,17,354,190,538,1189,777,412,11,251,118,367
453,TRAVIS,453,0395,4530395,8938,3660,2654,1006,105,82,702,767,2994,2265,729,82,61,473,523
113,DALLAS,113,1305,1131305,2128,4116,773,3343,36,451,2851,3268,2831,663,2168,26,274,1847,2109
41,BRAZOS,41,0088,410088,1278,4329,2968,1361,228,304,743,1022,3709,2637,1072,197,219,574,784
183,GREGG,183,0016,1830016,4043,7103,4723,2380,91,820,1309,2104,5314,3785,1529,66,542,802,1338
439,TARRANT,439,1081,4391081,7873,4168,1751,2417,856,1078,447,1522,4040,1656,2384,853,1072,440,1509
201,HARRIS,201,0890,2010890,5108,3511,2021,1490,216,587,632,1196,3206,1967,1239,198,469,514,965
231,HUNT,231,0320,2310320,5958,4802,3686,1116,45,80,743,816,3738,3026,712,36,47,433,477
327,MENARD,327,0006,3270006,6808,102,94,8,0,0,8,8,90,83,7,0,0,7,7
191,HALL,191,0302,1910302,4172,517,277,240,3,60,173,227,396,253,143,2,40,94,133
135,ECTOR,135,0310,1350310,3236,3193,967,2226,29,184,1968,2136,2241,798,1443,18,116,1268,1377
29,BEXAR,29,1092,291092,342,2744,135,2609,18,132,2474,2578,1736,100,1636,9,75,1550,1614
187,GUADALUPE,187,0406,1870406,4129,1687,1306,381,16,37,294,321,1313,1066,247,10,18,192,207
29,BEXAR,29,1049,291049,299,5228,379,4849,25,81,4745,4784,3916,318,3598,18,56,3526,3556
453,TRAVIS,453,0351,4530351,8895,6208,3192,3016,971,238,1723,1938,4927,2669,2258,792,197,1196,1376
201,HARRIS,201,0847,2010847,5065,7037,649,6388,170,2509,3721,6161,4733,507,4226,136,1687,2397,4046
41,BRAZOS,41,0044,410044,1235,170,124,46,0,3,36,39,125,95,30,0,2,24,26
181,GRAYSON,181,0411,1810411,4026,357,281,76,4,7,29,36,270,212,58,2,4,21,25
39,BRAZORIA,39,0019,390019,1132,4802,1273,3529,23,507,2987,3449,3508,1060,2448,20,342,2071,2391
113,DALLAS,113,1713,1131713,2171,2766,797,1969,29,158,1737,1878,1999,689,1310,19,103,1139,1238
239,JACKSON,239,0007,2390007,6001,158,130,28,3,2,26,26,127,107,20,1,1,20,20
27,BELL,27,0108,270108,196,2482,1878,604,12,94,416,502,1870,1469,401,8,45,282,324
453,TRAVIS,453,0174,4530174,8766,1526,749,777,171,214,362,562,1171,594,577,124,153,273,414
201,HARRIS,201,0744,2010744,4962,3130,1666,1464,344,322,755,1040,2416,1353,1063,271,219,519,722
157,FORT BEND,157,4173,1574173,3791,1970,389,1581,632,538,392,917,1415,299,1116,471,347,276,619
13,ATASCOSA,13,0017,130017,110,3226,526,2700,5,34,2645,2666,2360,412,1948,3,13,1906,1916
325,MEDINA,325,002A,325002A,6791,1257,502,755,37,217,476,689,950,396,554,32,170,329,499
423,SMITH,423,0049,4230049,7770,2011,1546,465,9,77,331,401,1444,1157,287,7,35,205,237
215,HIDALGO,215,0154,2150154,5706,6207,242,5965,15,38,5915,5932,4279,194,4085,13,20,4050,4055
113,DALLAS,113,4615,1134615,2855,470,100,370,8,13,346,359,359,87,272,8,9,252,261
31,BLANCO,31,0401,310401,1046,2934,2218,716,18,43,593,633,2400,1893,507,14,35,418,450
221,HOOD,221,0415,2210415,5855,1237,830,407,11,152,215,357,817,597,220,8,75,123,194
329,MIDLAND,329,0305,3290305,6834,4297,343,3954,84,1177,2714,3825,2881,256,2625,37,812,1765,2558
91,COMAL,91,0302,910302,1919,4180,2200,1980,46,154,1691,1829,3165,1822,1343,40,118,1122,1235
227,HOWARD,227,0011,2270011,5898,3081,739,2342,51,332,1958,2244,2258,604,1654,31,237,1350,1580
441,TAYLOR,441,0101,4410101,8600,6315,3356,2959,109,843,1943,2692,4632,2746,1886,78,482,1217,1681
201,HARRIS,201,0510,2010510,4727,8083,2427,5656,634,2878,2177,4913,6554,2124,4430,503,2261,1674,3837
453,TRAVIS,453,0100,4530100,8706,3863,1761,2102,209,819,1040,1819,3361,1612,1749,183,712,802,1495
119,DELTA,119,0003,1190003,2918,765,507,258,13,132,87,209,553,391,162,7,94,36,126
179,GRAY,179,0004,1790004,3983,898,757,141,2,12,101,112,709,615,94,1,8,67,75
201,HARRIS,201,0616,2010616,4833,4677,2380,2297,364,580,1297,1838,3563,1956,1607,285,394,866,1241
1,ANDERSON,1,0004,10004,4,2306,2004,302,6,91,131,219,1821,1605,216,4,63,82,145
309,MCLENNAN,309,0010,3090010,6642,5334,573,4761,26,2491,2347,4689,3614,461,3153,13,1661,1498,3102
5,ANGELINA,5,0020,50020,47,5324,654,4670,53,2374,2230,4555,3947,539,3408,43,1811,1521,3312
167,GALVESTON,167,0185,1670185,3854,3993,2806,1187,230,350,540,876,3314,2420,894,188,245,386,626
215,HIDALGO,215,0217,2150217,5769,610,8,602,1,0,601,601,422,8,414,1,0,413,413
311,MCMULLEN,311,0003,3110003,6728,151,116,35,2,3,32,34,122,92,30,2,3,27,29
201,HARRIS,201,0573,2010573,4790,3163,38,3125,40,2483,644,3080,2065,37,2028,31,1618,394,1988
309,MCLENNAN,309,0072,3090072,6705,1415,1028,387,5,126,214,336,1100,828,272,2,106,140,244
409,SAN PATRICIO,409,0120,4090120,7664,960,666,294,16,17,229,241,812,589,223,9,12,175,183
201,HARRIS,201,0701,2010701,4919,1780,200,1580,55,54,1482,1522,1292,177,1115,37,40,1048,1081
397,ROCKWALL,397,004B,397004B,7578,7129,4206,2923,169,720,1868,2550,5023,3103,1920,127,473,1196,1644
29,BEXAR,29,4172,294172,983,2498,877,1621,89,187,1345,1505,1939,723,1216,60,126,1004,1123
27,BELL,27,0402,270402,239,8273,2683,5590,514,2937,2139,4844,5701,2090,3611,316,1898,1354,3131
39,BRAZORIA,39,0062,390062,1175,7585,2353,5232,654,2394,2173,4447,5454,1874,3580,473,1646,1424,3011
407,SAN JACINTO,407,0008,4070008,7641,1651,1297,354,25,153,125,273,1358,1108,250,14,114,79,188
245,JEFFERSON,245,0059,2450059,6087,1730,36,1694,10,1556,139,1673,1225,23,1202,5,1120,83,1192
113,DALLAS,113,2003,1132003,2214,3329,2289,1040,251,212,524,726,2690,1920,770,177,157,394,544
121,DENTON,121,3123,1213123,3047,9795,3327,6468,2022,2539,1727,4172,7961,2932,5029,1627,1899,1338,3183
121,DENTON,121,4224,1214224,3150,2858,1803,1055,144,301,550,826,1912,1259,653,89,169,332,493
113,DALLAS,113,1162,1131162,2111,0,0,0,0,0,0,0,0,0,0,0,0,0,0
187,GUADALUPE,187,0202,1870202,4086,2313,422,1891,5,231,1672,1861,1652,331,1321,2,179,1140,1297
51,BURLESON,51,0207,510207,1341,654,347,307,4,201,98,290,524,287,237,4,163,64,225
99,CORYELL,99,0310,990310,1982,1187,918,269,5,27,206,233,967,786,181,4,19,135,154
113,DALLAS,113,1113,1131113,2085,605,20,585,2,164,416,578,427,17,410,1,118,289,406
439,TARRANT,439,4649,4394649,8577,5479,3077,2402,279,353,1677,1998,4032,2406,1626,200,240,1091,1317
449,TITUS,449,0009,4490009,8660,893,525,368,4,108,214,315,649,412,237,2,72,126,198
135,ECTOR,135,0104,1350104,3213,5864,1751,4113,23,108,3909,3998,4182,1406,2776,11,73,2624,2686
41,BRAZOS,41,0107,410107,1298,507,406,101,6,27,58,83,418,342,76,5,22,38,58
245,JEFFERSON,245,0036,2450036,6064,2691,1974,717,82,157,420,569,2121,1631,490,53,104,262,366
439,TARRANT,439,1434,4391434,7979,0,0,0,0,0,0,0,0,0,0,0,0,0,0
451,TOM GREEN,451,0434,4510434,8703,2294,836,1458,46,131,1268,1368,1718,691,1027,28,78,886,955
121,DENTON,121,1034,1211034,2958,1996,1054,942,330,308,275,564,1344,731,613,219,200,171,364
201,HARRIS,201,0656,2010656,4873,2004,65,1939,15,179,1757,1919,1264,55,1209,11,130,1072,1195
325,MEDINA,325,001B,325001B,6788,3404,2382,1022,26,37,891,914,2698,1998,700,14,19,623,635
123,DEWITT,123,0302,1230302,3170,1869,1048,821,1,88,713,786,1401,856,545,1,60,464,519
201,HARRIS,201,0867,2010867,5085,3222,266,2956,97,820,2050,2840,2267,236,2031,72,616,1351,1949
439,TARRANT,439,1278,4391278,7936,4178,636,3542,145,2764,640,3363,3176,586,2590,113,2025,441,2451
29,BEXAR,29,1154A,291154A,405,2873,936,1937,270,432,1240,1651,1993,685,1308,187,292,814,1097
121,DENTON,121,2077,1212077,3001,6988,2110,4878,819,1251,2675,3868,4861,1626,3235,613,815,1681,2465
201,HARRIS,201,0698,2010698,4916,2795,57,2738,113,1539,1091,2608,1879,43,1836,87,1048,701,1743
37,BOWIE,37,0029,370029,1086,555,475,80,1,10,33,42,452,392,60,0,9,16,25
329,MIDLAND,329,0302,3290302,6831,8796,2259,6537,37,145,6238,6344,6210,1829,4381,21,82,4177,4245
113,DALLAS,113,2134,1132134,2320,2450,881,1569,223,555,765,1312,2149,847,1302,210,491,577,1064
13,ATASCOSA,13,0013,130013,107,4248,1795,2453,22,41,2313,2349,3080,1394,1686,17,23,1576,1598
453,TRAVIS,453,0260,4530260,8829,3029,1834,1195,476,149,527,653,2657,1615,1042,410,128,466,579
39,BRAZORIA,39,0059,390059,1172,3877,1204,2673,1223,973,487,1409,2729,898,1831,818,685,300,971
113,DALLAS,113,1406,1131406,2151,687,59,628,54,309,262,568,483,53,430,42,214,170,384
233,HUTCHINSON,233,0031,2330031,5981,2291,1828,463,7,42,290,332,1722,1416,306,6,16,183,199
229,HUDSPETH,229,003S,229003S,5938,311,29,282,0,5,280,280,244,21,223,0,0,222,222
493,WILSON,493,0312,4930312,9556,3541,2514,1027,53,74,803,866,2705,2006,699,31,55,522,573
339,MONTGOMERY,339,0059,3390059,6957,2100,1622,478,167,46,222,268,1611,1270,341,123,35,155,190
427,STARR,427,0013,4270013,7810,6530,110,6420,6,13,6388,6395,4374,76,4298,3,13,4283,4290
453,TRAVIS,453,0331,4530331,8875,2474,1559,915,96,117,663,765,2023,1350,673,85,80,474,545
121,DENTON,121,3120,1213120,3044,4740,1750,2990,94,636,2197,2802,3427,1504,1923,76,402,1381,1771
109,CULBERSON,109,0001,1090001,2005,533,72,461,10,9,441,446,440,62,378,6,5,363,365
167,GALVESTON,167,0389,1670389,3897,1311,302,1009,34,406,536,932,929,238,691,19,304,335,632
195,HANSFORD,195,0007,1950007,4192,56,47,9,0,0,8,8,49,44,5,0,0,5,5
29,BEXAR,29,4129,294129,940,206,71,135,2,3,126,129,174,66,108,2,3,99,102
187,GUADALUPE,187,0225,1870225,4109,39,9,30,1,1,29,30,32,9,23,0,1,22,23
29,BEXAR,29,1029,291029,279,3653,138,3515,27,100,3402,3476,2761,107,2654,23,67,2571,2619
439,TARRANT,439,1603,4391603,8022,4,0,4,1,1,1,2,0,0,0,0,0,0,0
309,MCLENNAN,309,0030,3090030,6662,3654,1601,2053,49,715,1286,1931,2721,1359,1362,33,477,814,1264
423,SMITH,423,0006,4230006,7727,1406,1004,402,9,109,236,337,1100,848,252,6,74,133,204
491,WILLIAMSON,491,0471,4910471,9536,447,263,184,3,11,167,175,334,208,126,1,4,116,118
339,MONTGOMERY,339,0043C,3390043C,6940,8,1,7,3,1,2,3,7,1,6,3,0,2,2
403,SABINE,403,0007,4030007,7621,255,112,143,1,124,5,127,189,90,99,1,87,3,90
113,DALLAS,113,1043,1131043,2025,4318,2080,2238,451,897,851,1723,3195,1700,1495,268,614,571,1169
27,BELL,27,0212,270212,216,1558,912,646,107,218,274,477,1249,777,472,71,157,198,348
453,TRAVIS,453,0151B,4530151B,8749,0,0,0,0,0,0,0,0,0,0,0,0,0,0
171,GILLESPIE,171,0001,1710001,3940,2653,2194,459,25,27,348,368,2200,1865,335,11,19,246,264
113,DALLAS,113,1309,1131309,2131,1407,88,1319,8,849,470,1301,993,86,907,8,561,335,889
453,TRAVIS,453,0237,4530237,8812,3568,2555,1013,281,110,545,638,2955,2196,759,204,81,424,489
215,HIDALGO,215,0197,2150197,5749,6620,69,6551,18,17,6529,6532,3734,42,3692,8,12,3672,3675
21,BASTROP,21,1008,211008,153,1803,951,852,67,99,616,708,1479,840,639,48,72,447,519
29,BEXAR,29,4192,294192,1003,2,1,1,0,0,1,1,1,1,0,0,0,0,0
165,GAINES,165,0005,1650005,3834,340,210,130,1,2,122,123,244,156,88,1,0,84,84
113,DALLAS,113,1095,1131095,2068,3529,166,3363,3,421,2939,3342,2459,153,2306,3,336,1963,2288
29,BEXAR,29,1009,291009,259,3048,727,2321,150,358,1846,2134,2077,538,1539,108,220,1201,1400
215,HIDALGO,215,0091,2150091,5643,2053,73,1980,3,1,1967,1967,1443,62,1381,2,1,1375,1375
167,GALVESTON,167,0275,1670275,3877,413,363,50,4,3,29,30,384,341,43,3,2,24,25
29,BEXAR,29,4149,294149,960,1085,228,857,25,96,741,813,829,200,629,16,58,542,590
113,DALLAS,113,4639,1134639,2875,2548,339,2209,194,372,1626,1971,1782,288,1494,141,243,1094,1322
97,COOKE,97,0008,970008,1962,1456,1173,283,4,26,158,181,1131,934,197,4,17,98,113
29,BEXAR,29,1072,291072,322,3382,552,2830,126,535,2227,2693,2611,471,2140,104,392,1654,2016
423,SMITH,423,0079,4230079,7790,5649,3984,1665,106,884,526,1389,4099,3000,1099,73,567,339,898
499,WOOD,499,02-2,49902-2,9599,6080,4369,1711,39,305,1182,1461,4688,3564,1124,24,189,759,940
121,DENTON,121,4165,1214165,3090,12019,4769,7250,381,3633,3170,6641,9406,4195,5211,310,2549,2217,4708
415,SCURRY,415,0008,4150008,7684,1646,878,768,18,80,653,718,1170,701,469,11,47,391,433
223,HOPKINS,223,003A,223003A,5875,2945,2042,903,37,264,547,793,2332,1718,614,32,177,356,526
491,WILLIAMSON,491,0372,4910372,9493,6822,3808,3014,1710,327,821,1130,4585,2775,1810,997,224,508,719
121,DENTON,121,1014,1211014,2938,4128,2030,2098,191,976,883,1817,2951,1572,1379,147,611,570,1167
187,GUADALUPE,187,0106,1870106,4066,5108,2774,2334,135,271,1861,2078,4031,2350,1681,100,179,1320,1478
113,DALLAS,113,2052,1132052,2257,1684,1346,338,97,59,136,190,1287,1065,222,74,26,76,100
37,BOWIE,37,0009,370009,1066,4844,2510,2334,71,1390,723,2089,3616,2019,1597,40,998,438,1426
245,JEFFERSON,245,0016,2450016,6044,1141,70,1071,39,372,654,1018,815,58,757,35,266,446,708
439,TARRANT,439,1019,4391019,7853,2162,265,1897,14,205,1669,1860,1524,224,1300,14,166,1110,1264
439,TARRANT,439,1199,4391199,7916,424,288,136,22,46,55,101,369,261,108,19,44,35,79
39,BRAZORIA,39,0016,390016,1129,4049,1986,2063,65,226,1699,1911,2913,1566,1347,48,140,1082,1221
329,MIDLAND,329,101A,329101A,6851,31,7,24,2,2,14,15,21,5,16,2,1,6,7
245,JEFFERSON,245,0079,2450079,6107,2915,1437,1478,214,979,254,1210,2278,1280,998,169,635,154,779
11,ARMSTRONG,11,0202,110202,90,119,108,11,2,2,3,4,101,92,9,2,2,3,4
113,DALLAS,113,1736,1131736,2194,2300,1355,945,231,290,388,665,1944,1240,704,184,230,260,484
217,HILL,217,0001,2170001,5812,2861,1686,1175,53,321,743,1053,2102,1347,755,32,199,467,663
181,GRAYSON,181,0208,1810208,4003,2352,1832,520,18,180,212,382,1785,1440,345,12,119,133,246
141,EL PASO,141,0006,1410006,3319,3160,1035,2125,79,59,1987,2027,2360,850,1510,37,40,1416,1445
455,TRINITY,455,0017,4550017,9021,716,179,537,12,459,63,520,522,134,388,8,338,37,374
409,SAN PATRICIO,409,0117,4090117,7661,934,348,586,1,9,551,557,721,284,437,1,7,412,416
351,NEWTON,351,0023,3510023,7106,188,139,49,0,31,2,33,135,103,32,0,19,1,20
201,HARRIS,201,0973,2010973,5191,3304,1183,2121,212,200,1706,1887,2164,845,1319,127,122,1070,1182
309,MCLENNAN,309,0091,3090091,6725,2421,1912,509,53,144,256,387,1879,1553,326,33,92,157,243
201,HARRIS,201,0593,2010593,4810,9264,1239,8025,1650,866,5538,6312,6908,1077,5831,1289,620,3918,4489
251,JOHNSON,251,0012A,2510012A,6170,4589,3462,1127,38,106,836,924,3388,2671,717,26,60,517,569
201,HARRIS,201,0039,2010039,4255,4889,3112,1777,631,304,794,1080,4375,2847,1528,527,262,678,928
497,WISE,497,0011,4970011,9576,957,795,162,4,9,119,127,753,649,104,4,6,68,74
451,TOM GREEN,451,0225,4510225,8683,119,111,8,0,0,5,5,99,91,8,0,0,5,5
167,GALVESTON,167,0460,1670460,3917,4359,3444,915,153,104,543,642,3362,2713,649,123,68,369,435
29,BEXAR,29,4212,294212,1023,7,1,6,0,0,4,4,7,1,6,0,0,4,4
29,BEXAR,29,4109,294109,920,2567,529,2038,154,843,1103,1877,1739,412,1327,109,547,695,1212
503,YOUNG,503,0022,5030022,9619,4509,3585,924,29,65,709,762,3462,2874,588,27,34,426,459
121,DENTON,121,1057,1211057,2981,2134,693,1441,18,243,1157,1388,1379,513,866,13,148,678,823
9,ARCHER,9,0013,90013,87,189,179,10,1,3,1,4,152,146,6,1,0,1,1
85,COLLIN,85,0227,850227,1856,6417,3417,3000,1349,743,824,1538,4385,2432,1953,878,467,524,982
215,HIDALGO,215,0237,2150237,5789,1702,28,1674,5,2,1664,1664,1207,22,1185,3,0,1177,1177
97,COOKE,97,0004,970004,1959,476,399,77,2,6,49,55,380,327,53,2,5,30,35
423,SMITH,423,0026,4230026,7747,3961,3094,867,27,406,317,719,3096,2481,615,18,285,211,494
121,DENTON,121,2100,1212100,3024,8886,2451,6435,543,3535,2271,5677,7352,2251,5101,473,2766,1743,4437
329,MIDLAND,329,202A,329202A,6854,6497,3544,2953,43,92,2652,2730,4449,2567,1882,30,42,1681,1718
439,TARRANT,439,1672,4391672,8042,0,0,0,0,0,0,0,0,0,0,0,0,0,0
303,LUBBOCK,303,0076,3030076,6579,3392,1799,1593,114,195,1231,1406,2502,1404,1098,77,144,823,958
453,TRAVIS,453,0450,4530450,8978,6457,2991,3466,293,371,2745,3076,5403,2651,2752,226,301,2144,2420
113,DALLAS,113,1116,1131116,2088,3449,598,2851,30,124,2680,2784,2439,512,1927,24,80,1798,1874
227,HOWARD,227,0105,2270105,5918,1,0,1,0,0,1,1,0,0,0,0,0,0,0
201,HARRIS,201,0636,2010636,4853,3065,2368,697,52,85,446,530,2287,1808,479,32,68,290,357
121,DENTON,121,4185,1214185,3110,1623,1527,96,15,20,41,61,1615,1523,92,15,20,38,58
187,GUADALUPE,187,0205,1870205,4089,2044,1069,975,11,68,863,920,1589,899,690,8,53,591,643
183,GREGG,183,0019,1830019,4046,7183,1331,5852,112,3611,2109,5675,5497,1236,4261,102,2795,1339,4115
201,HARRIS,201,0807,2010807,5025,6420,661,5759,380,2714,2792,5346,4996,589,4407,307,2070,2104,4068
201,HARRIS,201,0764,2010764,4982,3887,1617,2270,194,907,1127,2002,2769,1208,1561,132,625,754,1371
113,DALLAS,113,1716,1131716,2174,3116,1832,1284,127,330,752,1069,2525,1632,893,101,243,489,728
339,MONTGOMERY,339,0004,3390004,6897,3314,2003,1311,166,369,707,1061,2627,1681,946,127,258,490,739
157,FORT BEND,157,3112,1573112,3728,2257,50,2207,11,69,2142,2189,1509,36,1473,11,44,1421,1457
201,HARRIS,201,0870,2010870,5088,0,0,0,0,0,0,0,0,0,0,0,0,0,0
29,BEXAR,29,4066,294066,877,5945,1178,4767,231,1894,2745,4460,4322,991,3331,185,1310,1853,3078
113,DALLAS,113,2030,1132030,2237,2597,2300,297,99,36,128,158,2010,1816,194,65,21,73,94
175,GOLIAD,175,0022,1750022,3960,338,150,188,6,2,180,180,268,127,141,4,0,134,134
201,HARRIS,201,0678,2010678,4896,5221,246,4975,181,3245,1637,4777,3748,209,3539,127,2380,1082,3403
113,DALLAS,113,1064,1131064,2045,478,39,439,2,202,234,433,327,33,294,2,126,162,288
231,HUNT,231,0323,2310323,5961,3876,3175,701,46,103,396,482,3060,2595,465,25,54,259,308
113,DALLAS,113,4166,1134166,2792,20,4,16,8,1,9,9,12,4,8,4,0,5,5
453,TRAVIS,453,0263,4530263,8832,5515,2561,2954,1221,537,1160,1646,4558,2269,2289,943,402,908,1274
121,DENTON,121,4162B,1214162B,3087,203,136,67,8,20,41,60,123,84,39,2,14,21,35
321,MATAGORDA,321,001E,321001E,6768,3332,965,2367,49,862,1468,2282,2332,798,1534,45,563,915,1462
27,BELL,27,0317,270317,236,7330,4465,2865,478,966,1302,2178,5390,3467,1923,323,651,826,1443
419,SHELBY,419,0005,4190005,7704,3156,2526,630,29,181,344,520,2419,1977,442,19,121,234,355
443,TERRELL,443,0004C,4430004C,8640,36,32,4,1,3,3,4,32,32,0,0,0,0,0
181,GRAYSON,181,0408,1810408,4023,1465,1125,340,39,75,137,209,1189,955,234,28,56,79,135
439,TARRANT,439,1127,4391127,7896,2373,101,2272,39,1375,875,2233,1790,78,1712,32,1115,567,1679
219,HOCKLEY,219,0033,2190033,5832,191,121,70,1,4,65,68,125,89,36,1,2,32,34
37,BOWIE,37,014A,37014A,1109,2346,1271,1075,38,799,154,942,1734,1000,734,29,541,97,634
23,BAYLOR,23,0002,230002,173,870,703,167,6,37,110,136,655,532,123,2,21,83,99
435,SUTTON,435,0401,4350401,7833,846,215,631,4,6,608,610,637,177,460,3,3,447,448
225,HOUSTON,225,0020,2250020,5895,302,258,44,0,10,24,34,241,212,29,0,7,14,21
243,JEFF DAVIS,243,0001,2430001,6024,497,387,110,3,3,99,101,436,355,81,1,2,71,72
453,TRAVIS,453,0177,4530177,8769,4851,2212,2639,511,648,1388,1992,3819,1891,1928,391,499,951,1425
201,HARRIS,201,0741,2010741,4959,4898,353,4545,183,1083,3329,4332,3411,283,3128,144,799,2209,2965
339,MONTGOMERY,339,0062,3390062,6960,3547,2687,860,252,120,406,521,2784,2148,636,186,91,295,384
41,BRAZOS,41,0047,410047,1238,967,324,643,6,73,561,630,682,285,397,4,58,331,389
453,TRAVIS,453,0326,4530326,8872,4100,3016,1084,591,58,352,404,2915,2199,716,380,41,222,261
453,TRAVIS,453,0423,4530423,8958,5541,1023,4518,194,849,3487,4249,4180,919,3261,157,641,2478,3066
423,SMITH,423,0003,4230003,7724,3538,2601,937,83,394,384,764,2785,2147,638,67,258,256,508
453,TRAVIS,453,0373,4530373,8915,2734,2257,477,123,59,217,269,2299,1953,346,81,46,144,186
29,BEXAR,29,1112,291112,362,5079,726,4353,165,587,3679,4172,3509,573,2936,118,391,2452,2803
113,DALLAS,113,2091,1132091,2277,1459,817,642,59,81,472,539,1070,648,422,37,50,305,348
339,MONTGOMERY,339,0100,3390100,7000,7308,4324,2984,487,1009,1300,2226,4739,2872,1867,307,648,780,1388
351,NEWTON,351,0005,3510005,7086,551,474,77,5,33,25,57,511,447,64,4,30,21,51
201,HARRIS,201,0910,2010910,5128,571,56,515,1,16,494,508,424,53,371,1,11,357,368
347,NACOGDOCHES,347,0033,3470033,7043,5006,3838,1168,185,486,374,848,4064,3202,862,134,352,264,615
453,TRAVIS,453,0150A,4530150A,8746,6315,2548,3767,863,1108,1755,2761,4367,1883,2484,606,684,1149,1775
169,GARZA,169,0004,1690004,3937,889,215,674,9,89,582,647,622,170,452,2,46,393,433
113,DALLAS,113,1039,1131039,2022,860,47,813,11,523,283,801,587,40,547,11,360,178,535
221,HOOD,221,0404,2210404,5852,3669,2472,1197,25,46,1027,1068,2802,2036,766,20,28,642,668
423,SMITH,423,0046,4230046,7767,1990,1083,907,31,302,522,814,1502,873,629,30,224,334,555
189,HALE,189,0204,1890204,4149,1732,305,1427,1,51,1350,1389,1204,266,938,1,33,881,909
113,DALLAS,113,2026,1132026,2234,3776,3205,571,229,70,234,294,3211,2795,416,164,49,169,210
201,HARRIS,201,0784,2010784,5002,1368,27,1341,2,880,463,1336,1050,26,1024,2,725,297,1019
201,HARRIS,201,0827,2010827,5045,4810,301,4509,31,137,4362,4468,3283,253,3030,20,84,2924,2997
41,BRAZOS,41,0024,410024,1215,3762,2138,1624,303,396,836,1205,3017,1818,1199,255,251,621,858
215,HIDALGO,215,0174,2150174,5726,2320,25,2295,3,7,2283,2284,1523,18,1505,2,3,1497,1497
21,BASTROP,21,1005,211005,150,1829,1240,589,41,139,408,539,1462,1021,441,29,115,292,400
113,DALLAS,113,1151,1131151,2108,80,29,51,0,6,46,51,62,29,33,0,5,28,33
37,BOWIE,37,0012,370012,1069,3020,2627,393,14,177,102,277,2313,2012,301,10,125,75,200
439,TARRANT,439,1119,4391119,7893,6315,1983,4332,385,2647,1313,3871,4853,1690,3163,275,1917,949,2825
123,DEWITT,123,0402,1230402,3173,1372,1154,218,4,28,171,198,1079,935,144,4,17,112,129
179,GRAY,179,0001,1790001,3980,682,561,121,5,9,64,71,506,427,79,3,4,39,42
439,TARRANT,439,1292,4391292,7939,4292,620,3672,198,1534,1955,3446,3144,548,2596,150,1132,1303,2418
121,DENTON,121,1017,1211017,2941,5094,2761,2333,681,889,641,1494,3351,1934,1417,414,557,356,894
139,ELLIS,139,1002,1391002,3256,168,132,36,2,0,26,26,135,113,22,1,0,15,15
241,JASPER,241,0019,2410019,6021,2498,1740,758,24,527,157,681,1966,1438,528,17,380,89,468
333,MILLS,333,0011,3330011,6874,285,235,50,2,15,28,39,201,180,21,0,5,12,14
215,HIDALGO,215,0257,2150257,5809,829,13,816,4,2,809,810,651,13,638,3,2,632,633
201,HARRIS,201,0659,2010659,4876,4756,2678,2078,238,750,1005,1711,3582,2173,1409,151,527,656,1167
41,BRAZOS,41,0004,410004,1195,4399,329,4070,17,1815,2274,4041,3073,277,2796,5,1366,1433,2775
309,MCLENNAN,309,0053A,3090053A,6685,1891,1101,790,25,348,381,704,1642,996,646,21,269,318,576
121,DENTON,121,1037,1211037,2961,3111,1257,1854,919,464,414,858,1972,839,1133,568,290,232,513
5,ANGELINA,5,011B,5011B,67,2025,1663,362,9,158,136,288,1463,1224,239,2,92,95,185
201,HARRIS,201,0553,2010553,4770,6610,1082,5528,864,1589,3092,4573,4840,907,3933,671,1123,2136,3207
141,EL PASO,141,0040,1410040,3353,1628,172,1456,10,38,1413,1437,1346,147,1199,6,27,1164,1186
309,MCLENNAN,309,0047,3090047,6679,723,337,386,15,129,219,343,467,258,209,10,77,111,185
439,TARRANT,439,1264,4391264,7930,2533,1497,1036,79,245,648,875,1941,1255,686,48,160,404,561
439,TARRANT,439,4053,4394053,8428,2223,1232,991,46,112,770,864,1688,1009,679,33,85,520,593
439,TARRANT,439,4730,4394730,8594,4445,2517,1928,362,533,963,1465,3221,1902,1319,257,351,651,983
465,VAL VERDE,465,0022,4650022,9092,5314,1214,4100,84,111,3906,3997,4254,1152,3102,60,91,2949,3026
167,GALVESTON,167,0168,1670168,3851,12,1,11,4,0,8,8,12,1,11,4,0,8,8
181,GRAYSON,181,0402,1810402,4017,4201,2984,1217,43,314,549,846,3256,2435,821,27,190,356,545
201,HARRIS,201,0298,2010298,4515,4199,1616,2583,481,713,1405,2045,3429,1399,2030,387,569,1077,1599
211,HEMPHILL,211,0202,2110202,5517,46,24,22,1,2,18,19,42,24,18,1,1,15,15
241,JASPER,241,0012,2410012,6015,920,689,231,11,122,63,185,717,544,173,5,93,42,135
251,JOHNSON,251,0022,2510022,6181,7854,4102,3752,179,486,2440,2835,5921,3301,2620,140,322,1721,1996
41,BRAZOS,41,0097,410097,1289,0,0,0,0,0,0,0,0,0,0,0,0,0,0
85,COLLIN,85,0158,850158,1787,4428,1480,2948,1943,599,373,956,3218,1148,2070,1412,403,212,610
95,CONCHO,95,0306,950306,1953,563,330,233,8,13,203,215,433,271,162,8,10,135,145
113,DALLAS,113,3014,1133014,2451,11621,1726,9895,71,1324,8482,9718,7392,1357,6035,48,885,5062,5909
141,EL PASO,141,0140,1410140,3453,4555,128,4427,3,48,4382,4405,3157,97,3060,0,24,3039,3052
171,GILLESPIE,171,0013,1710013,3951,2578,1976,602,11,18,511,524,2131,1712,419,9,11,343,353
201,HARRIS,201,0398,2010398,4615,8765,1816,6949,1016,1599,4351,5843,6447,1533,4914,798,1135,2976,4035
249,JIM WELLS,249,0022,2490022,6158,2886,194,2692,10,29,2631,2646,2098,154,1944,6,18,1897,1907
309,MCLENNAN,309,0024,3090024,6656,1408,809,599,5,375,202,565,973,631,342,3,237,91,321
329,MIDLAND,329,0202,3290202,6822,4197,2830,1367,16,18,1260,1273,2745,1925,820,13,15,738,751
439,TARRANT,439,4116,4394116,8451,2603,2106,497,131,59,226,282,2252,1826,426,121,53,184,236
181,GRAYSON,181,0108,1810108,3994,3432,2965,467,49,45,220,261,2524,2245,279,17,28,133,160
187,GUADALUPE,187,0303,1870303,4117,1911,1105,806,93,210,472,657,1530,931,599,67,169,322,478
201,HARRIS,201,0447,2010447,4664,6495,2861,3634,357,1487,1749,3151,4284,1973,2311,222,972,1075,2001
201,HARRIS,201,0275,2010275,4492,4578,227,4351,101,1721,2638,4212,3422,193,3229,87,1327,1878,3117
201,HARRIS,201,0938,2010938,5156,2207,72,2135,44,337,1745,2068,1453,55,1398,28,205,1145,1345
201,HARRIS,201,0441,2010441,4658,2380,1571,809,388,64,316,369,1744,1182,562,274,36,217,252
5,ANGELINA,5,0038,50038,64,691,481,210,9,24,167,190,510,363,147,5,18,116,133
29,BEXAR,29,3124,293124,728,6704,2777,3927,542,958,2462,3314,5282,2355,2927,413,694,1793,2449
39,BRAZORIA,39,0033,390033,1146,2857,1905,952,7,404,471,867,2308,1586,722,4,338,318,651
85,COLLIN,85,0181,850181,1810,4165,2263,1902,124,612,1061,1646,2846,1685,1161,74,365,630,990
99,CORYELL,99,0207,990207,1979,7920,4034,3886,439,1745,1485,3056,5968,3223,2745,322,1229,946,2101
113,DALLAS,113,3951,1133951,2643,4834,642,4192,53,3096,1057,4101,3429,534,2895,41,2183,654,2819
303,LUBBOCK,303,0043,3030043,6556,1094,699,395,12,22,357,372,800,541,259,5,6,241,247
355,NUECES,355,0104,3550104,7220,1308,60,1248,2,23,1236,1241,919,52,867,1,14,858,861
371,PECOS,371,0002,3710002,7389,3417,628,2789,34,61,2691,2720,2513,531,1982,26,29,1899,1920
439,TARRANT,439,1715,4391715,8053,1668,669,999,196,415,385,762,1250,550,700,142,288,251,516
453,TRAVIS,453,0116,4530116,8720,6507,2163,4344,270,1021,3047,3979,5126,1919,3207,193,788,2177,2924
491,WILLIAMSON,491,0116B,4910116B,9384,0,0,0,0,0,0,0,0,0,0,0,0,0,0
139,ELLIS,139,1056,1391056,3310,3409,2639,770,52,234,394,617,2532,2031,501,22,177,234,403
177,GONZALES,177,0011,1770011,3974,322,230,92,0,9,73,82,259,194,65,0,8,50,58
189,HALE,189,0108,1890108,4143,238,82,156,0,16,139,153,164,59,105,0,15,88,102
201,HARRIS,201,1007,2011007,5225,4844,482,4362,193,1943,2189,4051,3391,385,3006,152,1347,1448,2752
201,HARRIS,201,0590,2010590,4807,2732,2059,673,78,102,395,491,2053,1608,445,56,71,243,311
225,HOUSTON,225,0014,2250014,5889,337,289,48,0,9,32,40,257,220,37,0,4,28,32
5,ANGELINA,5,0011,50011,38,3071,2623,448,12,77,260,337,2371,2060,311,9,66,159,225
29,BEXAR,29,2166,292166,579,2268,687,1581,205,152,1234,1364,1826,592,1234,154,111,957,1057
113,DALLAS,113,4086,1134086,2743,6359,593,5766,129,881,4745,5586,4848,535,4313,100,646,3533,4157
113,DALLAS,113,1106,1131106,2079,610,21,589,4,108,476,584,429,21,408,3,94,312,406
113,DALLAS,113,3616,1133616,2620,1294,78,1216,8,762,454,1207,918,72,846,5,559,285,839
121,DENTON,121,9302,1219302,3161,0,0,0,0,0,0,0,0,0,0,0,0,0,0
479,WEBB,479,0402,4790402,9284,3303,70,3233,12,10,3218,3218,2301,53,2248,10,7,2239,2239
479,WEBB,479,0164,4790164,9235,2484,60,2424,4,19,2406,2413,1726,47,1679,3,12,1667,1674
237,JACK,237,0001,2370001,5989,2845,1742,1103,19,287,767,1040,2395,1505,890,16,275,580,845
303,LUBBOCK,303,0014,3030014,6530,2809,1433,1376,55,188,1078,1244,2255,1266,989,50,127,757,876
439,TARRANT,439,4629,4394629,8571,0,0,0,0,0,0,0,0,0,0,0,0,0,0
439,TARRANT,439,1621,4391621,8030,424,96,328,15,212,103,310,293,69,224,14,145,66,206
451,TOM GREEN,451,0351,4510351,8694,481,360,121,3,9,87,95,374,303,71,3,4,45,49
453,TRAVIS,453,0144,4530144,8743,3985,777,3208,124,999,2133,3040,2712,631,2081,91,610,1390,1963
139,ELLIS,139,1030,1391030,3284,3032,1894,1138,15,409,672,1070,2290,1496,794,12,304,435,729
163,FRIO,163,0004,1630004,3825,1895,455,1440,16,10,1397,1405,1381,370,1011,9,9,983,990
201,HARRIS,201,1107,2011107,5325,553,107,446,9,87,353,431,361,84,277,5,55,214,266
201,HARRIS,201,0567,2010567,4784,11906,1050,10856,1096,2146,7668,9657,8694,888,7806,869,1644,5349,6880
209,HAYS,209,0203,2090203,5448,5038,1796,3242,102,339,2724,3021,3730,1420,2310,68,230,1921,2136
223,HOPKINS,223,0016,2230016,5866,1571,1308,263,8,25,157,182,1215,1046,169,5,6,100,106
13,ATASCOSA,13,0007,130007,101,3502,930,2572,17,51,2474,2506,2528,737,1791,6,34,1726,1751
29,BEXAR,29,1100,291100,350,4440,887,3553,221,450,2944,3314,3243,711,2532,157,334,2062,2356
29,BEXAR,29,2181E,292181E,599,146,15,131,30,31,79,105,78,7,71,13,13,43,56
113,DALLAS,113,3083,1133083,2520,3232,368,2864,8,452,2383,2830,2205,319,1886,6,349,1506,1855
141,EL PASO,141,0120,1410120,3433,4841,324,4517,47,138,4353,4444,3844,292,3552,33,95,3424,3496
157,FORT BEND,157,2118,1572118,3682,11103,5405,5698,1741,2565,1243,3718,7320,3630,3690,1163,1673,732,2365
455,TRINITY,455,0001,4550001,9006,822,672,150,3,43,80,121,640,533,107,0,33,51,82
329,MIDLAND,329,0409,3290409,6848,4575,2559,2016,151,352,1429,1747,3596,2103,1493,112,247,1068,1298
423,SMITH,423,0040,4230040,7761,5091,4107,984,96,335,412,733,3863,3175,688,67,247,260,500
439,TARRANT,439,4342,4394342,8508,3200,2360,840,88,224,453,657,2482,1909,573,59,134,308,439
439,TARRANT,439,1549,4391549,8010,0,0,0,0,0,0,0,0,0,0,0,0,0,0
439,TARRANT,439,3049,4393049,8259,4034,3099,935,222,172,447,594,3131,2514,617,156,115,263,363
453,TRAVIS,453,0161,4530161,8757,2954,1015,1939,401,670,844,1485,2261,838,1423,281,516,602,1098
167,GALVESTON,167,4322,1674322,3931,0,0,0,0,0,0,0,0,0,0,0,0,0,0
193,HAMILTON,193,0012,1930012,4180,225,198,27,2,5,8,13,180,163,17,1,4,5,9
201,HARRIS,201,0212,2010212,4429,3097,110,2987,18,279,2701,2952,2207,90,2117,16,234,1882,2093
201,HARRIS,201,0461,2010461,4678,7964,3785,4179,1890,949,1245,2154,6247,3244,3003,1304,727,893,1595
201,HARRIS,201,0709,2010709,4927,7824,2957,4867,1359,1403,2060,3375,5672,2241,3431,995,980,1408,2336
303,LUBBOCK,303,0125,3030125,6599,2939,1956,983,129,131,677,785,2298,1628,670,91,84,464,537
27,BELL,27,0203,270203,207,4727,3553,1174,79,111,844,942,3557,2780,777,55,86,535,613
53,BURNET,53,0020,530020,1369,6675,4172,2503,196,227,1866,2067,5127,3438,1689,143,147,1238,1371
91,COMAL,91,0208C,910208C,1916,22,14,8,3,3,2,4,15,14,1,0,0,1,1
113,DALLAS,113,2613,1132613,2414,9207,2122,7085,5188,977,843,1772,7099,1871,5228,3725,785,646,1407
115,DAWSON,115,0017,1150017,2912,160,82,78,3,0,74,74,119,66,53,2,0,50,50
143,ERATH,143,0012,1430012,3539,1929,1565,364,47,47,230,271,1482,1249,233,26,32,146,175
315,MARION,315,0009,3150009,6742,600,475,125,6,60,27,84,491,403,88,3,45,21,64
355,NUECES,355,0124,3550124,7240,4836,1659,3177,256,199,2685,2859,3822,1443,2379,207,142,1979,2109
367,PARKER,367,0340,3670340,7369,1317,1135,182,13,10,117,126,934,832,102,5,6,62,68
439,TARRANT,439,1074,4391074,7867,2544,92,2452,10,438,2019,2426,1774,86,1688,4,331,1348,1664
439,TARRANT,439,3554,4393554,8365,3978,3022,956,330,145,355,493,2994,2337,657,224,94,230,323
453,TRAVIS,453,0313,4530313,8863,3792,2049,1743,906,146,635,765,3412,1854,1558,821,117,572,676
183,GREGG,183,0010,1830010,4037,9793,4441,5352,130,2489,2579,5001,7155,3589,3566,102,1632,1682,3284
187,GUADALUPE,187,0116,1870116,4074,4156,2277,1879,36,96,1648,1730,3309,1991,1318,21,62,1144,1203
201,HARRIS,201,0318,2010318,4535,6270,194,6076,104,3168,2827,5924,4620,171,4449,69,2501,1876,4350
215,HIDALGO,215,0145,2150145,5697,2044,30,2014,5,4,2007,2009,1486,27,1459,2,3,1453,1455
215,HIDALGO,215,0194,2150194,5746,3953,918,3035,7,22,3010,3017,3106,899,2207,5,14,2183,2190
257,KAUFMAN,257,0023,2570023,6244,2904,1487,1417,16,187,1139,1319,2119,1213,906,9,137,711,845
29,BEXAR,29,4166,294166,977,737,120,617,52,178,424,568,514,91,423,40,120,286,385
41,BRAZOS,41,0035,410035,1226,12318,7755,4563,1050,825,2443,3220,11360,7228,4132,979,745,2179,2889
99,CORYELL,99,0101,990101,1973,9419,4678,4741,388,2302,1826,3926,6543,3559,2984,228,1450,1074,2453
113,DALLAS,113,2011,1132011,2222,2531,1926,605,226,65,272,331,1897,1515,382,136,33,175,207
113,DALLAS,113,1086,1131086,2059,1698,262,1436,24,442,975,1399,1159,235,924,18,293,605,891
113,DALLAS,113,2122,1132122,2308,3971,682,3289,378,1937,959,2878,2919,598,2321,296,1365,651,2003
459,UPSHUR,459,0013,4590013,9055,952,692,260,6,161,60,214,755,546,209,3,129,50,173
479,WEBB,479,0465,4790465,9304,1696,22,1674,8,3,1668,1670,1233,17,1216,6,3,1210,1212
507,ZAVALA,507,001A,507001A,9633,1432,87,1345,14,21,1315,1325,956,69,887,11,11,870,875
265,KERR,265,0314,2650314,6301,4745,2232,2513,127,301,1991,2245,3698,1865,1833,90,216,1416,1619
281,LAMPASAS,281,0004,2810004,6387,1685,1303,382,36,47,248,290,1345,1092,253,17,34,161,190
309,MCLENNAN,309,0004,3090004,6636,147,85,62,1,22,37,54,136,85,51,1,18,27,43
369,PARMER,369,0202,3690202,7383,515,232,283,5,8,274,277,360,184,176,4,6,168,171
439,TARRANT,439,2658,4392658,8222,1414,249,1165,71,479,650,1090,1000,217,783,52,304,438,729
439,TARRANT,439,1420,4391420,7973,0,0,0,0,0,0,0,0,0,0,0,0,0,0
121,DENTON,121,3131,1213131,3055,7082,3569,3513,741,1186,1505,2647,5555,3054,2501,573,792,1057,1823
139,ELLIS,139,1050,1391050,3304,5728,2059,3669,97,2247,1272,3450,4022,1615,2407,62,1471,797,2243
167,GALVESTON,167,0386,1670386,3894,3624,2265,1359,448,275,596,853,2463,1556,907,309,191,389,573
201,HARRIS,201,0758,2010758,4976,6906,4640,2266,698,333,1053,1361,4761,3296,1465,470,213,652,860
201,HARRIS,201,1087,2011087,5305,5729,1894,3835,951,1625,1231,2782,4787,1695,3092,743,1307,1007,2259
215,HIDALGO,215,0002,2150002,5554,4317,429,3888,18,17,3864,3866,3183,413,2770,7,8,2756,2757
5,ANGELINA,5,0017,50017,44,2127,1938,189,6,29,69,93,1769,1633,136,5,20,46,65
29,BEXAR,29,4229,294229,1040,4933,555,4378,190,1123,3188,4138,3479,470,3009,134,760,2142,2823
29,BEXAR,29,2172,292172,585,669,132,537,31,36,489,517,487,105,382,15,26,347,366
73,CHEROKEE,73,0032,730032,1581,1436,1119,317,9,101,170,270,1080,862,218,9,65,110,174
85,COLLIN,85,0038,850038,1667,4698,1912,2786,1187,881,656,1482,3839,1711,2128,856,676,517,1166
113,DALLAS,113,4001,1134001,2663,3571,318,3253,49,110,3094,3189,2576,277,2299,37,89,2168,2246
239,JACKSON,239,0001,2390001,5995,3804,1801,2003,80,682,1240,1847,2859,1494,1365,47,427,847,1262
339,MONTGOMERY,339,0091,3390091,6991,6245,4390,1855,87,227,1330,1542,4607,3358,1249,52,166,856,1018
403,SABINE,403,0004,4030004,7618,318,299,19,0,6,7,12,250,239,11,0,1,4,5
441,TAYLOR,441,0205,4410205,8614,7283,2981,4302,161,1396,2689,3940,5366,2439,2927,129,913,1764,2644
451,TOM GREEN,451,0422,4510422,8700,1607,1283,324,11,23,258,273,1238,1007,231,8,15,172,182
479,WEBB,479,0219,4790219,9241,3193,118,3075,95,21,2971,2980,2329,96,2233,70,17,2159,2167
139,ELLIS,139,1036,1391036,3290,5459,3540,1919,121,677,967,1610,3777,2577,1200,65,417,583,995
201,HARRIS,201,0069,2010069,4286,3430,116,3314,43,61,3224,3265,2540,106,2434,34,42,2360,2392
201,HARRIS,201,0695,2010695,4913,5105,1618,3487,119,428,2924,3296,3531,1293,2238,75,241,1871,2103
201,HARRIS,201,1150,2011150,5368,0,0,0,0,0,0,0,0,0,0,0,0,0,0
201,HARRIS,201,0155,2010155,4372,7397,3387,4010,1668,388,1842,2216,5614,2674,2940,1311,285,1255,1532
227,HOWARD,227,0034,2270034,5909,2492,1421,1071,56,185,811,976,1968,1223,745,39,126,559,679
29,BEXAR,29,4123,294123,934,199,31,168,7,14,151,162,165,31,134,7,13,118,129
29,BEXAR,29,3081,293081,685,3356,1533,1823,161,361,1312,1603,2787,1395,1392,120,256,1003,1230
39,BRAZORIA,39,0070,390070,1183,5478,1424,4054,1148,1761,1154,2844,3951,1081,2870,822,1247,780,1988
61,CAMERON,61,0020,610020,1432,2301,220,2081,7,11,2056,2060,1675,174,1501,6,5,1481,1483
113,DALLAS,113,4609,1134609,2849,6371,595,5776,356,1170,4236,5348,4579,508,4071,290,918,2843,3723
121,DENTON,121,4173,1214173,3098,32,11,21,2,8,6,14,25,9,16,2,4,5,9
499,WOOD,499,01-3,49901-3,9596,2876,2485,391,17,35,230,258,2363,2084,279,11,19,159,173
355,NUECES,355,0062,3550062,7177,1754,173,1581,10,66,1508,1560,1341,141,1200,7,53,1138,1187
375,POTTER,375,0222,3750222,7426,5840,656,5184,2771,764,1683,2427,3945,535,3410,1927,378,1080,1449
411,SAN SABA,411,004A,411004A,7675,1505,970,535,11,112,412,511,1302,852,450,10,111,331,430
439,TARRANT,439,1238,4391238,7924,5300,1320,3980,161,1684,2124,3758,3868,1154,2714,127,1140,1399,2522
485,WICHITA,485,0301,4850301,9341,1817,1001,816,34,326,432,727,1358,843,515,23,170,284,445
497,WISE,497,0027,4970027,9590,4841,3962,879,33,43,528,566,3773,3164,609,28,19,334,353
141,EL PASO,141,0034,1410034,3347,2331,264,2067,187,291,1613,1870,2115,245,1870,166,262,1458,1696
149,FAYETTE,149,101N,149101N,3596,3300,1994,1306,15,368,900,1236,2487,1610,877,11,232,596,816
201,HARRIS,201,0795,2010795,5013,3143,207,2936,13,55,2867,2905,2311,186,2125,5,32,2082,2107
201,HARRIS,201,1044,2011044,5262,442,90,352,93,32,232,259,365,84,281,87,23,172,194
209,HAYS,209,0449,2090449,5511,2890,2022,868,63,50,679,720,2085,1505,580,38,40,436,472
215,HIDALGO,215,0208,2150208,5760,124,2,122,0,0,122,122,97,1,96,0,0,96,96
29,BEXAR,29,4023,294023,834,4053,707,3346,76,163,3135,3239,3074,630,2444,60,104,2273,2355
29,BEXAR,29,1043,291043,293,2774,277,2497,50,123,2338,2435,2088,252,1836,49,88,1705,1780
29,BEXAR,29,3185,293185,791,409,123,286,35,45,217,251,305,107,198,21,28,154,179
49,BROWN,49,0316,490316,1332,290,252,38,3,3,27,30,250,227,23,0,0,19,19
113,DALLAS,113,3020,1133020,2457,298,134,164,6,93,61,150,278,134,144,5,87,45,131
121,DENTON,121,1031,1211031,2955,4925,1926,2999,951,1018,943,1928,3554,1523,2031,620,700,642,1325
491,WILLIAMSON,491,0369,4910369,9490,5002,2545,2457,366,505,1544,1980,3581,1912,1669,257,324,1045,1326
323,MAVERICK,323,004B,323004B,6785,4840,203,4637,45,33,4566,4583,3437,147,3290,34,22,3243,3254
361,ORANGE,361,0028,3610028,7283,4251,3628,623,98,47,349,390,3091,2690,401,57,26,224,246
365,PANOLA,365,0012,3650012,7326,526,447,79,4,35,33,66,407,355,52,3,27,17,44
431,STERLING,431,0003,4310003,7824,331,231,100,3,4,91,94,247,178,69,0,2,65,66
453,TRAVIS,453,0413,4530413,8949,3230,2191,1039,354,98,530,616,2724,1925,799,226,88,428,504
491,WILLIAMSON,491,0264,4910264,9447,5698,2973,2725,270,345,2001,2308,4005,2217,1788,181,212,1282,1472
121,DENTON,121,2074,1212074,2998,2769,2219,550,90,80,259,338,2187,1789,398,54,58,186,244
141,EL PASO,141,0183,1410183,3496,0,0,0,0,0,0,0,0,0,0,0,0,0,0
201,HARRIS,201,0944,2010944,5162,312,8,304,1,110,195,299,206,7,199,0,75,125,196
201,HARRIS,201,0404,2010404,4621,7134,1188,5946,105,315,5541,5785,5252,1071,4181,68,205,3886,4053
201,HARRIS,201,0901,2010901,5119,6555,1424,5131,573,2041,2535,4499,4561,1064,3497,413,1378,1683,3030
215,HIDALGO,215,0108,2150108,5660,4110,150,3960,18,29,3914,3926,3044,100,2944,12,22,2914,2924
29,BEXAR,29,1142,291142,393,4503,560,3943,149,446,3435,3774,2954,418,2536,104,257,2202,2417
29,BEXAR,29,3038,293038,642,1553,572,981,44,48,872,910,1245,509,736,30,35,651,683
61,CAMERON,61,0063,610063,1475,2346,188,2158,20,9,2128,2130,1805,163,1642,19,4,1616,1616
85,COLLIN,85,0095,850095,1724,4495,2339,2156,887,617,568,1170,3253,1792,1461,633,403,372,766
113,DALLAS,113,4511,1134511,2806,5138,933,4205,61,457,3653,4069,3684,834,2850,52,341,2407,2732
113,DALLAS,113,3115,1133115,2557,3343,466,2877,77,1868,940,2768,2501,406,2095,66,1392,629,2005
337,MONTAGUE,337,0008,3370008,6885,1052,926,126,2,13,65,77,855,766,89,1,9,41,49
355,NUECES,355,0019,3550019,7134,3149,2706,443,60,17,237,249,2772,2411,361,47,10,195,202
439,TARRANT,439,1408,4391408,7967,372,128,244,7,15,204,219,311,113,198,5,12,169,181
439,TARRANT,439,2643,4392643,8216,5954,1944,4010,594,2340,1064,3344,3905,1357,2548,379,1457,665,2099
459,UPSHUR,459,0007,4590007,9049,4339,3193,1146,40,348,549,881,3249,2452,797,31,264,329,589
479,WEBB,479,0448,4790448,9298,871,37,834,3,9,827,828,606,26,580,3,7,574,575
157,FORT BEND,157,1159,1571159,3639,6829,1984,4845,2739,702,1337,2005,4259,1266,2993,1683,399,859,1240
167,GALVESTON,167,0357,1670357,3888,6183,4461,1722,407,176,1042,1207,4681,3505,1176,280,116,695,801
201,HARRIS,201,0752,2010752,4970,3252,1109,2143,100,217,1825,2005,2440,946,1494,83,150,1251,1377
201,HARRIS,201,0504,2010504,4721,3003,2035,968,254,118,535,646,2442,1709,733,209,92,384,473
215,HIDALGO,215,0251,2150251,5803,29,1,28,0,0,28,28,18,1,17,0,0,17,17
245,JEFFERSON,245,0024,2450024,6052,639,439,200,2,100,84,184,487,346,141,1,73,54,127
1,ANDERSON,1,0001,10001,1,3153,1660,1493,53,914,487,1381,2340,1347,993,40,632,284,911
29,BEXAR,29,2129,292129,542,0,0,0,0,0,0,0,0,0,0,0,0,0,0
37,BOWIE,37,0025,370025,1083,1880,1398,482,19,269,123,390,1412,1094,318,13,179,69,246
81,COKE,81,0004B,810004B,1624,16,9,7,0,0,7,7,16,9,7,0,0,7,7
113,DALLAS,113,4048,1134048,2706,12,0,12,0,3,9,11,8,0,8,0,1,7,8
113,DALLAS,113,1707,1131707,2165,5209,269,4940,309,897,3753,4608,3393,224,3169,271,558,2347,2886
297,LIVE OAK,297,0004,2970004,6493,998,611,387,10,7,354,360,786,505,281,10,6,252,257
347,NACOGDOCHES,347,0013,3470013,7034,1861,1513,348,20,109,154,258,1415,1162,253,16,80,102,178
397,ROCKWALL,397,003D,397003D,7575,5459,3924,1535,200,313,809,1111,3952,2963,989,128,221,495,714
439,TARRANT,439,2266,4392266,8116,4108,2818,1290,212,403,589,966,3228,2330,898,150,263,404,648
449,TITUS,449,0006,4490006,8657,1967,1154,813,14,120,607,712,1402,911,491,8,73,344,415
475,WARD,475,001W,475001W,9198,331,47,284,3,7,271,273,257,46,211,1,3,202,204
135,ECTOR,135,0407,1350407,3247,7015,1559,5456,15,77,5312,5375,4989,1289,3700,14,39,3612,3644
157,FORT BEND,157,4164,1574164,3788,2198,452,1746,914,529,315,829,1711,370,1341,703,397,244,632
201,HARRIS,201,0653,2010653,4870,3693,124,3569,25,588,3020,3538,2501,100,2401,18,413,2012,2379
201,HARRIS,201,0112,2010112,4329,4750,2343,2407,585,554,1224,1725,3604,1914,1690,472,354,821,1156
205,HARTLEY,205,0102,2050102,5411,564,389,175,3,9,162,168,414,293,121,3,9,111,117
231,HUNT,231,0212,2310212,5952,692,488,204,15,21,148,167,554,406,148,9,17,105,121
29,BEXAR,29,3084,293084,688,5175,2206,2969,194,384,2384,2697,4087,1874,2213,152,264,1752,1990
29,BEXAR,29,4209,294209,1020,72,26,46,1,4,42,46,46,20,26,0,3,23,26
29,BEXAR,29,1106,291106,356,0,0,0,0,0,0,0,0,0,0,0,0,0,0
53,BURNET,53,0003,530003,1352,3268,1292,1976,26,46,1851,1888,2409,1117,1292,21,18,1197,1214
85,COLLIN,85,0055,850055,1684,9561,4364,5197,3391,707,1028,1706,8867,4067,4800,3174,629,931,1539
111,DALLAM,111,0007,1110007,2016,1668,559,1109,12,38,1035,1070,1200,422,778,11,28,718,744
473,WALLER,473,0103,4730103,9178,557,198,359,4,63,277,337,448,184,264,0,51,203,253
491,WILLIAMSON,491,0403,4910403,9510,2947,1396,1551,123,457,982,1377,2060,1065,995,79,276,609,866
227,HOWARD,227,0408,2270408,5929,58,48,10,0,0,9,9,52,45,7,0,0,7,7
259,KENDALL,259,1050,2591050,6261,3739,2540,1199,82,98,975,1059,2746,1961,785,53,53,644,691
303,LUBBOCK,303,0119,3030119,6593,5526,2059,3467,196,677,2612,3202,3956,1695,2261,157,415,1669,2049
339,MONTGOMERY,339,0030,3390030,6925,3962,3095,867,75,170,534,697,2957,2371,586,60,120,344,460
439,TARRANT,439,4370,4394370,8514,0,0,0,0,0,0,0,0,0,0,0,0,0,0
453,TRAVIS,453,0282,4530282,8846,2993,2076,917,72,91,617,691,2422,1747,675,58,75,426,495
113,DALLAS,113,4018,1134018,2680,1538,987,551,129,176,238,400,1418,916,502,118,150,222,363
113,DALLAS,113,2224,1132224,2348,5812,3842,1970,1054,362,444,801,5255,3495,1760,931,350,396,742
201,HARRIS,201,0715,2010715,4933,1950,348,1602,342,713,541,1219,1440,297,1143,245,487,397,868
201,HARRIS,201,0384,2010384,4601,4921,1059,3862,246,2415,1222,3558,3593,641,2952,207,1906,839,2693
201,HARRIS,201,1047,2011047,5265,2207,752,1455,223,648,579,1200,1844,707,1137,189,488,437,917
215,HIDALGO,215,0045,2150045,5597,1772,446,1326,9,11,1296,1299,1442,432,1010,7,8,992,992
31,BLANCO,31,0201,310201,1043,2830,2171,659,26,30,511,535,2393,1910,483,19,23,368,386
55,CALDWELL,55,0108,550108,1375,1574,541,1033,12,100,917,1001,1144,435,709,10,68,622,684
85,COLLIN,85,0078,850078,1707,7808,3666,4142,1806,1272,933,2160,6990,3369,3621,1611,1078,800,1848
113,DALLAS,113,4044,1134044,2703,3107,38,3069,10,465,2591,3044,2157,36,2121,8,378,1731,2103
113,DALLAS,113,1058,1131058,2039,3466,1376,2090,56,154,1859,1993,2733,1216,1517,49,101,1331,1427
113,DALLAS,113,2405,1132405,2371,4418,2328,2090,527,413,1063,1457,3713,2094,1619,428,322,772,1086
201,HARRIS,201,0030,2010030,4246,5736,2232,3504,557,1856,1081,2862,4904,2157,2747,490,1278,941,2167
201,HARRIS,201,0361,2010361,4578,2849,982,1867,984,232,520,746,2831,977,1854,982,227,510,734
215,HIDALGO,215,0022,2150022,5574,1496,45,1451,6,7,1441,1441,1073,33,1040,5,7,1031,1031
227,HOWARD,227,0031,2270031,5906,166,92,74,3,11,63,74,112,76,36,0,5,31,36
257,KAUFMAN,257,0017,2570017,6238,2246,1858,388,20,39,273,309,1821,1544,277,7,24,193,217
491,WILLIAMSON,491,0456,4910456,9533,4052,1119,2933,51,627,2243,2827,3087,915,2172,35,507,1610,2099
121,DENTON,121,2111,1212111,3035,6788,2778,4010,1545,1153,1220,2332,5264,2351,2913,1196,796,820,1595
141,EL PASO,141,0054,1410054,3367,5616,660,4956,129,440,4493,4784,3991,549,3442,97,278,3089,3319
147,FANNIN,147,0015,1470015,3582,1408,1169,239,15,41,118,152,1059,906,153,11,25,71,92
167,GALVESTON,167,0438,1670438,3914,9063,2764,6299,205,3745,2300,5906,6663,2294,4369,155,2584,1527,4057
201,HARRIS,201,0692,2010692,4910,5617,3720,1897,256,506,985,1455,4587,3137,1450,196,374,732,1096
201,HARRIS,201,1024,2011024,5242,597,395,202,11,27,151,176,451,321,130,7,16,91,106
19,BANDERA,19,0306,190306,141,1622,1332,290,8,23,214,229,1397,1181,216,3,9,159,168
113,DALLAS,113,4069,1134069,2726,6091,666,5425,43,175,5207,5344,4557,591,3966,26,138,3793,3908
113,DALLAS,113,1089,1131089,2062,5137,184,4953,61,2607,2321,4886,3483,159,3324,56,1789,1485,3263
113,DALLAS,113,2514,1132514,2394,4587,2086,2501,625,625,1181,1796,3503,1772,1731,488,424,748,1170
113,DALLAS,113,4663,1134663,2895,0,0,0,0,0,0,0,0,0,0,0,0,0,0
121,DENTON,121,3134,1213134,3058,2792,1796,996,213,226,499,699,2187,1514,673,142,150,317,458
491,WILLIAMSON,491,0309,4910309,9464,4204,3218,986,82,90,659,747,3346,2634,712,61,61,468,529
381,RANDALL,381,0301,3810301,7472,2175,1852,323,16,18,193,209,1674,1464,210,13,14,114,127
427,STARR,427,0007,4270007,7804,1343,29,1314,2,2,1310,1310,939,26,913,2,2,911,911
439,TARRANT,439,4159,4394159,8468,4182,1255,2927,531,99,2240,2321,3038,1040,1998,438,67,1437,1493
439,TARRANT,439,2315,4392315,8136,3899,931,2968,293,2027,635,2619,3070,819,2251,251,1528,456,1952
453,TRAVIS,453,0223,4530223,8800,2442,1810,632,153,62,372,428,1955,1471,484,114,50,274,323
469,VICTORIA,469,0012,4690012,9132,1060,382,678,13,36,611,642,812,292,520,6,25,471,494
201,HARRIS,201,0007,2010007,4223,1294,32,1262,9,754,507,1253,987,27,960,9,627,328,952
201,HARRIS,201,0670,2010670,4887,4164,3286,878,109,91,570,658,3130,2525,605,85,52,381,430
201,HARRIS,201,0338,2010338,4555,10261,785,9476,2730,2667,4152,6705,7730,650,7080,2247,1879,3003,4806
201,HARRIS,201,1001,2011001,5219,4029,193,3836,533,1624,1621,3198,3006,176,2830,441,1171,1159,2301
201,HARRIS,201,0169,2010169,4386,3793,65,3728,18,2880,840,3691,2701,45,2656,4,2114,538,2631
355,NUECES,355,0025,3550025,7140,908,394,514,2,7,491,496,716,324,392,1,3,373,376
135,ECTOR,135,0301,1350301,3227,4465,1107,3358,33,150,3142,3274,3345,941,2404,27,108,2232,2335
141,EL PASO,141,0077,1410077,3390,4610,371,4239,84,197,3995,4149,3712,349,3363,68,163,3160,3290
145,FALLS,145,0102,1450102,3559,1423,708,715,8,401,291,682,1076,619,457,4,267,170,435
157,FORT BEND,157,3098,1573098,3722,5446,949,4497,1245,793,2474,3222,4115,762,3353,985,541,1795,2325
167,GALVESTON,167,0370,1670370,3891,3871,2707,1164,190,246,637,854,2918,2117,801,132,156,438,579
185,GRIMES,185,0006,1850006,4054,3086,1347,1739,29,722,974,1657,2389,1185,1204,21,517,644,1150
113,DALLAS,113,4093,1134093,2749,210,31,179,0,132,43,175,174,24,150,0,117,29,146
113,DALLAS,113,4632,1134632,2872,5111,694,4417,2092,1330,971,2259,3840,608,3232,1473,1028,693,1699
113,DALLAS,113,30T4,11330T4,2540,49,4,45,11,11,26,34,30,3,27,9,5,15,18
113,DALLAS,113,1750,1131750,2208,5611,1825,3786,1752,895,1126,1988,4533,1674,2859,1408,630,787,1414
121,DENTON,121,3157,1213157,3081,416,365,51,18,5,24,28,345,308,37,15,2,19,20
133,EASTLAND,133,0004,1330004,3204,395,312,83,1,5,68,73,337,279,58,1,5,46,51
439,TARRANT,439,2411,4392411,8159,1858,211,1647,34,554,1029,1562,1351,190,1161,31,385,721,1094
453,TRAVIS,453,0251,4530251,8823,5902,1505,4397,1194,1256,1989,3179,4761,1342,3419,984,920,1524,2402
469,VICTORIA,469,0035,4690035,9155,1308,141,1167,7,123,1050,1137,868,103,765,2,75,685,751
491,WILLIAMSON,491,0360,4910360,9487,7993,4202,3791,1332,781,1499,2217,5796,3230,2566,886,513,1028,1514
201,HARRIS,201,0855,2010855,5073,3494,704,2790,342,1540,881,2382,2482,551,1931,251,1070,568,1621
201,HARRIS,201,0315,2010315,4532,2446,1404,1042,226,238,581,768,1909,1173,736,162,176,389,539
201,HARRIS,201,0524,2010524,4741,7462,878,6584,825,2163,3656,5722,5450,752,4698,650,1479,2581,4009
201,HARRIS,201,0192,2010192,4409,4010,198,3812,44,1640,2146,3752,2951,166,2785,34,1284,1480,2739
433,STONEWALL,433,0002,4330002,7827,284,219,65,1,16,42,57,225,189,36,1,12,18,29
439,TARRANT,439,4245B,4394245B,8491,0,0,0,0,0,0,0,0,0,0,0,0,0,0
141,EL PASO,141,0221,1410221,3536,1324,626,698,209,203,286,426,1303,626,677,207,195,266,406
141,EL PASO,141,0100,1410100,3413,5149,504,4645,43,149,4471,4575,4001,435,3566,34,102,3420,3506
157,FORT BEND,157,3157,1573157,3745,2018,280,1738,1262,322,173,468,1384,217,1167,851,212,98,298
167,GALVESTON,167,0221,1670221,3868,2330,1965,365,45,40,234,267,2066,1788,278,36,18,173,191
187,GUADALUPE,187,0120,1870120,4077,1693,1060,633,20,53,517,562,1369,914,455,14,36,367,399
199,HARDIN,199,0003,1990003,4200,835,784,51,1,5,38,42,655,617,38,0,1,29,30
25,BEE,25,0018,250018,187,2417,1046,1371,40,84,1227,1294,1876,905,971,30,60,852,908
29,BEXAR,29,4040,294040,851,2480,195,2285,147,1167,1049,2113,1727,159,1568,96,838,652,1451
63,CAMP,63,2002,632002,1515,3126,2042,1084,37,265,696,953,2475,1764,711,31,163,438,601
85,COLLIN,85,0224,850224,1853,3525,2578,947,297,279,277,536,2438,1861,577,194,158,166,318
113,DALLAS,113,3080,1133080,2517,3430,445,2985,13,813,2154,2931,2318,363,1955,9,550,1379,1914
127,DIMMIT,127,0002,1270002,3181,2236,231,2005,26,40,1944,1970,1601,172,1429,21,26,1386,1406
289,LEON,289,0006,2890006,6430,1466,1288,178,6,25,80,104,1201,1094,107,4,10,36,46
351,NEWTON,351,0011,3510011,7094,711,658,53,2,17,16,32,552,518,34,2,7,7,14
415,SCURRY,415,0005,4150005,7681,143,101,42,2,2,36,36,112,79,33,1,1,27,27
423,SMITH,423,0037,4230037,7758,2401,1816,585,52,252,215,463,1781,1385,396,34,171,137,306
439,TARRANT,439,3470,4393470,8345,267,119,148,42,11,94,103,195,99,96,23,7,64,71
455,TRINITY,455,0004,4550004,9009,331,290,41,7,8,17,25,280,249,31,7,6,12,18
141,EL PASO,141,0123,1410123,3436,5432,320,5112,65,99,4969,5029,4263,272,3991,54,76,3873,3922
167,GALVESTON,167,0151,1670151,3845,6252,3568,2684,205,199,2098,2277,4959,3131,1828,171,124,1359,1475
187,GUADALUPE,187,0216,1870216,4100,76,46,30,1,1,27,28,54,36,18,0,0,18,18
201,HARRIS,201,0547,2010547,4764,4321,2356,1965,195,377,1319,1663,3318,1886,1432,139,240,967,1198
209,HAYS,209,0102,2090102,5428,0,0,0,0,0,0,0,0,0,0,0,0,0,0
215,HIDALGO,215,0214,2150214,5766,3821,161,3660,22,23,3626,3627,2620,138,2482,11,9,2460,2460
21,BASTROP,21,3019,213019,164,6859,1922,4937,38,193,4640,4789,4919,1640,3279,25,140,3038,3153
29,BEXAR,29,4017,294017,828,3099,1002,2097,83,219,1776,1964,2810,939,1871,70,204,1579,1759
29,BEXAR,29,1037,291037,287,5861,610,5251,86,386,4775,5094,4234,528,3706,68,280,3320,3564
29,BEXAR,29,2089,292089,502,1015,30,985,9,24,970,975,744,23,721,4,22,708,713
39,BRAZORIA,39,0053,390053,1166,4703,747,3956,613,2283,1116,3309,3143,557,2586,424,1497,688,2139
85,COLLIN,85,0201,850201,1830,0,0,0,0,0,0,0,0,0,0,0,0,0,0
453,TRAVIS,453,0461,4530461,8986,6621,893,5728,102,671,4975,5553,4655,776,3879,76,456,3345,3755
453,TRAVIS,453,0467,4530467,8992,4723,1066,3657,221,516,2944,3384,3607,913,2694,171,393,2122,2473
339,MONTGOMERY,339,0094,3390094,6994,7448,3873,3575,448,890,2098,2943,5833,3267,2566,344,667,1421,2065
355,NUECES,355,0002,3550002,7117,4043,1549,2494,76,154,2228,2355,3301,1374,1927,68,109,1706,1802
409,SAN PATRICIO,409,0114,4090114,7658,3825,1904,1921,66,90,1697,1757,2802,1512,1290,45,56,1127,1171
423,SMITH,423,0060,4230060,7781,2272,551,1721,19,221,1459,1670,1562,435,1127,14,166,926,1087
439,TARRANT,439,4101,4394101,8445,3357,640,2717,353,86,2242,2325,2422,527,1895,296,52,1510,1560
439,TARRANT,439,3368,4393368,8322,944,742,202,30,14,114,125,809,646,163,28,12,89,98
113,DALLAS,113,3057,1133057,2494,4573,197,4376,20,1746,2625,4342,3375,183,3192,14,1430,1753,3165
187,GUADALUPE,187,0309,1870309,4123,5519,2586,2933,371,902,1606,2408,3858,1910,1948,252,599,1030,1595
201,HARRIS,201,0570,2010570,4787,3793,1602,2191,850,543,760,1273,3387,1510,1877,688,489,652,1117
209,HAYS,209,0206,2090206,5451,4918,1669,3249,120,374,2726,3054,3709,1383,2326,87,315,1891,2184
245,JEFFERSON,245,0087,2450087,6115,2086,217,1869,23,1429,432,1835,1504,200,1304,19,1016,261,1274
291,LIBERTY,291,0021,2910021,6453,5031,3796,1235,14,135,908,1039,3769,2980,789,10,95,543,637
29,BEXAR,29,4163,294163,974,3210,768,2442,184,1038,1259,2217,2331,583,1748,133,761,844,1576
29,BEXAR,29,4086,294086,897,1022,396,626,20,21,574,585,775,313,462,11,15,425,433
29,BEXAR,29,1060,291060,310,6077,187,5890,59,113,5751,5827,4147,138,4009,37,67,3921,3962
29,BEXAR,29,2066,292066,479,4872,1843,3029,225,286,2542,2765,3697,1472,2225,163,180,1876,2027
39,BRAZORIA,39,0030,390030,1143,4522,2781,1741,215,531,884,1403,3760,2323,1437,154,478,704,1177
71,CHAMBERS,71,0010,710010,1561,2181,1712,469,13,63,312,367,1626,1323,303,8,46,186,226
381,RANDALL,381,0208,3810208,7466,1910,1593,317,20,26,207,230,1288,1092,196,12,11,133,143
407,SAN JACINTO,407,0002,4070002,7635,7103,4558,2545,29,606,1704,2277,5198,3488,1710,23,447,1078,1501
439,TARRANT,439,3287,4393287,8299,4264,2616,1648,335,236,974,1181,3273,2108,1165,253,156,653,793
215,HIDALGO,215,0168,2150168,5720,706,12,694,1,0,689,689,531,10,521,1,0,516,516
249,JIM WELLS,249,0001,2490001,6138,1044,154,890,6,20,859,869,814,138,676,4,10,650,658
265,KERR,265,0417,2650417,6307,2489,1909,580,37,41,435,466,2046,1659,387,32,20,276,290
281,LAMPASAS,281,0001,2810001,6384,2994,1902,1092,145,356,495,814,2343,1577,766,109,271,313,560
327,MENARD,327,0001,3270001,6802,471,196,275,3,9,255,264,381,161,220,2,7,203,210
339,MONTGOMERY,339,0072,3390072,6971,4507,3927,580,78,83,302,380,4006,3555,451,66,70,220,285
85,COLLIN,85,0178,850178,1807,4198,2884,1314,302,266,602,864,2843,2021,822,167,167,409,575
113,DALLAS,113,2017,1132017,2225,3597,1503,2094,388,1037,634,1635,3262,1435,1827,357,873,549,1403
113,DALLAS,113,4657,1134657,2889,328,15,313,27,65,236,280,263,11,252,22,46,198,223
201,HARRIS,201,0838,2010838,5056,0,0,0,0,0,0,0,0,0,0,0,0,0,0
201,HARRIS,201,0175,2010175,4392,3876,2488,1388,614,196,515,692,2753,1810,943,402,152,341,485
209,HAYS,209,0331,2090331,5474,1025,701,324,25,54,233,275,889,627,262,22,25,196,217
27,BELL,27,0206,270206,210,4421,1105,3316,343,1941,1003,2810,3134,883,2251,237,1307,632,1868
29,BEXAR,29,4186,294186,997,141,80,61,4,4,50,54,108,69,39,2,4,30,34
29,BEXAR,29,4063,294063,874,2146,310,1836,99,335,1467,1727,1617,271,1346,90,245,1046,1246
29,BEXAR,29,2044,292044,456,5315,224,5091,72,251,4813,4998,3677,157,3520,48,144,3330,3451
29,BEXAR,29,1083,291083,333,4093,1021,3072,145,357,2605,2907,3027,820,2207,90,275,1836,2082
39,BRAZORIA,39,0007,390007,1120,5497,1433,4064,31,781,3261,3938,4039,1217,2822,26,504,2244,2721
383,REAGAN,383,0001,3830001,7489,859,67,792,19,21,743,759,594,63,531,19,14,491,503
401,RUSK,401,0416,4010416,7612,1676,983,693,13,132,523,655,1292,835,457,8,91,338,429
439,TARRANT,439,2383,4392383,8153,4348,1166,3182,370,1360,1480,2772,3192,990,2202,278,938,990,1882
251,JOHNSON,251,0003,2510003,6161,3634,2763,871,72,120,578,678,2774,2186,588,46,76,370,439
263,KENT,263,0202,2630202,6284,113,95,18,3,2,17,18,96,83,13,2,2,12,13
285,LAVACA,285,0329,2850329,6407,1995,1637,358,11,83,210,287,1559,1337,222,6,50,130,176
329,MIDLAND,329,0205,3290205,6825,2210,1712,498,24,57,361,409,1663,1320,343,16,34,244,274
339,MONTGOMERY,339,0050,3390050,6948,5128,4131,997,88,168,569,723,4179,3478,701,68,97,402,493
349,NAVARRO,349,0305,3490305,7071,1003,609,394,16,53,267,314,733,485,248,13,34,158,191
67,CASS,67,0017,670017,1538,4343,3272,1071,23,742,197,934,3300,2620,680,16,469,125,590
85,COLLIN,85,0032,850032,1661,3158,2244,914,240,177,435,590,2522,1831,691,191,123,316,429
113,DALLAS,113,1744,1131744,2202,99,31,68,3,23,46,65,64,27,37,3,11,24,35
201,HARRIS,201,0861,2010861,5079,4773,233,4540,160,1993,2419,4362,3377,199,3178,152,1468,1578,3014
215,HIDALGO,215,0191,2150191,5743,902,23,879,9,6,867,867,595,18,577,8,4,569,569
215,HIDALGO,215,0068,2150068,5620,7750,394,7356,30,83,7253,7312,5209,304,4905,18,38,4845,4869
1,ANDERSON,1,0020,10020,18,2048,1011,1037,31,307,656,952,1539,853,686,22,203,414,614
29,BEXAR,29,3159,293159,765,5165,1350,3815,109,1360,2354,3625,3963,1189,2774,79,961,1699,2621
439,TARRANT,439,1463,4391463,7991,5447,1011,4436,146,2940,1414,4241,4167,893,3274,125,2145,1019,3105
463,UVALDE,463,0005,4630005,9073,2822,1160,1662,50,67,1510,1567,2271,978,1293,40,62,1159,1211
113,DALLAS,113,3305,1133305,2581,7063,2079,4984,482,1828,2581,4356,5297,1798,3499,407,1228,1755,2968
201,HARRIS,201,0531,2010531,4748,4307,2278,2029,27,291,1660,1923,3275,1860,1415,23,204,1128,1323
215,HIDALGO,215,0029,2150029,5581,2447,322,2125,19,31,2084,2100,1652,310,1342,16,29,1305,1321
219,HOCKLEY,219,0024,2190024,5830,1528,727,801,5,23,749,770,1072,554,518,3,12,481,492
245,JEFFERSON,245,0048,2450048,6076,2937,124,2813,91,505,2239,2713,1991,103,1888,73,379,1432,1802
309,MCLENNAN,309,0031,3090031,6663,4300,1971,2329,47,1183,1060,2202,3286,1703,1583,39,791,710,1480
3,ANDREWS,3,0003,30003,25,4686,1705,2981,38,120,2739,2832,3265,1333,1932,22,87,1753,1829
29,BEXAR,29,4001,294001,812,3564,1647,1917,213,258,1360,1592,3425,1618,1807,201,235,1277,1496
29,BEXAR,29,1021,291021,271,3139,167,2972,16,34,2930,2941,2240,145,2095,11,24,2062,2070
29,BEXAR,29,2153,292153,566,859,203,656,37,138,470,605,664,178,486,31,105,336,438
37,BOWIE,37,011A,37011A,1107,2405,2028,377,58,110,89,196,1820,1540,280,35,86,59,142
53,BURNET,53,0004,530004,1353,3068,2497,571,35,40,408,447,2585,2192,393,23,28,270,298
303,LUBBOCK,303,0001,3030001,6517,6681,1934,4747,256,777,3762,4422,5247,1767,3480,205,512,2742,3215
321,MATAGORDA,321,0013,3210013,6763,440,283,157,11,103,41,142,360,240,120,6,84,26,110
349,NAVARRO,349,0108,3490108,7058,772,427,345,3,37,284,318,591,368,223,2,30,170,199
363,PALO PINTO,363,0016,3630016,7304,488,431,57,4,2,23,25,423,380,43,3,2,12,14
439,TARRANT,439,1008,4391008,7845,589,40,549,10,184,356,536,421,38,383,7,147,227,371
439,TARRANT,439,3648,4393648,8386,6198,3716,2482,613,707,1017,1677,4177,2613,1564,412,407,630,1014
89,COLORADO,89,0401,890401,1894,668,321,347,5,106,223,326,502,252,250,4,84,151,235
113,DALLAS,113,2913,1132913,2435,31,10,21,0,12,11,18,18,7,11,0,6,7,9
201,HARRIS,201,0676,2010676,4894,6877,1011,5866,407,974,4517,5399,5007,840,4167,333,680,3137,3766
209,HAYS,209,0120,2090120,5435,3150,994,2156,132,234,1743,1947,2284,834,1450,100,153,1155,1285
231,HUNT,231,215B,231215B,5976,3122,2479,643,31,75,421,483,2220,1811,409,19,49,253,299
257,KAUFMAN,257,0001,2570001,6222,6376,2882,3494,83,657,2635,3253,4558,2243,2315,56,462,1694,2132
29,BEXAR,29,4150,294150,961,3066,640,2426,154,963,1364,2224,2316,544,1772,94,716,964,1627
29,BEXAR,29,3189,293189,795,1549,606,943,308,115,516,619,1116,451,665,213,81,355,430
41,BRAZOS,41,0101,410101,1293,97,28,69,3,15,47,62,69,23,46,1,8,33,41
61,CAMERON,61,0047,610047,1459,3837,293,3544,15,26,3510,3522,2902,277,2625,14,17,2596,2608
85,COLLIN,85,0162,850162,1791,318,247,71,5,11,47,53,271,213,58,4,5,43,43
97,COOKE,97,0002,970002,1957,5569,2307,3262,46,515,2545,3035,3983,1889,2094,37,358,1568,1918
503,YOUNG,503,0010,5030010,9617,768,621,147,5,8,95,103,568,472,96,4,4,52,56
245,JEFFERSON,245,0008,2450008,6036,1275,119,1156,19,939,196,1128,941,111,830,16,688,124,805
277,LAMAR,277,2A1A,2772A1A,6368,1965,710,1255,9,906,288,1181,1505,566,939,6,709,186,886
303,LUBBOCK,303,0020,3030020,6534,2272,109,2163,17,1649,557,2149,1698,83,1615,8,1269,359,1604
345,MOTLEY,345,0006,3450006,7032,244,178,66,5,8,52,59,196,153,43,3,6,32,38
453,TRAVIS,453,0417,4530417,8953,2356,1506,850,115,103,619,700,2171,1411,760,102,98,547,625
491,WILLIAMSON,491,0277,4910277,9451,5955,4160,1795,628,232,816,1025,4324,3132,1192,428,156,522,667
113,DALLAS,113,3018,1133018,2455,2678,92,2586,19,1993,598,2559,2135,87,2048,11,1687,373,2032
121,DENTON,121,1029,1211029,2953,247,25,222,1,14,208,219,159,12,147,1,4,144,146
201,HARRIS,201,1154,2011154,5372,0,0,0,0,0,0,0,0,0,0,0,0,0,0
201,HARRIS,201,0657,2010657,4874,3894,729,3165,182,1114,1879,2950,3051,657,2394,143,859,1378,2218
213,HENDERSON,213,004W,213004W,5538,1293,1025,268,20,44,171,211,1015,835,180,14,36,104,140
223,HOPKINS,223,0023,2230023,5870,415,284,131,10,35,62,95,330,236,94,5,23,44,67
29,BEXAR,29,4127,294127,938,212,27,185,1,48,136,182,141,27,114,1,31,84,113
29,BEXAR,29,2028,292028,440,3346,637,2709,62,139,2557,2653,2733,602,2131,35,96,2016,2088
61,CAMERON,61,0024,610024,1436,2908,117,2791,4,7,2769,2772,1992,89,1903,0,3,1884,1885
77,CLAY,77,0009,770009,1602,519,463,56,5,1,26,27,406,361,45,5,1,16,17
93,COMANCHE,93,0001,930001,1934,2492,1636,856,26,19,760,772,1887,1363,524,21,13,445,454
113,DALLAS,113,1140,1131140,2100,0,0,0,0,0,0,0,0,0,0,0,0,0,0
465,VAL VERDE,465,0031,4650031,9096,5236,1458,3778,146,173,3445,3568,3715,1174,2541,114,111,2287,2376
499,WOOD,499,01-1,49901-1,9594,4354,3559,795,27,212,405,610,3674,3110,564,22,157,248,403
397,ROCKWALL,397,0001,3970001,7553,6097,4619,1478,353,329,632,944,4466,3516,950,222,211,393,596
439,TARRANT,439,4067,4394067,8432,3006,192,2814,17,53,2742,2782,2289,155,2134,10,45,2080,2114
439,TARRANT,439,1273,4391273,7934,6207,919,5288,108,236,4910,5110,4362,796,3566,88,158,3277,3418
439,TARRANT,439,1103,4391103,7885,1881,1139,742,58,222,409,620,1563,999,564,39,185,296,474
439,TARRANT,439,4737B,4394737B,8598,49,23,26,11,12,1,12,28,18,10,2,7,0,7
439,TARRANT,439,2210,4392210,8100,3693,530,3163,101,251,2781,3017,2558,458,2100,68,178,1826,1995
203,HARRISON,203,0012,2030012,5395,4052,3215,837,56,329,316,640,2908,2380,528,42,195,195,386
215,HIDALGO,215,0175,2150175,5727,2390,92,2298,4,4,2289,2290,1705,78,1627,4,1,1619,1619
225,HOUSTON,225,0018,2250018,5893,177,114,63,1,36,14,50,143,90,53,1,36,10,46
281,LAMPASAS,281,0008,2810008,6391,3023,2139,884,80,239,450,669,2344,1718,626,63,169,307,463
337,MONTAGUE,337,0012,3370012,6889,208,158,50,0,4,25,29,179,138,41,0,1,24,25
369,PARMER,369,0402,3690402,7387,1865,139,1726,11,27,1695,1703,1237,103,1134,7,17,1113,1119
29,BEXAR,29,2170,292170,583,6304,1906,4398,903,500,3042,3434,4854,1576,3278,655,350,2256,2553
113,DALLAS,113,4541,1134541,2833,0,0,0,0,0,0,0,0,0,0,0,0,0,0
113,DALLAS,113,1711,1131711,2169,6720,1089,5631,81,380,5141,5480,4763,941,3822,45,261,3492,3723
123,DEWITT,123,0102,1230102,3165,2250,450,1800,18,575,1214,1748,1645,363,1282,11,403,851,1245
141,EL PASO,141,0187,1410187,3500,0,0,0,0,0,0,0,0,0,0,0,0,0,0
163,FRIO,163,0009,1630009,3829,2016,220,1796,6,6,1764,1768,1417,165,1252,3,5,1226,1230
423,SMITH,423,0021,4230021,7742,2159,1654,505,57,157,242,387,1597,1282,315,40,84,147,228
439,TARRANT,439,3728,4393728,8406,3974,2202,1772,1305,148,270,408,2749,1633,1116,805,100,168,261
439,TARRANT,439,4638,4394638,8575,5656,2875,2781,407,1020,1236,2192,3718,1993,1725,264,615,745,1328
439,TARRANT,439,2746,4392746,8243,3443,982,2461,204,835,1433,2213,2479,838,1641,168,593,884,1444
479,WEBB,479,0177,4790177,9239,2458,33,2425,2,8,2418,2419,1702,18,1684,1,2,1680,1681
189,HALE,189,0408,1890408,4164,1161,518,643,13,46,564,608,871,453,418,12,23,363,386
201,HARRIS,201,0942,2010942,5160,1121,49,1072,9,82,985,1067,764,41,723,6,68,651,719
201,HARRIS,201,0279,2010279,4496,4003,1172,2831,73,220,2485,2691,2840,932,1908,56,129,1667,1793
317,MARTIN,317,0003,3170003,6746,1106,692,414,8,18,374,389,827,555,272,3,8,254,261
373,POLK,373,0014,3730014,7410,3016,2454,562,9,75,253,320,2281,1922,359,4,42,142,181
397,ROCKWALL,397,004C,397004C,7579,2754,1950,804,56,244,442,672,1929,1413,516,34,158,273,428
13,ATASCOSA,13,0011,130011,105,2789,898,1891,29,43,1783,1811,2049,717,1332,22,28,1243,1269
27,BELL,27,0308,270308,228,7360,3501,3859,452,1761,1612,3212,5575,3000,2575,337,1100,1022,2070
29,BEXAR,29,2147,292147,560,1220,293,927,67,170,718,846,923,244,679,50,131,517,622
29,BEXAR,29,3163,293163,769,3738,1882,1856,298,210,1363,1522,2748,1477,1271,194,136,923,1035
37,BOWIE,37,006A,37006A,1101,3351,2421,930,97,554,190,725,2641,1989,652,70,363,143,496
85,COLLIN,85,0185,850185,1814,91,84,7,1,1,4,5,61,59,2,0,0,2,2
453,TRAVIS,453,0342,4530342,8884,4579,2722,1857,326,254,1235,1451,3750,2342,1408,241,196,911,1094
453,TRAVIS,453,0165,4530165,8761,4347,1589,2758,323,831,1567,2347,3374,1320,2054,256,601,1138,1718
491,WILLIAMSON,491,0207,4910207,9425,4559,3255,1304,95,81,1004,1068,3364,2492,872,64,55,644,691
491,WILLIAMSON,491,0322,4910322,9474,2217,1607,610,214,80,272,337,1666,1253,413,156,47,181,223
251,JOHNSON,251,0020,2510020,6179,3726,1391,2335,28,327,1800,2107,2570,1062,1508,16,249,1147,1383
303,LUBBOCK,303,0047,3030047,6560,4655,2356,2299,184,427,1628,1987,3549,1985,1564,144,263,1075,1303
351,NEWTON,351,0018,3510018,7101,379,352,27,1,21,3,24,293,277,16,1,13,1,14
355,NUECES,355,0108,3550108,7224,2317,720,1597,13,24,1562,1576,1953,695,1258,11,22,1226,1239
423,SMITH,423,0044,4230044,7765,6429,3105,3324,112,1674,1451,3077,4784,2586,2198,71,1159,878,2012
439,TARRANT,439,2656,4392656,8220,411,131,280,11,83,182,259,312,107,205,8,71,125,193
113,DALLAS,113,4515,1134515,2810,6461,673,5788,41,235,5520,5697,4559,574,3985,32,133,3809,3915
141,EL PASO,141,0161,1410161,3474,2296,69,2227,4,29,2203,2217,1708,57,1651,3,15,1635,1644
161,FREESTONE,161,0005B,1610005B,3806,1500,652,848,5,404,436,835,1461,641,820,4,394,420,810
167,GALVESTON,167,0191,1670191,3855,4333,3114,1219,188,271,705,932,3299,2456,843,130,195,468,640
201,HARRIS,201,0302,2010302,4519,7384,1578,5806,60,206,5537,5662,5274,1328,3946,43,119,3756,3843
211,HEMPHILL,211,0101,2110101,5515,839,428,411,9,7,367,371,568,340,228,2,3,200,200
29,BEXAR,29,3022,293022,626,2134,1445,689,100,80,504,566,1593,1131,462,57,49,340,384
29,BEXAR,29,2048,292048,460,3665,242,3423,27,94,3326,3389,2760,208,2552,25,48,2485,2520
39,BRAZORIA,39,0011,390011,1124,4982,2027,2955,661,533,1670,2173,3735,1616,2119,502,366,1148,1506
113,DALLAS,113,4157,1134157,2790,853,56,797,10,47,743,760,621,49,572,9,34,527,544
113,DALLAS,113,1303,1131303,2126,513,39,474,8,277,193,467,336,33,303,2,180,124,301
113,DALLAS,113,3620,1133620,2624,1841,150,1691,26,1385,316,1670,1428,141,1287,22,1058,223,1268
309,MCLENNAN,309,0070,3090070,6703,707,477,230,6,38,121,154,509,376,133,3,16,59,75
333,MILLS,333,0002,3330002,6869,139,117,22,2,0,15,15,106,91,15,0,0,10,10
367,PARKER,367,0330,3670330,7367,3230,2027,1203,24,38,1005,1039,2454,1671,783,16,27,624,649
441,TAYLOR,441,0302,4410302,8618,3690,2565,1125,89,255,730,963,2853,2141,712,59,153,450,593
467,VAN ZANDT,467,004A,467004A,9116,2081,1666,415,22,50,261,307,1617,1351,266,18,23,161,184
479,WEBB,479,0371,4790371,9282,3935,223,3712,67,32,3617,3638,2809,174,2635,52,23,2559,2578
139,ELLIS,139,1034,1391034,3288,5466,4049,1417,89,458,698,1144,3873,2932,941,60,317,449,761
183,GREGG,183,0014,1830014,4041,6882,5070,1812,54,565,1028,1561,5097,3907,1190,42,411,608,1007
201,HARRIS,201,0985,2010985,5203,525,250,275,51,130,91,216,434,216,218,42,110,68,173
201,HARRIS,201,0488,2010488,4705,3930,372,3558,527,861,2211,3014,2942,345,2597,469,577,1562,2109
201,HARRIS,201,0322,2010322,4539,4594,430,4164,67,1335,2818,4066,2979,376,2603,48,875,1711,2539
253,JONES,253,0003,2530003,6205,8512,4446,4066,49,1598,2323,3895,7669,3826,3843,40,1568,2165,3716
29,BEXAR,29,2070,292070,483,4060,117,3943,16,85,3838,3893,2841,88,2753,6,50,2682,2722
99,CORYELL,99,0205,990205,1977,3800,2853,947,50,128,647,754,2849,2211,638,33,88,415,493
113,DALLAS,113,3038,1133038,2475,1221,53,1168,14,766,388,1152,956,45,911,12,645,255,899
113,DALLAS,113,3940,1133940,2641,6428,1025,5403,26,1831,3512,5288,4447,875,3572,17,1285,2210,3478
113,DALLAS,113,3962,1133962,2647,7075,3078,3997,1030,1432,1439,2838,5592,2632,2960,769,1030,1067,2076
129,DONLEY,129,0201,1290201,3188,825,686,139,11,41,73,109,617,527,90,9,25,40,63
469,VICTORIA,469,0019,4690019,9139,4993,1764,3229,215,435,2584,2956,3678,1460,2218,164,278,1750,2006
201,HARRIS,201,1134,2011134,5352,4356,2219,2137,741,592,727,1299,3108,1627,1481,530,403,491,883
201,HARRIS,201,0962,2010962,5180,8276,2030,6246,50,3999,2243,6190,8172,2021,6151,48,3946,2201,6098
329,MIDLAND,329,0407,3290407,6846,6003,2896,3107,247,570,2244,2761,4526,2342,2184,171,376,1596,1938
367,PARKER,367,0130,3670130,7344,6110,4419,1691,62,90,1231,1310,4572,3473,1099,44,53,755,808
439,TARRANT,439,4195,4394195,8475,4544,273,4271,59,67,4144,4196,3075,213,2862,42,36,2779,2810
445,TERRY,445,0101,4450101,8641,3327,1791,1536,13,161,1333,1479,2480,1428,1052,9,134,883,1013
189,HALE,189,0104,1890104,4141,1344,304,1040,16,69,920,979,967,267,700,5,45,615,659
201,HARRIS,201,0637,2010637,4854,4554,654,3900,83,323,3484,3783,3629,583,3046,67,272,2687,2952
201,HARRIS,201,0588,2010588,4805,6645,2779,3866,282,1300,2121,3359,5034,2354,2680,213,911,1400,2287
201,HARRIS,201,0422,2010422,4639,5387,64,5323,30,4533,802,5266,3987,43,3944,20,3405,543,3905
201,HARRIS,201,0465,2010465,4682,7146,1616,5530,334,2877,2354,5113,5385,1451,3934,276,2016,1622,3575
201,HARRIS,201,1128,2011128,5346,5045,2937,2108,452,494,1085,1549,3645,2258,1387,309,326,677,990
9,ARCHER,9,0011,90011,85,27,24,3,0,0,3,3,22,20,2,0,0,2,2
29,BEXAR,29,3146,293146,752,5620,1944,3676,461,394,2837,3164,4643,1701,2942,391,306,2223,2492
61,CAMERON,61,0004,610004,1416,4167,748,3419,116,39,3246,3280,3155,634,2521,79,25,2394,2416
85,COLLIN,85,0205,850205,1834,36,21,15,11,2,1,3,24,13,11,8,1,1,2
113,DALLAS,113,3061,1133061,2498,2920,73,2847,8,1990,872,2835,2070,48,2022,7,1478,543,2011
113,DALLAS,113,4005,1134005,2667,2656,508,2148,137,231,1794,2004,1995,462,1533,116,167,1246,1408
303,LUBBOCK,303,0072,3030072,6577,5233,2491,2742,196,499,1975,2417,3881,2040,1841,148,307,1285,1582
355,NUECES,355,0128,3550128,7244,4541,1543,2998,398,289,2302,2539,3279,1231,2048,284,200,1539,1711
439,TARRANT,439,1170,4391170,7908,5102,1598,3504,203,1239,2012,3198,3750,1386,2364,132,876,1289,2142
439,TARRANT,439,2031,4392031,8077,5140,957,4183,824,2209,1144,3290,3597,710,2887,625,1493,744,2212
453,TRAVIS,453,0142,4530142,8741,4318,1436,2882,225,1043,1613,2587,3236,1167,2069,175,758,1108,1835
491,WILLIAMSON,491,0174,4910174,9408,4766,2601,2165,613,427,1082,1447,3981,2280,1701,483,340,828,1126
141,EL PASO,141,0018,1410018,3331,4314,1529,2785,235,179,2375,2520,3334,1254,2080,182,125,1769,1870
181,GRAYSON,181,0203,1810203,3998,2306,1292,1014,26,404,443,821,1708,1037,671,17,297,271,555
201,HARRIS,201,0445,2010445,4662,5046,1501,3545,314,414,2808,3169,3797,1314,2483,244,306,1911,2189
201,HARRIS,201,0614,2010614,4831,7884,649,7235,1395,2664,3257,5838,5983,541,5442,1157,2036,2275,4263
209,HAYS,209,0424,2090424,5495,3484,2153,1331,120,113,1019,1109,2299,1479,820,70,71,607,673
227,HOWARD,227,0042,2270042,5913,1258,451,807,20,74,711,775,912,355,557,11,48,485,530
5,ANGELINA,5,0035,50035,62,2614,1750,864,54,418,347,757,2071,1481,590,49,262,233,493
29,BEXAR,29,3122,293122,726,3459,1726,1733,168,259,1270,1489,2815,1501,1314,129,184,946,1114
29,BEXAR,29,3169,293169,775,233,102,131,17,8,106,113,189,96,93,8,7,78,84
29,BEXAR,29,2182B,292182B,603,246,89,157,14,54,103,147,182,72,110,7,44,67,105
41,BRAZOS,41,0076,410076,1267,4464,2829,1635,414,434,685,1092,3484,2321,1163,318,298,475,759
47,BROOKS,47,0003,470003,1316,1299,79,1220,15,10,1192,1198,944,63,881,13,6,855,861
453,TRAVIS,453,0114,4530114,8718,3048,1756,1292,136,194,922,1100,2636,1578,1058,117,157,736,887
479,WEBB,479,0272,4790272,9259,3811,173,3638,69,43,3513,3547,2807,138,2669,53,34,2572,2598
491,WILLIAMSON,491,0230,4910230,9431,6085,3952,2133,232,357,1377,1694,4428,3023,1405,133,228,918,1119
201,HARRIS,201,0345,2010345,4562,9177,824,8353,780,2090,5555,7508,6613,691,5922,634,1603,3726,5247
209,HAYS,209,0325,2090325,5472,715,448,267,8,15,229,242,570,371,199,2,8,172,180
241,JASPER,241,0010,2410010,6013,2829,2491,338,10,89,134,220,2169,1949,220,2,48,86,131
303,LUBBOCK,303,0040,3030040,6554,2043,128,1915,16,1046,873,1876,1552,118,1434,11,784,641,1412
311,MCMULLEN,311,0001,3110001,6726,155,69,86,5,6,82,83,126,60,66,3,3,62,63
361,ORANGE,361,0012,3610012,7267,2216,1452,764,35,388,303,686,1709,1261,448,16,204,196,400
85,COLLIN,85,0228,850228,1857,9245,3808,5437,554,1782,2958,4650,6148,2720,3428,362,1117,1846,2910
113,DALLAS,113,4114,1134114,2767,3819,185,3634,7,50,3563,3600,2785,167,2618,6,42,2557,2590
139,ELLIS,139,1054,1391054,3308,4056,947,3109,40,2161,882,3008,2781,725,2056,27,1434,569,1993
141,EL PASO,141,0167,1410167,3480,8042,186,7856,30,80,7780,7818,5857,135,5722,18,50,5675,5703
167,GALVESTON,167,0166,1670166,3849,3972,2854,1118,169,182,685,841,3187,2393,794,116,126,468,585
181,GRAYSON,181,0406,1810406,4021,3782,3331,451,18,31,203,229,3180,2864,316,16,15,132,146
5,ANGELINA,5,0015,50015,42,1606,913,693,9,130,538,655,1287,762,525,6,102,397,496
29,BEXAR,29,3183,293183,789,65,18,47,5,17,25,36,44,15,29,5,10,11,20
29,BEXAR,29,4227,294227,1038,0,0,0,0,0,0,0,0,0,0,0,0,0,0
29,BEXAR,29,1041,291041,291,4128,170,3958,37,79,3868,3910,3108,145,2963,27,55,2894,2924
29,BEXAR,29,2127,292127,540,3883,1118,2765,164,299,2286,2540,2995,960,2035,137,203,1655,1846
113,DALLAS,113,4052,1134052,2710,8452,1069,7383,448,2814,4113,6857,6034,903,5131,353,2016,2728,4716
451,TOM GREEN,451,0420,4510420,8698,953,559,394,52,24,308,327,654,408,246,35,14,183,195
453,TRAVIS,453,0411,4530411,8947,3344,2621,723,151,82,420,498,3048,2409,639,137,73,362,434
475,WARD,475,0002,4750002,9196,3002,1394,1608,33,175,1398,1526,2204,1091,1113,27,111,960,1051
201,HARRIS,201,0651,2010651,4868,5949,1761,4188,590,855,2702,3507,4490,1460,3030,442,617,1925,2506
325,MEDINA,325,001C,325001C,6789,6653,3174,3479,142,334,2925,3201,4986,2571,2415,93,221,1993,2192
347,NACOGDOCHES,347,0021,3470021,7038,3536,1861,1675,13,353,1243,1580,2604,1526,1078,8,221,783,1000
361,ORANGE,361,0032,3610032,7287,2546,2278,268,31,19,144,160,1978,1789,189,16,10,101,111
393,ROBERTS,393,0002,3930002,7536,182,162,20,2,3,10,12,142,128,14,0,2,6,8
439,TARRANT,439,4113,4394113,8449,2506,1345,1161,45,365,673,1024,2398,1280,1118,44,348,649,987
121,DENTON,121,1035,1211035,2959,8079,3411,4668,399,1785,2319,4038,5661,2559,3102,277,1148,1540,2663
133,EASTLAND,133,0008,1330008,3208,4563,3600,963,39,177,577,746,3558,2891,667,29,147,367,514
187,GUADALUPE,187,0307,1870307,4121,6449,3104,3345,334,1142,1782,2836,4708,2354,2354,253,845,1163,1966
201,HARRIS,201,0153,2010153,4370,5556,289,5267,28,334,4945,5225,3973,238,3735,23,243,3489,3702
201,HARRIS,201,0402,2010402,4619,5296,181,5115,113,3221,1836,4987,3777,162,3615,80,2429,1112,3515
201,HARRIS,201,0899,2010899,5117,2222,1062,1160,692,140,282,415,1566,760,806,484,98,189,283
29,BEXAR,29,4084,294084,895,1411,204,1207,17,348,884,1188,1040,158,882,14,261,632,864
29,BEXAR,29,1146,291146,397,402,79,323,14,18,286,299,313,64,249,10,7,226,232
113,DALLAS,113,1147,1131147,2106,977,803,174,21,33,94,122,706,594,112,17,17,56,72
113,DALLAS,113,3600,1133600,2604,3957,533,3424,60,2399,970,3345,3368,496,2872,47,2144,686,2816
121,DENTON,121,4177,1214177,3102,1754,896,858,131,258,404,658,1507,810,697,112,215,315,526
151,FISHER,151,0004,1510004,3600,918,707,211,4,11,190,197,712,554,158,1,5,141,144
375,POTTER,375,0321,3750321,7430,3512,2903,609,19,44,372,413,2623,2242,381,12,27,224,249
439,TARRANT,439,4565,4394565,8555,96,32,64,0,0,60,60,75,26,49,0,0,45,45
439,TARRANT,439,1255,4391255,7928,5268,1341,3927,367,1873,1683,3489,3908,1161,2747,274,1317,1125,2417
439,TARRANT,439,1722,4391722,8057,626,246,380,35,177,160,336,463,193,270,17,127,114,241
459,UPSHUR,459,0011,4590011,9053,897,728,169,6,35,81,113,676,581,95,1,16,42,57
493,WILSON,493,0104,4930104,9551,1820,996,824,21,35,739,768,1420,818,602,19,30,531,555
157,FORT BEND,157,3119,1573119,3729,3982,1996,1986,1521,124,293,410,3146,1637,1509,1183,84,215,292
201,HARRIS,201,1005,2011005,5223,0,0,0,0,0,0,0,0,0,0,0,0,0,0
201,HARRIS,201,0011,2010011,4227,3492,295,3197,62,194,2962,3133,2784,275,2509,49,173,2294,2450
201,HARRIS,201,0508,2010508,4725,11162,557,10605,3070,1652,5896,7438,8627,492,8135,2648,1202,4271,5416
289,LEON,289,0010,2890010,6434,1689,1024,665,11,79,563,633,1224,821,403,7,59,323,377
339,MONTGOMERY,339,0037,3390037,6932,5977,3156,2821,287,444,1935,2345,4395,2523,1872,197,300,1223,1508
1,ANDERSON,1,0005,10005,5,405,335,70,1,14,37,51,325,274,51,1,11,24,35
29,BEXAR,29,1004,291004,254,1689,103,1586,4,43,1550,1580,1253,83,1170,0,33,1141,1164
37,BOWIE,37,002A,37002A,1087,1910,417,1493,2,1364,96,1452,1401,349,1052,2,969,54,1019
49,BROWN,49,0417,490417,1336,2972,2379,593,13,68,400,461,2502,2061,441,13,51,279,327
85,COLLIN,85,0036,850036,1665,2253,1671,582,279,126,123,246,1795,1366,429,206,99,86,182
91,COMAL,91,0208A,910208A,1914,4053,3133,920,65,64,679,737,3341,2656,685,48,42,501,540
237,JACK,237,0005,2370005,5993,782,699,83,7,3,59,60,619,562,57,3,1,36,37
257,KAUFMAN,257,0021,2570021,6242,4850,2874,1976,17,151,1686,1822,3570,2331,1239,14,107,1010,1110
349,NAVARRO,349,0400,3490400,7075,2494,1631,863,32,308,483,767,1863,1313,550,25,214,282,482
365,PANOLA,365,0009,3650009,7324,887,691,196,4,126,32,158,689,560,129,4,77,20,97
449,TITUS,449,0010,4490010,8661,1426,1045,381,8,28,305,326,1077,827,250,5,12,200,210
453,TRAVIS,453,0367,4530367,8910,3503,2754,749,217,70,393,451,2521,2037,484,126,53,251,297
113,DALLAS,113,4091,1134091,2747,23,4,19,3,6,15,17,14,4,10,2,3,7,8
121,DENTON,121,2072,1212072,2996,5753,3456,2297,290,568,1229,1768,4300,2731,1569,212,376,819,1178
201,HARRIS,201,0116,2010116,4333,4229,3231,998,447,54,428,475,3027,2352,675,303,35,271,301
201,HARRIS,201,0365,2010365,4582,1445,225,1220,24,930,267,1181,1204,201,1003,21,805,165,966
205,HARTLEY,205,0401,2050401,5415,1153,665,488,12,16,432,445,909,540,369,12,9,324,331
215,HIDALGO,215,0112,2150112,5664,2662,74,2588,28,32,2542,2545,1884,53,1831,18,12,1796,1798
29,BEXAR,29,3128,293128,732,86,56,30,5,6,19,24,68,48,20,3,4,12,16
29,BEXAR,29,3042,293042,646,3735,1702,2033,479,215,1366,1541,2590,1258,1332,303,134,888,1008
41,BRAZOS,41,0082,410082,1273,464,416,48,3,0,36,36,354,314,40,3,0,29,29
85,COLLIN,85,0099,850099,1728,497,274,223,22,107,96,193,385,238,147,11,74,59,128
113,DALLAS,113,2081,1132081,2269,1362,55,1307,7,311,988,1295,1043,47,996,5,265,722,986
113,DALLAS,113,2305,1132305,2355,3625,1418,2207,603,922,674,1541,3196,1319,1877,515,781,560,1304
303,LUBBOCK,303,0123,3030123,6597,2704,1807,897,53,194,596,773,2136,1495,641,34,130,427,549
309,MCLENNAN,309,0051,3090051,6683,7850,4790,3060,552,1025,1322,2276,6068,3902,2166,405,715,899,1582
413,SCHLEICHER,413,0003,4130003,7679,604,161,443,6,11,422,431,459,138,321,4,10,302,311
439,TARRANT,439,3326,4393326,8306,1822,1094,728,67,230,399,615,1492,967,525,56,162,276,432
479,WEBB,479,0460,4790460,9302,1303,38,1265,2,8,1258,1260,917,33,884,0,1,884,884
491,WILLIAMSON,491,0122,4910122,9388,682,415,267,37,60,159,216,555,378,177,19,40,102,142
141,EL PASO,141,0038,1410038,3351,4379,331,4048,47,124,3921,3993,3508,286,3222,37,93,3124,3180
177,GONZALES,177,0015,1770015,3978,462,291,171,1,3,163,166,371,247,124,0,2,117,119
201,HARRIS,201,0756,2010756,4974,3418,529,2889,112,1126,1649,2724,2507,455,2052,103,818,1118,1911
201,HARRIS,201,0842,2010842,5060,5686,926,4760,352,1469,2984,4359,4284,813,3471,291,1064,2128,3141
215,HIDALGO,215,0049,2150049,5601,5432,201,5231,110,45,5101,5114,4082,175,3907,87,22,3801,3813
245,JEFFERSON,245,0028,2450028,6056,1164,369,795,18,675,101,765,924,311,613,10,527,73,597
55,CALDWELL,55,0103,550103,1373,3277,1732,1545,53,157,1284,1407,2526,1451,1075,38,96,886,967
81,COKE,81,0003,810003,1622,858,624,234,4,13,181,190,728,552,176,3,10,133,140
83,COLEMAN,83,0004,830004,1628,1870,1565,305,12,42,215,251,1553,1342,211,10,20,149,166
85,COLLIN,85,0242,850242,1871,5080,2167,2913,1859,619,380,970,3895,1901,1994,1198,449,286,722
143,ERATH,143,0021,1430021,3543,2831,1560,1271,14,39,1138,1174,2130,1267,863,12,15,773,787
143,ERATH,143,0010,1430010,3537,3048,2139,909,30,164,678,834,2623,1925,698,20,143,507,645
231,HUNT,231,0110,2310110,5950,1724,933,791,26,41,656,694,1216,711,505,17,35,407,440
251,JOHNSON,251,0040,2510040,6199,5257,3689,1568,141,453,891,1292,3725,2724,1001,94,276,550,809
439,TARRANT,439,1066,4391066,7865,2444,511,1933,66,497,1369,1843,1776,452,1324,55,381,879,1244
439,TARRANT,439,2262,4392262,8114,1728,1083,645,71,136,395,520,1327,894,433,49,83,259,338
439,TARRANT,439,2274,4392274,8120,19,0,19,3,11,5,16,12,0,12,0,9,3,12
439,TARRANT,439,1079,4391079,7871,2558,117,2441,53,923,1474,2385,1793,100,1693,27,735,933,1663
157,FORT BEND,157,4162,1574162,3786,1264,420,844,10,42,795,826,919,350,569,7,28,536,558
159,FRANKLIN,159,0101,1590101,3792,1875,1456,419,24,129,227,346,1463,1181,282,12,76,155,226
183,GREGG,183,0008,1830008,4035,7193,4481,2712,231,1438,843,2245,5624,3789,1835,191,934,537,1457
215,HIDALGO,215,0149,2150149,5701,107,1,106,1,2,106,106,90,1,89,1,2,89,89
215,HIDALGO,215,0155,2150155,5707,1116,69,1047,11,4,1035,1036,820,56,764,4,3,760,761
231,HUNT,231,0318,2310318,5956,1097,858,239,12,17,179,191,830,683,147,10,11,96,105
29,BEXAR,29,4170,294170,981,866,223,643,24,116,519,609,652,192,460,19,74,366,430
61,CAMERON,61,0067,610067,1479,4678,1797,2881,129,51,2624,2673,3963,1640,2323,119,43,2097,2139
65,CARSON,65,0301,650301,1522,928,799,129,3,14,77,90,658,565,93,3,11,51,61
113,DALLAS,113,1006,1131006,2020,2163,1823,340,73,72,139,207,1561,1352,209,50,47,73,120
121,DENTON,121,4219,1214219,3145,4413,3395,1018,70,182,598,754,3248,2590,658,46,110,380,478
157,FORT BEND,157,2134,1572134,3686,7090,1065,6025,1546,2728,1791,4433,5511,913,4598,1242,2081,1278,3307
381,RANDALL,381,0302,3810302,7473,4012,2987,1025,73,110,735,833,3027,2276,751,63,80,516,588
439,TARRANT,439,1416,4391416,7971,228,117,111,4,17,91,105,181,102,79,2,13,65,75
439,TARRANT,439,4362,4394362,8512,17,7,10,3,0,7,7,11,5,6,0,0,6,6
439,TARRANT,439,1564,4391564,8014,0,0,0,0,0,0,0,0,0,0,0,0,0,0
157,FORT BEND,157,2007,1572007,3643,16010,4625,11385,2931,4294,4088,8234,11084,3415,7669,2147,2784,2583,5317
193,HAMILTON,193,0022,1930022,4184,1372,1205,167,14,13,106,116,1082,977,105,12,10,55,62
201,HARRIS,201,1091,2011091,5309,3629,759,2870,861,423,1630,2005,2745,654,2091,665,318,1114,1407
215,HIDALGO,215,0255,2150255,5807,498,85,413,0,1,412,412,345,85,260,0,1,259,259
221,HOOD,221,0314,2210314,5850,5496,4201,1295,47,49,1032,1077,4286,3403,883,31,40,669,705
277,LAMAR,277,001F,277001F,6348,1856,1630,226,3,23,91,113,1450,1298,152,2,17,49,66
27,BELL,27,0414,270414,248,9210,1757,7453,563,4634,2424,6609,6204,1375,4829,386,2925,1526,4257
37,BOWIE,37,0022,370022,1081,265,169,96,2,69,20,89,210,142,68,1,50,13,63
49,BROWN,49,0307,490307,1330,907,731,176,7,12,138,145,731,608,123,7,5,90,92
113,DALLAS,113,2611,1132611,2412,6088,753,5335,4098,621,562,1170,4428,676,3752,2782,487,439,921
113,DALLAS,113,1705,1131705,2163,4233,931,3302,820,657,1795,2424,3136,790,2346,626,471,1213,1665
135,ECTOR,135,0405,1350405,3245,2483,153,2330,10,133,2195,2306,1824,118,1706,5,94,1615,1699
449,TITUS,449,0004,4490004,8655,893,631,262,4,20,208,227,728,553,175,4,13,128,140
479,WEBB,479,0227,4790227,9245,1903,44,1859,6,14,1852,1855,1267,25,1242,6,8,1238,1240
491,WILLIAMSON,491,0379,4910379,9494,4247,3407,840,140,109,492,585,3392,2815,577,92,83,315,394
215,HIDALGO,215,0106,2150106,5658,4530,421,4109,389,109,3647,3714,3255,326,2929,280,70,2584,2635
257,KAUFMAN,257,0027,2570027,6248,5082,3153,1929,153,709,976,1657,3414,2221,1193,103,453,582,1022
297,LIVE OAK,297,0002,2970002,6491,1452,1094,358,10,26,294,314,1226,952,274,7,18,218,235
365,PANOLA,365,0019,3650019,7330,500,406,94,4,21,45,63,381,317,64,4,13,25,35
397,ROCKWALL,397,003BB,397003BB,7573,59,7,52,1,3,45,48,47,7,40,0,2,34,36
439,TARRANT,439,3759,4393759,8412,0,0,0,0,0,0,0,0,0,0,0,0,0,0
141,EL PASO,141,0181,1410181,3494,9744,1300,8444,344,969,7242,8004,6112,912,5200,222,559,4418,4895
187,GUADALUPE,187,0129,1870129,4084,4617,2658,1959,141,188,1504,1654,3306,2021,1285,92,108,986,1083
201,HARRIS,201,0110,2010110,4327,5211,1768,3443,501,1385,1490,2838,4035,1521,2514,387,987,1067,2040
201,HARRIS,201,0948,2010948,5166,973,582,391,60,84,247,320,755,474,281,43,59,171,225
201,HARRIS,201,0359,2010359,4576,14523,426,14097,564,5359,8349,13451,9869,356,9513,431,3734,5461,9049
203,HARRISON,203,0026,2030026,5409,3746,2869,877,51,396,300,680,2585,2075,510,30,211,159,364
21,BASTROP,21,1003,211003,148,3183,2162,1021,57,127,732,836,2444,1774,670,38,78,460,531
29,BEXAR,29,3085,293085,689,1853,937,916,51,131,727,832,1518,822,696,41,96,542,622
41,BRAZOS,41,0039,410039,1230,2834,1734,1100,324,262,444,684,2087,1355,732,222,171,277,439
85,COLLIN,85,0142,850142,1771,4917,2396,2521,1466,507,450,943,4187,2079,2108,1323,367,328,684
113,DALLAS,113,4613,1134613,2853,2491,237,2254,69,156,2014,2147,1743,204,1539,54,109,1354,1455
113,DALLAS,113,2126,1132126,2312,910,367,543,88,306,149,448,754,349,405,61,222,108,325
309,MCLENNAN,309,0008,3090008,6640,2649,944,1705,30,473,1230,1650,1966,781,1185,25,340,808,1133
355,NUECES,355,0066,3550066,7181,2759,631,2128,66,150,1886,2018,2169,542,1627,57,119,1424,1530
423,SMITH,423,0001,4230001,7722,1538,241,1297,7,341,934,1265,1031,203,828,6,225,581,805
439,TARRANT,439,3114,4393114,8263,4991,3102,1889,196,211,1351,1548,4134,2730,1404,155,154,965,1112
453,TRAVIS,453,0227,4530227,8804,5312,2165,3147,169,342,2621,2901,4072,1921,2151,145,255,1735,1952
485,WICHITA,485,0305,4850305,9345,843,143,700,14,557,131,670,629,109,520,9,431,74,496
141,EL PASO,141,0081,1410081,3394,736,7,729,4,1,725,725,567,6,561,4,0,559,559
169,GARZA,169,0002,1690002,3935,1040,664,376,10,50,327,361,787,537,250,4,25,218,240
201,HARRIS,201,0259,2010259,4476,3027,38,2989,8,1948,1050,2980,2392,31,2361,3,1671,700,2356
201,HARRIS,201,0799,2010799,5017,3032,263,2769,66,1209,1405,2574,2145,236,1909,57,878,916,1774
215,HIDALGO,215,0006,2150006,5558,5949,639,5310,49,44,5207,5227,4209,574,3635,31,23,3575,3589
245,JEFFERSON,245,0071,2450071,6099,417,258,159,27,24,102,122,291,189,102,16,7,75,79
29,BEXAR,29,4067,294067,878,4026,983,3043,160,1140,1842,2820,2803,810,1993,121,679,1199,1812
29,BEXAR,29,2133,292133,546,548,179,369,24,37,307,340,389,139,250,11,26,207,232
41,BRAZOS,41,0019,410019,1210,954,159,795,14,108,670,773,670,137,533,12,78,439,515
67,CASS,67,013T,67013T,1542,2505,1248,1257,21,1046,124,1167,1904,983,921,11,792,70,859
85,COLLIN,85,0245,850245,1874,5622,2199,3423,930,870,1521,2356,4293,1828,2465,680,627,1055,1668
113,DALLAS,113,30A6,11330A6,2538,0,0,0,0,0,0,0,0,0,0,0,0,0,0
489,WILLACY,489,0003,4890003,9368,1447,124,1323,4,32,1306,1317,1043,103,940,2,8,928,936
245,JEFFERSON,245,0091,2450091,6119,923,779,144,12,30,91,118,689,586,103,8,27,56,80
291,LIBERTY,291,0019,2910019,6451,6999,4008,2991,95,989,1766,2725,5315,3265,2050,69,721,1148,1854
323,MAVERICK,323,003C,323003C,6783,957,130,827,8,5,807,811,716,117,599,5,4,583,586
353,NOLAN,353,0009,3530009,7115,2269,1593,676,13,84,539,612,1744,1299,445,12,44,358,398
451,TOM GREEN,451,0435,4510435,8704,2562,1047,1515,50,99,1342,1411,1887,860,1027,24,65,904,954
457,TYLER,457,0011,4570011,9036,170,138,32,1,1,17,18,131,108,23,1,0,14,14
113,DALLAS,113,4630,1134630,2870,2653,1047,1606,292,396,885,1257,2128,921,1207,257,270,635,901
113,DALLAS,113,1748,1131748,2206,3918,1056,2862,967,732,1168,1868,3074,920,2154,770,538,829,1346
201,HARRIS,201,0574,2010574,4791,818,22,796,2,161,642,793,562,12,550,1,117,436,548
201,HARRIS,201,0905,2010905,5123,1934,233,1701,22,72,1612,1672,1468,221,1247,11,54,1186,1230
209,HAYS,209,0219,2090219,5455,905,264,641,21,54,569,612,678,227,451,18,41,392,427
215,HIDALGO,215,0235,2150235,5787,511,87,424,8,5,414,416,394,71,323,7,5,315,317
41,BRAZOS,41,0042,410042,1233,0,0,0,0,0,0,0,0,0,0,0,0,0,0
71,CHAMBERS,71,0014,710014,1565,1144,746,398,5,154,195,344,890,607,283,5,118,124,239
91,COMAL,91,0102,910102,1897,5432,3902,1530,93,84,1170,1244,4292,3191,1101,69,62,846,902
113,DALLAS,113,2021,1132021,2229,3911,3137,774,346,68,290,347,3059,2546,513,229,44,187,227
113,DALLAS,113,4661,1134661,2893,3551,231,3320,83,131,3103,3220,2456,197,2259,66,102,2092,2182
113,DALLAS,113,31A4,11331A4,2561,0,0,0,0,0,0,0,0,0,0,0,0,0,0
201,HARRIS,201,0551,2010551,4768,3791,2591,1200,483,147,492,631,2732,1935,797,326,110,303,408
209,HAYS,209,0113,2090113,5432,5355,1528,3827,116,493,3223,3635,4070,1293,2777,71,379,2302,2642
215,HIDALGO,215,0212,2150212,5764,5411,182,5229,20,64,5157,5194,3616,133,3483,19,35,3431,3454
245,JEFFERSON,245,0068,2450068,6096,3537,1806,1731,150,1150,377,1512,2720,1494,1226,113,818,252,1062
289,LEON,289,0004,2890004,6428,1183,914,269,14,75,148,220,956,751,205,10,63,98,160
135,ECTOR,135,0208,1350208,3225,6145,2611,3534,363,455,2640,3047,4661,2142,2519,277,305,1872,2152
143,ERATH,143,0047,1430047,3557,573,455,118,9,13,99,108,447,370,77,5,6,65,70
167,GALVESTON,167,0363,1670363,3889,5313,3384,1929,318,396,1070,1440,3793,2479,1314,225,269,715,967
187,GUADALUPE,187,0220,1870220,4104,177,54,123,2,25,96,121,149,52,97,2,24,71,95
201,HARRIS,201,0219,2010219,4436,4025,514,3511,445,2395,686,3035,3388,479,2909,405,1973,532,2472
201,HARRIS,201,0882,2010882,5100,6388,912,5476,1949,1827,1765,3498,4826,738,4088,1519,1305,1293,2533
21,BASTROP,21,4023,214023,168,2517,1450,1067,43,97,879,942,1892,1203,689,31,58,538,585
29,BEXAR,29,4021,294021,832,2037,432,1605,48,287,1309,1529,1545,384,1161,39,194,941,1095
29,BEXAR,29,2087,292087,500,2414,827,1587,100,164,1337,1457,1881,686,1195,70,115,986,1084
39,BRAZORIA,39,0051,390051,1164,4445,2881,1564,292,243,947,1173,3556,2401,1155,225,176,670,838
61,CAMERON,61,0084,610084,1496,3171,509,2662,61,58,2538,2584,2315,447,1868,43,31,1782,1811
251,JOHNSON,251,0007,2510007,6165,3714,2945,769,46,81,522,597,2912,2404,508,27,53,334,384
439,TARRANT,439,2403,4392403,8157,255,52,203,10,106,104,196,189,37,152,6,78,81,147
297,LIVE OAK,297,0008,2970008,6497,127,85,42,2,1,36,36,97,69,28,1,1,24,24
329,MIDLAND,329,0210,3290210,6829,2621,1334,1287,94,237,927,1132,1984,1080,904,62,177,632,788
355,NUECES,355,0046,3550046,7161,770,60,710,3,27,679,698,596,57,539,2,18,518,532
383,REAGAN,383,0004,3830004,7493,836,248,588,11,23,555,571,609,187,422,9,17,396,409
431,STERLING,431,0004,4310004,7825,352,238,114,8,9,97,104,249,169,80,2,3,71,74
439,TARRANT,439,4243,4394243,8489,3787,1717,2070,84,229,1672,1873,2954,1490,1464,71,158,1146,1292
27,BELL,27,0103,270103,191,8657,4159,4498,176,847,3343,4115,6444,3364,3080,117,563,2255,2799
29,BEXAR,29,4044,294044,855,2821,726,2095,85,456,1572,1971,2207,637,1570,71,360,1131,1466
29,BEXAR,29,2110,292110,523,1468,498,970,86,84,789,853,1211,458,753,72,56,606,654
39,BRAZORIA,39,0074,390074,1187,789,274,515,6,11,496,502,563,231,332,5,7,315,321
65,CARSON,65,0102,650102,1519,128,109,19,0,1,9,10,90,79,11,0,1,4,5
85,COLLIN,85,0222,850222,1851,6088,2339,3749,2532,616,499,1099,4297,1758,2539,1665,460,345,802
355,NUECES,355,0023,3550023,7138,3206,1925,1281,46,32,1156,1178,2440,1543,897,32,24,798,817
1,ANDERSON,1,0019,10019,17,3467,2054,1413,41,673,644,1293,2580,1628,952,30,465,402,858
29,BEXAR,29,4202,294202,1013,5,3,2,0,2,2,2,5,3,2,0,2,2,2
51,BURLESON,51,0305,510305,1345,730,559,171,4,56,85,139,609,488,121,3,39,56,93
121,DENTON,121,1010,1211010,2934,5271,4027,1244,64,248,712,940,4004,3167,837,38,152,471,611
121,DENTON,121,2093,1212093,3017,713,233,480,327,71,76,141,586,193,393,272,61,53,110
139,ELLIS,139,1012,1391012,3266,6812,2209,4603,69,816,3635,4412,4924,1773,3151,41,623,2396,3001
439,TARRANT,439,2174,4392174,8095,4546,2141,2405,322,1079,966,1996,3664,1897,1767,271,777,663,1422
439,TARRANT,439,3469,4393469,8344,1450,1193,257,62,74,101,171,1203,1018,185,45,58,71,126
439,TARRANT,439,4707,4394707,8590,3662,1369,2293,223,561,1482,1999,2402,991,1411,145,326,904,1209
451,TOM GREEN,451,0124,4510124,8676,3496,627,2869,28,441,2405,2803,2500,503,1997,16,361,1605,1941
453,TRAVIS,453,0381C,4530381C,8922,144,66,78,43,12,18,29,112,61,51,31,6,10,15
491,WILLIAMSON,491,0205,4910205,9423,358,292,66,16,4,41,44,284,242,42,14,3,19,22
201,HARRIS,201,0877,2010877,5095,5420,1035,4385,757,1641,2018,3585,3649,765,2884,540,1000,1320,2291
209,HAYS,209,0101,2090101,5427,0,0,0,0,0,0,0,0,0,0,0,0,0,0
287,LEE,287,0404,2870404,6423,1436,598,838,12,209,594,788,1075,504,571,11,158,375,532
361,ORANGE,361,0007,3610007,7262,2566,1810,756,91,356,249,592,1925,1406,519,61,245,166,406
401,RUSK,401,0113,4010113,7594,4942,3324,1618,43,599,802,1374,3695,2625,1070,30,418,467,879
439,TARRANT,439,4051,4394051,8427,23,5,18,1,2,13,15,12,5,7,0,2,2,4
181,GRAYSON,181,0308,1810308,4013,1968,1416,552,14,34,398,423,1467,1112,355,6,19,245,264
187,GUADALUPE,187,0215,1870215,4099,1468,901,567,55,105,373,473,1006,630,376,34,81,242,322
201,HARRIS,201,0045B,2010045B,4262,0,0,0,0,0,0,0,0,0,0,0,0,0,0
201,HARRIS,201,0377,2010377,4594,970,703,267,25,43,170,207,736,550,186,15,26,115,138
201,HARRIS,201,0128,2010128,4345,3148,2033,1115,715,79,259,331,2315,1561,754,484,52,182,232
201,HARRIS,201,1123,2011123,5341,2690,781,1909,393,566,963,1489,2017,648,1369,280,396,687,1054
29,BEXAR,29,1076,291076,326,5222,815,4407,158,431,3813,4187,3835,690,3145,127,331,2680,2981
113,DALLAS,113,2146,1132146,2330,4988,1792,3196,360,848,1950,2762,4223,1713,2510,319,613,1525,2116
141,EL PASO,141,0013,1410013,3326,4835,925,3910,274,154,3488,3607,3629,726,2903,199,100,2595,2678
141,EL PASO,141,0099,1410099,3412,3046,236,2810,40,91,2689,2757,2184,202,1982,23,48,1895,1936
157,FORT BEND,157,2052,1572052,3658,4133,130,4003,40,2814,1200,3941,3084,110,2974,30,2184,786,2929
157,FORT BEND,157,1054,1571054,3621,1078,220,858,38,84,735,803,759,181,578,22,57,498,542
457,TYLER,457,0006,4570006,9031,466,444,22,1,3,11,13,400,380,20,1,2,11,12
461,UPTON,461,0006,4610006,9068,550,160,390,5,21,361,377,404,141,263,4,18,240,255
479,WEBB,479,0356,4790356,9277,7857,396,7461,102,63,7325,7365,5427,291,5136,72,39,5027,5056
487,WILBARGER,487,0019,4870019,9363,2981,1484,1497,140,455,873,1306,2341,1306,1035,92,324,590,912
501,YOAKUM,501,0202,5010202,9609,1958,655,1303,25,37,1230,1263,1350,521,829,8,14,788,802
215,HIDALGO,215,0184,2150184,5736,92,30,62,0,1,59,60,66,25,41,0,1,38,39
373,POLK,373,0012,3730012,7408,654,100,554,9,9,41,46,469,80,389,4,2,22,24
423,SMITH,423,0019,4230019,7740,6010,4708,1302,115,476,554,1016,4377,3508,869,79,330,335,663
439,TARRANT,439,1337,4391337,7949,3264,2515,749,77,144,415,546,2605,2089,516,58,101,274,370
439,TARRANT,439,3194,4393194,8281,4272,2296,1976,201,245,1425,1650,3146,1804,1342,166,149,945,1081
453,TRAVIS,453,0136,4530136,8736,2661,1140,1521,76,449,973,1395,2107,995,1112,66,333,682,1002
173,GLASSCOCK,173,0001,1730001,3953,285,197,88,0,3,85,87,221,164,57,0,1,55,56
201,HARRIS,201,0191,2010191,4408,7021,560,6461,11,402,6042,6405,4664,449,4215,9,238,3941,4164
201,HARRIS,201,1063,2011063,5281,5130,385,4745,860,589,3337,3870,3615,334,3281,664,406,2219,2600
201,HARRIS,201,0437,2010437,4654,4267,2413,1854,446,544,833,1332,3194,1847,1347,333,412,578,966
201,HARRIS,201,0731,2010731,4949,7734,1439,6295,406,1553,4371,5777,5680,1184,4496,307,1068,3121,4100
201,HARRIS,201,0523,2010523,4740,7786,2433,5353,353,1089,3875,4872,5737,2054,3683,283,696,2647,3295
27,BELL,27,0303,270303,223,8257,3888,4369,119,1715,2494,4052,6211,3256,2955,84,1124,1643,2720
29,BEXAR,29,2060,292060,472,2746,382,2364,43,181,2160,2306,2191,344,1847,35,136,1683,1799
29,BEXAR,29,3204,293204,810,4,4,0,0,0,0,0,4,4,0,0,0,0,0
35,BOSQUE,35,0006,350006,1059,1690,1458,232,10,32,102,130,1474,1301,173,6,20,74,90
113,DALLAS,113,4068,1134068,2725,3841,418,3423,35,89,3293,3360,2902,380,2522,24,77,2412,2473
113,DALLAS,113,1316,1131316,2138,2551,497,2054,48,1183,811,1970,1952,434,1518,36,879,575,1445
443,TERRELL,443,0002B,4430002B,8636,27,22,5,2,1,1,1,26,22,4,2,0,0,0
477,WASHINGTON,477,0320,4770320,9217,2689,2158,531,33,72,351,418,2171,1794,377,25,58,230,286
309,MCLENNAN,309,0081,3090081,6715,6095,4996,1099,48,100,714,801,4575,3864,711,19,66,446,502
339,MONTGOMERY,339,0065,3390065,6964,8296,5541,2755,77,133,2279,2387,6349,4457,1892,49,102,1523,1612
349,NAVARRO,349,0103,3490103,7053,2831,1785,1046,46,393,563,941,2132,1437,695,36,269,352,617
363,PALO PINTO,363,0014,3630014,7302,279,214,65,5,3,52,55,214,174,40,3,3,32,35
439,TARRANT,439,3624,4393624,8381,568,243,325,281,22,23,40,380,194,186,158,16,13,26
441,TAYLOR,441,0406,4410406,8630,5732,3732,2000,89,869,993,1806,4607,3212,1395,69,597,671,1239
113,DALLAS,113,2507,1132507,2387,3011,2129,882,155,211,459,644,2331,1734,597,112,135,311,432
141,EL PASO,141,0159,1410159,3472,5107,60,5047,35,33,4995,5017,3536,40,3496,21,20,3467,3480
185,GRIMES,185,0005,1850005,4053,4610,2244,2366,27,1024,1303,2305,4165,2093,2072,24,944,1086,2019
201,HARRIS,201,0583,2010583,4800,2298,50,2248,12,1279,987,2240,1701,42,1659,7,1038,625,1654
203,HARRISON,203,0004,2030004,5387,2603,955,1648,22,703,901,1581,1881,785,1096,16,482,578,1051
215,HIDALGO,215,0084,2150084,5636,5133,263,4870,139,34,4694,4716,3505,183,3322,94,21,3201,3213
29,BEXAR,29,1122A,291122A,372,4489,1335,3154,342,619,2278,2815,3172,999,2173,221,420,1556,1944
39,BRAZORIA,39,0046,390046,1159,7502,3869,3633,467,1071,1979,2969,5718,3186,2532,340,733,1327,2031
61,CAMERON,61,0085,610085,1497,4199,803,3396,18,52,3323,3357,3142,694,2448,10,35,2383,2414
85,COLLIN,85,0071,850071,1700,2320,1565,755,298,151,240,384,1941,1346,595,249,117,182,292
113,DALLAS,113,1057,1131057,2038,4145,956,3189,58,237,2860,3061,3144,869,2275,40,182,2005,2167
113,DALLAS,113,4532,1134532,2825,659,125,534,23,29,477,500,491,110,381,18,20,334,351
485,WICHITA,485,0103,4850103,9323,8215,5423,2792,566,745,1278,1961,5986,4197,1789,415,440,748,1168
277,LAMAR,277,1A3B,2771A3B,6366,6444,4527,1917,100,1012,560,1545,5006,3757,1249,74,662,338,989
409,SAN PATRICIO,409,0107,4090107,7651,359,156,203,0,8,193,199,293,135,158,0,6,150,156
417,SHACKELFORD,417,0202,4170202,7694,774,664,110,6,1,82,82,574,501,73,4,0,52,52
439,TARRANT,439,4475,4394475,8530,79,50,29,4,6,21,25,57,42,15,4,1,10,11
439,TARRANT,439,1459,4391459,7989,3571,647,2924,219,1330,1406,2686,2532,554,1978,166,919,908,1800
483,WHEELER,483,0101,4830101,9317,1233,828,405,9,10,378,385,936,693,243,1,5,226,229
141,EL PASO,141,0053,1410053,3366,5225,751,4474,115,500,3947,4327,3995,662,3333,99,346,2906,3201
189,HALE,189,0316,1890316,4159,1909,708,1201,3,41,1125,1165,1455,588,867,1,34,805,838
201,HARRIS,201,0483,2010483,4700,9387,3873,5514,1100,1917,2451,4266,7156,3127,4029,891,1314,1766,3023
209,HAYS,209,0351,2090351,5487,3850,1693,2157,171,551,1459,1959,3313,1578,1735,142,489,1107,1562
243,JEFF DAVIS,243,0005,2430005,6028,241,200,41,4,2,26,27,227,194,33,3,2,19,20
273,KLEBERG,273,0011,2730011,6323,1129,228,901,12,49,857,888,801,174,627,10,29,590,617
29,BEXAR,29,1019,291019,269,2775,224,2551,33,143,2404,2502,1646,189,1457,25,67,1366,1424
29,BEXAR,29,2105,292105,518,1166,50,1116,6,40,1086,1105,852,33,819,5,22,797,811
29,BEXAR,29,3158,293158,764,151,40,111,25,23,61,80,101,30,71,10,12,46,55
53,BURNET,53,0002,530002,1351,5550,3739,1811,96,193,1363,1527,4405,3089,1316,66,160,967,1109
75,CHILDRESS,75,0301,750301,1597,1439,860,579,20,155,398,539,1124,708,416,14,115,282,384
85,COLLIN,85,0217,850217,1846,4121,2510,1611,386,513,630,1124,2827,1755,1072,278,327,411,724
439,TARRANT,439,2158,4392158,8089,3765,1753,2012,275,926,727,1633,3096,1552,1544,210,695,548,1237
439,TARRANT,439,3422,4393422,8338,3754,2360,1394,690,213,384,591,2474,1628,846,429,133,215,348
471,WALKER,471,0401,4710401,9171,8392,3823,4569,209,2239,1941,4134,7238,3436,3802,176,1828,1637,3437
251,JOHNSON,251,0015,2510015,6174,2137,1605,532,9,29,400,415,1709,1345,364,7,18,256,266
321,MATAGORDA,321,0010,3210010,6761,501,378,123,4,13,99,112,401,313,88,3,10,67,77
339,MONTGOMERY,339,0107,3390107,7007,57,36,21,9,2,5,6,48,30,18,9,2,4,5
339,MONTGOMERY,339,0110,3390110,7010,3235,2018,1217,244,259,641,883,2384,1541,843,179,177,418,587
361,ORANGE,361,0001,3610001,7256,739,496,243,5,151,76,226,552,396,156,5,86,54,139
439,TARRANT,439,1004,4391004,7843,4000,1571,2429,173,1174,1050,2199,3122,1406,1716,115,818,739,1545
113,DALLAS,113,4017,1134017,2679,584,359,225,18,79,126,199,531,353,178,16,62,98,155
113,DALLAS,113,2910,1132910,2433,321,87,234,9,4,214,218,228,70,158,7,4,142,146
157,FORT BEND,157,4037,1574037,3761,6371,1395,4976,42,616,4268,4820,4753,1229,3524,25,426,3022,3419
201,HARRIS,201,0629,2010629,4846,1360,77,1283,21,662,615,1257,897,56,841,13,446,388,826
215,HIDALGO,215,0127,2150127,5679,1952,37,1915,8,4,1897,1898,1378,28,1350,5,4,1339,1340
227,HOWARD,227,0405,2270405,5928,639,416,223,7,25,192,206,490,357,133,4,8,117,125
15,AUSTIN,15,0208,150208,123,818,652,166,0,34,109,142,679,562,117,0,27,70,97
29,BEXAR,29,3060,293060,664,2604,1103,1501,106,157,1235,1357,2124,993,1131,76,113,926,1021
29,BEXAR,29,4099,294099,910,2395,560,1835,45,149,1637,1759,1851,499,1352,43,110,1182,1280
41,BRAZOS,41,0014,410014,1205,9374,1040,8334,55,1537,6741,8160,6205,840,5365,48,1009,4269,5234
61,CAMERON,61,0039,610039,1451,2824,132,2692,10,20,2672,2682,1953,95,1858,3,13,1845,1852
85,COLLIN,85,0117,850117,1746,7053,3471,3582,1307,1002,1112,2088,5284,2806,2478,922,657,772,1413
439,TARRANT,439,1296,4391296,7943,4050,2510,1540,226,732,549,1252,3411,2216,1195,192,540,417,944
439,TARRANT,439,4232,4394232,8484,7904,2770,5134,1330,1233,2576,3688,5468,2086,3382,1005,732,1602,2277
455,TRINITY,455,0021,4550021,9025,652,504,148,5,21,94,114,519,439,80,3,7,43,50
271,KINNEY,271,0002,2710002,6320,645,181,464,12,19,440,451,465,146,319,7,7,303,310
303,LUBBOCK,303,0178,3030178,6615,380,295,85,1,17,63,77,277,221,56,1,9,43,50
331,MILAM,331,0210,3310210,6861,764,558,206,6,83,115,192,628,467,161,4,68,83,149
355,NUECES,355,0041,3550041,7156,864,33,831,1,16,804,814,643,24,619,1,12,601,611
373,POLK,373,0006,3730006,7402,5783,4905,878,63,174,374,537,4678,4041,637,41,104,264,361
417,SHACKELFORD,417,0404,4170404,7697,72,60,12,0,2,9,10,53,44,9,0,0,7,7
101,COTTLE,101,0401,1010401,1992,349,220,129,2,20,100,116,290,191,99,2,19,76,91
113,DALLAS,113,3096,1133096,2533,3725,1919,1806,270,865,636,1450,3449,1859,1590,245,750,548,1263
121,DENTON,121,3150,1213150,3074,3680,2579,1101,272,213,487,690,2716,2011,705,176,115,322,432
201,HARRIS,201,0774,2010774,4992,1705,272,1433,99,863,507,1315,1255,251,1004,82,574,361,904
213,HENDERSON,213,003C,213003C,5533,2782,2212,570,34,301,185,469,2263,1810,453,27,248,129,367
245,JEFFERSON,245,0046,2450046,6074,2917,324,2593,147,629,1823,2429,2139,293,1846,112,461,1266,1718
5,ANGELINA,5,0033,50033,60,1831,1643,188,8,36,82,116,1391,1269,122,8,24,40,64
27,BELL,27,0306,270306,226,7788,2752,5036,111,2006,2858,4746,6036,2417,3619,92,1426,1993,3377
29,BEXAR,29,3120,293120,724,5039,2160,2879,221,310,2326,2569,3906,1810,2096,162,192,1676,1838
29,BEXAR,29,2145,292145,558,503,135,368,41,31,301,323,389,115,274,31,18,221,236
35,BOSQUE,35,0003,350003,1056,1728,1201,527,30,106,375,459,1337,971,366,22,73,254,319
41,BRAZOS,41,0031,410031,1222,6241,3443,2798,482,951,1236,2128,4788,2828,1960,369,603,864,1438
453,TRAVIS,453,0340,4530340,8882,4692,3254,1438,434,150,745,875,3532,2513,1019,319,95,526,611
477,WASHINGTON,477,0307,4770307,9214,2876,1538,1338,149,589,595,1158,2199,1291,908,115,382,395,768
489,WILLACY,489,007A,489007A,9380,1537,108,1429,4,21,1412,1428,1089,96,993,3,17,978,992
201,HARRIS,201,0420,2010420,4637,7589,4823,2766,159,176,2249,2388,5641,3805,1836,108,117,1441,1542
201,HARRIS,201,1083,2011083,5301,0,0,0,0,0,0,0,0,0,0,0,0,0,0
215,HIDALGO,215,0247,2150247,5799,346,13,333,1,0,332,332,253,12,241,0,0,240,240
421,SHERMAN,421,0302,4210302,7720,370,246,124,4,7,113,117,282,199,83,1,5,77,80
439,TARRANT,439,2645,4392645,8218,3121,1900,1221,238,524,394,895,2178,1403,775,158,328,241,561
453,TRAVIS,453,0112,4530112,8716,2840,1003,1837,116,771,922,1657,2322,855,1467,99,652,672,1305
85,COLLIN,85,0091,850091,1720,3818,2195,1623,503,440,599,996,2963,1798,1165,380,292,434,699
157,FORT BEND,157,1165,1571165,3641,3851,2428,1423,283,480,603,1061,2734,1796,938,194,304,390,682
189,HALE,189,0102,1890102,4139,295,59,236,5,21,207,224,204,52,152,4,12,128,140
201,HARRIS,201,0917,2010917,5135,0,0,0,0,0,0,0,0,0,0,0,0,0,0
201,HARRIS,201,0586,2010586,4803,6267,1878,4389,172,1500,2653,4091,4547,1588,2959,128,995,1758,2727
201,HARRIS,201,0088,2010088,4305,3719,2276,1443,60,319,952,1243,2892,1876,1016,39,217,653,858
9,ARCHER,9,0009,90009,83,191,181,10,0,0,6,6,174,167,7,0,0,3,3
29,BEXAR,29,2003,292003,415,4510,164,4346,14,70,4265,4311,3408,119,3289,9,47,3236,3271
29,BEXAR,29,2168,292168,581,2783,940,1843,134,264,1453,1683,2211,821,1390,112,191,1081,1254
37,BOWIE,37,0020,370020,1079,407,285,122,9,84,22,106,324,224,100,9,69,15,84
73,CHEROKEE,73,0025,730025,1577,1827,1450,377,16,199,122,317,1329,1059,270,9,153,76,227
113,DALLAS,113,4152,1134152,2788,11,0,11,4,1,7,7,2,0,2,0,1,2,2
453,TRAVIS,453,0140,4530140,8739,856,178,678,53,153,482,618,604,151,453,43,100,313,406
463,UVALDE,463,0003,4630003,9071,550,460,90,2,3,73,75,463,398,65,0,1,52,53
479,WEBB,479,0176A,4790176A,9237,3780,100,3680,3,18,3656,3660,2228,57,2171,3,11,2158,2161
157,FORT BEND,157,4150,1574150,3784,13209,2368,10841,3235,4833,2909,7559,9358,1844,7514,2365,3183,1986,5083
201,HARRIS,201,0563,2010563,4780,5003,3333,1670,224,493,839,1296,4047,2806,1241,168,369,608,958
201,HARRIS,201,0065,2010065,4282,5238,205,5033,29,99,4926,5002,3957,172,3785,23,65,3706,3764
201,HARRIS,201,0728,2010728,4946,1988,763,1225,72,183,947,1111,1466,652,814,59,116,610,717
439,TARRANT,439,4632,4394632,8573,0,0,0,0,0,0,0,0,0,0,0,0,0,0
439,TARRANT,439,2744,4392744,8241,898,247,651,71,147,411,551,702,233,469,54,118,271,387
113,DALLAS,113,2035,1132035,2241,3499,2136,1363,437,345,510,833,3262,2046,1216,396,299,446,733
113,DALLAS,113,1102,1131102,2075,6127,372,5755,23,478,5248,5710,4109,331,3778,13,355,3400,3749
113,DALLAS,113,3210,1133210,2573,3768,963,2805,116,1159,1507,2629,2863,836,2027,91,835,1060,1877
113,DALLAS,113,3618,1133618,2622,801,42,759,19,578,154,716,606,38,568,16,443,99,531
121,DENTON,121,4195,1214195,3120,685,555,130,35,25,57,78,524,439,85,24,19,33,48
139,ELLIS,139,1032,1391032,3286,4774,3596,1178,50,207,759,948,3554,2735,819,35,158,501,648
61,CAMERON,61,0022,610022,1434,4450,186,4264,9,19,4237,4243,3221,149,3072,8,12,3060,3064
113,DALLAS,113,1137,1131137,2098,57,7,50,0,0,49,49,33,7,26,0,0,25,25
113,DALLAS,113,2079,1132079,2267,5562,1193,4369,518,1963,1814,3726,4472,1118,3354,449,1478,1350,2796
113,DALLAS,113,2903,1132903,2430,4257,2504,1753,466,575,629,1170,4040,2426,1614,434,507,575,1063
121,DENTON,121,1007,1211007,2931,1803,1377,426,24,33,280,313,1471,1174,297,9,29,186,215
121,DENTON,121,4169,1214169,3094,3961,2490,1471,335,322,741,1039,3497,2237,1260,304,262,607,859
355,NUECES,355,0058,3550058,7173,1512,778,734,41,25,639,660,1270,692,578,27,19,501,520
387,RED RIVER,387,02-4,38702-4,7508,540,475,65,1,36,19,52,458,414,44,1,23,15,35
437,SWISHER,437,0009,4370009,7840,40,38,2,1,0,1,1,32,31,1,1,0,0,0
439,TARRANT,439,4312,4394312,8504,237,85,152,0,12,132,144,190,74,116,0,10,100,110
465,VAL VERDE,465,0024,4650024,9094,3120,223,2897,19,19,2862,2872,2164,197,1967,11,9,1945,1951
139,ELLIS,139,1009,1391009,3263,5427,3192,2235,46,176,1865,2017,3939,2487,1452,32,106,1188,1287
167,GALVESTON,167,2301,1672301,3927,0,0,0,0,0,0,0,0,0,0,0,0,0,0
209,HAYS,209,0450B,2090450B,5513,674,531,143,16,7,89,94,506,422,84,8,2,51,52
251,JOHNSON,251,0018,2510018,6177,7429,4857,2572,83,377,1766,2111,5691,3974,1717,52,248,1142,1377
299,LLANO,299,0204,2990204,6509,1019,893,126,10,10,70,79,930,839,91,10,5,46,51
329,MIDLAND,329,0405,3290405,6844,4673,2533,2140,350,346,1361,1670,3505,2035,1470,213,236,957,1171
27,BELL,27,0116,270116,203,3016,668,2348,185,1385,800,2054,2166,563,1603,131,915,540,1382
29,BEXAR,29,4056,294056,867,5546,2040,3506,278,885,2339,3103,4368,1776,2592,195,641,1695,2266
41,BRAZOS,41,0057,410057,1248,919,154,765,23,312,423,726,637,137,500,19,206,268,469
85,COLLIN,85,0160,850160,1789,490,404,86,5,8,61,68,363,310,53,3,1,39,39
91,COMAL,91,0206,910206,1912,5097,3260,1837,137,204,1373,1540,3672,2441,1231,78,135,925,1042
113,DALLAS,113,3016,1133016,2453,2856,1077,1779,102,1023,610,1599,2490,1018,1472,86,832,500,1306
497,WISE,497,0007,4970007,9572,3897,2990,907,64,81,636,702,2981,2351,630,38,35,451,479
201,HARRIS,201,0277,2010277,4494,6433,688,5745,39,234,5485,5676,4468,590,3878,25,173,3673,3824
249,JIM WELLS,249,0017,2490017,6154,2059,242,1817,1,11,1795,1800,1572,207,1365,1,8,1350,1355
331,MILAM,331,0420,3310420,6867,3026,2260,766,20,93,548,634,2365,1829,536,16,75,356,431
355,NUECES,355,0084,3550084,7199,1281,299,982,19,45,909,951,1000,272,728,15,31,673,701
439,TARRANT,439,1062,4391062,7863,24,18,6,1,0,5,5,20,18,2,0,0,2,2
453,TRAVIS,453,0307,4530307,8859,4596,3338,1258,268,168,708,842,3737,2812,925,185,121,524,619
115,DAWSON,115,0005,1150005,2908,255,149,106,1,1,99,100,179,106,73,0,1,67,68
141,EL PASO,141,0136,1410136,3449,3626,108,3518,20,25,3479,3491,2695,93,2602,13,18,2577,2589
147,FANNIN,147,0003,1470003,3572,940,604,336,5,222,51,270,749,498,251,3,163,40,202
187,GUADALUPE,187,0229,1870229,4113,209,84,125,0,13,112,124,191,84,107,0,11,96,106
189,HALE,189,0406,1890406,4162,1872,259,1613,14,165,1439,1573,1228,194,1034,5,114,902,1004
201,HARRIS,201,0940,2010940,5158,50,0,50,0,15,33,48,39,0,39,0,15,23,38
29,BEXAR,29,4082,294082,893,4418,330,4088,116,2031,2105,3968,2908,260,2648,91,1298,1309,2555
55,CALDWELL,55,0402,550402,1391,2368,505,1863,36,184,1635,1801,1758,430,1328,26,143,1142,1281
71,CHAMBERS,71,0006,710006,1557,2620,1486,1134,41,396,648,1036,1975,1200,775,26,288,417,702
113,DALLAS,113,1082,1131082,2055,1039,79,960,4,29,923,951,732,71,661,1,25,629,654
139,ELLIS,139,1052,1391052,3306,3718,1255,2463,30,1468,911,2346,2734,1004,1730,15,1041,607,1641
161,FREESTONE,161,0004B,1610004B,3804,57,38,19,1,6,11,17,34,27,7,0,3,3,6
369,PARMER,369,0303,3690303,7385,113,52,61,0,0,60,60,85,43,42,0,0,41,41
439,TARRANT,439,1098,4391098,7883,4597,121,4476,14,1188,3300,4444,3109,106,3003,6,915,2083,2981
439,TARRANT,439,1701,4391701,8049,2077,970,1107,335,334,379,695,1502,713,789,255,239,243,472
439,TARRANT,439,4528,4394528,8547,6015,3202,2813,761,556,1335,1854,4440,2512,1928,576,371,850,1198
493,WILSON,493,0102,4930102,9549,3277,759,2518,41,68,2372,2431,2379,593,1786,28,47,1687,1728
177,GONZALES,177,0007,1770007,3970,736,449,287,2,57,216,266,560,377,183,2,40,129,166
201,HARRIS,201,0251,2010251,4468,5216,517,4699,36,2395,2248,4606,3635,376,3259,25,1867,1349,3194
209,HAYS,209,0319,2090319,5470,2459,1373,1086,51,93,929,1004,1737,1013,724,30,53,623,672
231,HUNT,231,0430,2310430,5968,1317,750,567,15,107,390,492,940,592,348,13,70,231,296
247,JIM HOGG,247,0002,2470002,6134,1167,124,1043,6,1,997,997,869,103,766,6,1,734,734
307,MCCULLOCH,307,0403,3070403,6632,158,147,11,0,2,2,3,150,141,9,0,1,1,1
5,ANGELINA,5,0008,50008,34,1703,1429,274,29,72,139,200,1257,1103,154,19,35,68,99
5,ANGELINA,5,0013,50013,40,1258,514,744,25,348,358,686,885,407,478,7,217,228,443
67,CASS,67,0012,670012,1534,1310,940,370,10,275,34,309,1052,761,291,4,221,24,245
113,DALLAS,113,1050,1131050,2032,250,189,61,18,10,33,43,162,136,26,5,3,17,20
121,DENTON,121,9304,1219304,3163,0,0,0,0,0,0,0,0,0,0,0,0,0,0
141,EL PASO,141,0016,1410016,3329,5256,675,4581,111,122,4361,4443,4137,591,3546,90,78,3381,3435
451,TOM GREEN,451,0401,4510401,8696,293,131,162,8,52,109,145,218,119,99,6,21,65,85
245,JEFFERSON,245,0006,2450006,6034,2518,516,2002,41,1224,749,1947,1892,462,1430,26,876,514,1383
303,LUBBOCK,303,0017,3030017,6532,6548,2155,4393,73,730,3533,4148,4975,1895,3080,58,485,2451,2887
381,RANDALL,381,0420,3810420,7485,5155,3718,1437,62,210,1022,1193,3860,2977,883,40,115,610,712
439,TARRANT,439,1623,4391623,8032,0,0,0,0,0,0,0,0,0,0,0,0,0,0
439,TARRANT,439,1610,4391610,8026,74,34,40,4,10,26,36,47,23,24,4,10,10,20
439,TARRANT,439,2553,4392553,8198,2809,723,2086,185,724,1155,1840,2089,610,1479,161,502,783,1268
163,FRIO,163,0006,1630006,3827,860,376,484,2,31,443,469,670,328,342,1,23,315,333
201,HARRIS,201,1109,2011109,5327,89,64,25,5,14,10,23,89,64,25,5,14,10,23
201,HARRIS,201,1103,2011103,5321,3278,979,2299,277,510,1489,1946,2499,821,1678,216,362,1053,1400
209,HAYS,209,0423B,2090423B,5493,0,0,0,0,0,0,0,0,0,0,0,0,0,0
223,HOPKINS,223,001A,223001A,5868,1987,1344,643,14,193,368,557,1467,1032,435,7,133,240,372
237,JACK,237,0003,2370003,5991,296,198,98,4,13,79,87,204,149,55,4,5,43,47
25,BEE,25,0010,250010,183,2838,437,2401,32,110,2241,2328,1987,338,1649,29,64,1543,1602
29,BEXAR,29,2181G,292181G,601,36,9,27,1,7,27,27,25,9,16,1,4,16,16
41,BRAZOS,41,0074,410074,1265,5221,2237,2984,908,770,1556,2056,5172,2223,2949,898,766,1536,2033
91,COMAL,91,0407,910407,1932,3721,2959,762,66,38,579,606,2792,2267,525,38,27,390,412
113,DALLAS,113,4112,1134112,2765,1868,1257,611,117,114,312,419,1848,1255,593,113,113,300,406
113,DALLAS,113,3321,1133321,2596,0,0,0,0,0,0,0,0,0,0,0,0,0,0
309,MCLENNAN,309,0043,3090043,6675,1244,690,554,32,223,295,500,1008,621,387,28,135,208,337
367,PARKER,367,0120,3670120,7342,3555,2853,702,34,66,436,500,2600,2165,435,24,30,259,288
439,TARRANT,439,1518,4391518,8006,2127,503,1624,66,1220,350,1541,1760,472,1288,53,946,293,1216
439,TARRANT,439,2464,4392464,8175,569,347,222,66,62,86,147,450,291,159,48,46,55,101
453,TRAVIS,453,0271,4530271,8839,3374,2486,888,446,53,344,389,2401,1800,601,292,38,230,263
479,WEBB,479,0267,4790267,9257,5019,131,4888,24,62,4795,4852,3458,99,3359,18,60,3280,3337
141,EL PASO,141,0116,1410116,3429,7419,677,6742,191,486,6133,6522,5127,484,4643,121,309,4212,4482
187,GUADALUPE,187,0212,1870212,4096,253,79,174,4,26,140,164,208,77,131,2,21,100,121
201,HARRIS,201,0543,2010543,4760,3984,259,3725,25,87,3594,3661,3018,242,2776,18,56,2686,2731
201,HARRIS,201,0960,2010960,5178,3360,391,2969,223,1934,835,2728,2450,328,2122,151,1400,575,1951
221,HOOD,221,0107,2210107,5842,1257,1106,151,5,9,86,93,941,847,94,3,7,47,52
241,JASPER,241,0008,2410008,6011,1628,678,950,12,824,84,907,1188,550,638,5,561,48,609
21,BASTROP,21,2015,212015,160,4581,2941,1640,64,570,887,1434,3582,2457,1125,42,406,581,974
29,BEXAR,29,3097,293097,701,24,19,5,0,0,3,3,11,10,1,0,0,1,1
41,BRAZOS,41,0051,410051,1242,0,0,0,0,0,0,0,0,0,0,0,0,0,0
61,CAMERON,61,0002,610002,1414,905,318,587,13,5,569,573,737,303,434,13,4,416,420
95,CONCHO,95,0408,950408,1955,1387,786,601,14,73,521,585,1299,752,547,12,67,471,532
141,EL PASO,141,0093,1410093,3406,2208,239,1969,16,51,1918,1941,1751,202,1549,12,28,1508,1525
453,TRAVIS,453,0242,4530242,8816,8429,1961,6468,354,668,5419,5971,6379,1777,4602,309,508,3744,4170
485,WICHITA,485,0407,4850407,9357,900,790,110,8,8,61,67,711,636,75,3,4,40,44
491,WILLIAMSON,491,0166,4910166,9406,3572,2168,1404,368,288,681,943,3048,1944,1104,293,244,517,737
309,MCLENNAN,309,0068,3090068,6701,1692,1352,340,10,46,222,260,1333,1093,240,8,30,150,177
329,MIDLAND,329,0204,3290204,6824,6243,4289,1954,140,296,1377,1647,4798,3457,1341,91,196,941,1127
355,NUECES,355,0078,3550078,7193,2490,110,2380,10,351,2041,2361,1908,95,1813,6,267,1547,1803
355,NUECES,355,0126,3550126,7242,7016,2822,4194,514,358,3364,3647,5005,2174,2831,346,263,2212,2440
367,PARKER,367,0320,3670320,7365,2945,2429,516,26,40,359,395,2268,1931,337,12,23,223,245
439,TARRANT,439,1165,4391165,7906,415,171,244,2,22,222,238,297,140,157,2,10,145,153
171,GILLESPIE,171,0008,1710008,3947,420,304,116,2,2,91,93,347,261,86,0,0,65,65
187,GUADALUPE,187,0305,1870305,4119,6675,3202,3473,437,979,2068,2944,4917,2488,2429,297,698,1358,2010
201,HARRIS,201,0443,2010443,4660,816,610,206,79,25,90,113,613,468,145,59,16,57,72
201,HARRIS,201,0983,2010983,5201,5953,2133,3820,881,1126,1805,2888,4327,1679,2648,626,784,1205,1970
245,JEFFERSON,245,0083,2450083,6111,1952,1434,518,82,107,290,390,1463,1146,317,62,56,172,225
309,MCLENNAN,309,0020,3090020,6652,1218,424,794,44,383,374,724,950,378,572,38,277,247,515
61,CAMERON,61,0065,610065,1477,5553,372,5181,12,35,5140,5153,3749,300,3449,6,16,3422,3427
85,COLLIN,85,0097,850097,1726,1530,1280,250,63,47,117,157,1236,1068,168,38,26,79,100
99,CORYELL,99,0103,990103,1975,545,405,140,8,12,104,115,416,321,95,8,2,73,74
113,DALLAS,113,2016,1132016,2224,4103,3197,906,302,183,380,530,3430,2745,685,230,121,278,386
121,DENTON,121,4211,1214211,3137,5400,4511,889,151,134,429,554,4107,3521,586,95,96,278,366
141,EL PASO,141,0073,1410073,3386,2138,98,2040,10,37,1998,2018,1748,90,1658,9,30,1621,1641
303,LUBBOCK,303,0038,3030038,6552,2977,789,2188,13,302,1882,2123,2144,629,1515,3,202,1287,1474
381,RANDALL,381,0204,3810204,7465,6033,4326,1707,270,223,1093,1301,4651,3473,1178,190,157,716,864
419,SHELBY,419,01SW,41901SW,7714,1883,1312,571,26,194,318,511,1466,1043,423,16,166,216,381
439,TARRANT,439,1388,4391388,7963,7956,1768,6188,1481,3409,1226,4516,5936,1471,4465,1104,2359,904,3191
157,FORT BEND,157,1148A,1571148A,3635,19438,9052,10386,3273,2445,4407,6743,12547,6081,6466,2047,1487,2753,4190
167,GALVESTON,167,0353,1670353,3884,7390,3988,3402,300,657,2298,2915,5910,3476,2434,233,491,1589,2054
215,HIDALGO,215,0004,2150004,5556,5173,201,4972,28,40,4925,4934,3737,169,3568,26,10,3531,3533
215,HIDALGO,215,0253,2150253,5805,721,129,592,1,5,582,584,576,129,447,1,3,437,439
245,JEFFERSON,245,0026,2450026,6054,3896,2014,1882,266,988,555,1529,3131,1718,1413,215,720,423,1131
265,KERR,265,0405,2650405,6303,1977,1652,325,16,16,234,249,1689,1472,217,11,8,153,161
39,BRAZORIA,39,0009,390009,1122,5764,2177,3587,47,1708,1821,3509,5351,2043,3308,32,1627,1633,3248
81,COKE,81,0001,810001,1620,834,603,231,4,6,189,190,623,467,156,2,3,120,121
113,DALLAS,113,4088,1134088,2745,3376,115,3261,27,193,3052,3206,2433,87,2346,18,145,2182,2302
113,DALLAS,113,1171,1131171,2118,3451,2276,1175,152,308,616,917,2853,1915,938,124,247,489,730
113,DALLAS,113,3612,1133612,2616,4206,436,3770,49,3094,621,3689,3310,392,2918,37,2445,410,2849
135,ECTOR,135,0403,1350403,3243,5997,256,5741,14,601,5123,5695,4346,196,4150,7,448,3685,4120
349,NAVARRO,349,0307,3490307,7073,935,487,448,25,50,341,390,709,422,287,9,33,216,248
397,ROCKWALL,397,003AB,397003AB,7571,96,70,26,1,3,22,24,65,54,11,0,3,8,10
439,TARRANT,439,4602,4394602,8567,0,0,0,0,0,0,0,0,0,0,0,0,0,0
439,TARRANT,439,2002,4392002,8069,0,0,0,0,0,0,0,0,0,0,0,0,0,0
157,FORT BEND,157,3139,1573139,3741,2936,395,2541,2109,305,125,424,2215,294,1921,1593,236,91,322
201,HARRIS,201,0023,2010023,4239,3628,50,3578,53,278,3257,3510,2510,37,2473,46,236,2193,2416
209,HAYS,209,0205,2090205,5450,5608,2095,3513,165,446,2862,3244,3993,1645,2348,124,289,1891,2153
231,HUNT,231,0108,2310108,5948,3340,1757,1583,30,495,971,1448,2454,1371,1083,21,373,621,983
291,LIBERTY,291,0009,2910009,6446,4701,4052,649,19,93,433,516,3497,3091,406,9,64,263,321
339,MONTGOMERY,339,0046,3390046,6944,6117,3513,2604,527,804,1213,1969,4023,2397,1626,326,502,745,1226
13,ATASCOSA,13,0009,130009,103,5009,990,4019,63,85,3840,3886,3598,823,2775,36,60,2627,2662
29,BEXAR,29,1102,291102,352,2115,483,1632,17,69,1528,1586,1594,407,1187,9,50,1101,1148
29,BEXAR,29,3077,293077,681,2923,1682,1241,148,72,1006,1068,2392,1451,941,92,53,766,815
29,BEXAR,29,4119,294119,930,922,421,501,47,57,400,452,826,392,434,46,56,334,386
85,COLLIN,85,0134,850134,1763,6806,2717,4089,1900,1214,860,2053,4511,1900,2611,1237,763,519,1270
111,DALLAM,111,0003,1110003,2012,36,36,0,0,0,0,0,32,32,0,0,0,0,0
455,TRINITY,455,0003,4550003,9008,656,596,60,3,10,18,26,569,527,42,2,10,11,19
485,WICHITA,485,0208,4850208,9337,603,396,207,4,33,148,179,471,331,140,2,20,102,121
497,WISE,497,0022,4970022,9586,1654,1333,321,11,22,239,250,1318,1094,224,2,9,169,174
245,JEFFERSON,245,0063,2450063,6091,1724,73,1651,9,1397,229,1619,1282,68,1214,8,1048,145,1189
275,KNOX,275,0101,2750101,6340,836,561,275,9,30,225,249,667,473,194,4,22,155,176
413,SCHLEICHER,413,0001,4130001,7677,592,289,303,7,14,294,298,451,252,199,4,10,192,196
439,TARRANT,439,1555,4391555,8012,72,9,63,1,37,25,61,58,9,49,0,32,16,48
439,TARRANT,439,1244,4391244,7926,306,138,168,5,39,110,144,205,115,90,4,17,56,70
453,TRAVIS,453,0163,4530163,8759,4968,1981,2987,625,885,1430,2240,3801,1612,2189,458,657,1008,1629
141,EL PASO,141,0036,1410036,3349,3919,422,3497,139,165,3185,3320,3384,397,2987,123,140,2697,2825
149,FAYETTE,149,301W,149301W,3598,2399,1831,568,31,137,372,491,1922,1545,377,27,84,239,317
201,HARRIS,201,0791,2010791,5009,0,0,0,0,0,0,0,0,0,0,0,0,0,0
201,HARRIS,201,0214,2010214,4431,2558,1447,1111,650,87,357,440,1935,1161,774,450,59,243,300
201,HARRIS,201,1040,2011040,5258,3845,223,3622,253,548,2821,3341,2683,186,2497,222,403,1867,2258
201,HARRIS,201,0463,2010463,4680,5293,1166,4127,379,1957,1820,3684,4108,1026,3082,312,1428,1325,2705
29,BEXAR,29,1039,291039,289,8087,396,7691,57,284,7431,7624,5413,304,5109,38,156,4945,5066
29,BEXAR,29,3139B,293139B,744,134,83,51,19,7,31,31,89,55,34,18,1,14,14
41,BRAZOS,41,0093,410093,1285,0,0,0,0,0,0,0,0,0,0,0,0,0,0
55,CALDWELL,55,0101,550101,1371,1182,449,733,16,103,611,699,896,372,524,9,73,435,498
113,DALLAS,113,2401,1132401,2367,5020,2629,2391,329,517,1458,1945,4095,2336,1759,265,383,1031,1394
121,DENTON,121,2070,1212070,2994,273,144,129,43,49,34,81,189,105,84,36,30,13,43
309,MCLENNAN,309,0062,3090062,6695,5637,3720,1917,185,665,975,1604,4588,3188,1400,132,476,690,1161
365,PANOLA,365,0007,3650007,7322,1044,760,284,2,234,32,264,786,563,223,0,190,23,212
439,TARRANT,439,3363,4393363,8318,5047,3154,1893,227,586,984,1531,3522,2298,1224,147,387,606,979
439,TARRANT,439,3720,4393720,8404,2788,2292,496,100,62,221,278,2147,1821,326,59,35,141,176
453,TRAVIS,453,0405,4530405,8945,5048,1606,3442,189,677,2562,3163,4012,1416,2596,147,512,1870,2353
491,WILLIAMSON,491,0150,4910150,9400,8476,3130,5346,244,1125,3921,4911,6573,2689,3884,182,790,2809,3539
181,GRAYSON,181,0104,1810104,3990,1453,1191,262,21,22,150,168,1153,968,185,15,15,97,109
187,GUADALUPE,187,0119,1870119,4076,2507,1571,936,28,75,807,869,2044,1355,689,23,41,589,630
201,HARRIS,201,0854,2010854,5072,383,4,379,1,102,282,379,300,4,296,0,92,208,296
201,HARRIS,201,0400,2010400,4617,22,0,22,0,6,13,16,15,0,15,0,4,7,10
215,HIDALGO,215,0147,2150147,5699,577,27,550,13,9,532,534,352,16,336,9,6,322,324
215,HIDALGO,215,0061,2150061,5613,6235,205,6030,50,47,5959,5972,4325,148,4177,43,25,4122,4127
29,BEXAR,29,3040,293040,644,2806,1295,1511,113,133,1236,1343,2222,1085,1137,76,108,915,1007
29,BEXAR,29,1138,291138,389,3243,757,2486,238,490,1771,2193,2578,645,1933,178,389,1346,1695
29,BEXAR,29,1144,291144,395,2643,1875,768,118,146,511,627,2454,1851,603,75,105,396,490
29,BEXAR,29,3034,293034,638,3053,2431,622,61,46,445,486,2478,2027,451,41,38,305,339
113,DALLAS,113,4513,1134513,2808,7997,1179,6818,118,1999,4660,6575,5585,1025,4560,95,1304,3106,4374
113,DALLAS,113,4507,1134507,2802,2421,218,2203,39,844,1345,2154,1676,176,1500,21,641,849,1470
453,TRAVIS,453,0225,4530225,8802,3538,2258,1280,475,132,593,710,2977,1911,1066,388,116,492,600
459,UPSHUR,459,0009,4590009,9051,2894,2295,599,17,317,165,480,2228,1793,435,6,242,102,343
459,UPSHUR,459,0003,4590003,9045,2264,1668,596,14,137,359,488,1748,1348,400,6,103,220,319
479,WEBB,479,0457,4790457,9300,87,15,72,1,5,70,70,70,13,57,1,5,55,55
201,HARRIS,201,0500,2010500,4717,6754,2936,3818,659,1278,1848,3065,5153,2417,2736,494,924,1276,2163
309,MCLENNAN,309,0006,3090006,6638,2352,195,2157,13,129,2026,2128,1684,175,1509,9,79,1414,1486
337,MONTAGUE,337,0010,3370010,6887,1762,1276,486,12,24,386,409,1319,1001,318,10,11,246,256
337,MONTAGUE,337,0004,3370004,6881,1154,906,248,1,9,187,196,839,677,162,1,6,117,123
355,NUECES,355,0021,3550021,7136,607,310,297,30,24,215,229,531,287,244,29,16,168,180
439,TARRANT,439,4551,4394551,8553,7228,3570,3658,344,1074,2120,3118,5089,2749,2340,231,654,1340,1963
113,DALLAS,113,3111,1133111,2553,0,0,0,0,0,0,0,0,0,0,0,0,0,0
113,DALLAS,113,3117,1133117,2559,108,33,75,0,64,8,72,104,33,71,0,60,8,68
201,HARRIS,201,0257,2010257,4474,11527,680,10847,472,3390,7136,10295,7925,562,7363,370,2239,4798,6925
201,HARRIS,201,0748,2010748,4966,4479,1590,2889,428,922,1552,2396,3478,1367,2111,329,644,1117,1718
201,HARRIS,201,0754,2010754,4972,5145,129,5016,162,2958,1959,4832,3414,112,3302,107,2052,1185,3188
201,HARRIS,201,0506,2010506,4723,5861,435,5426,383,2531,2543,4995,4574,384,4190,315,2071,1809,3842
29,BEXAR,29,4225,294225,1036,915,399,516,44,90,379,455,692,321,371,32,61,277,331
29,BEXAR,29,2125,292125,538,5046,1446,3600,433,650,2598,3149,3329,1053,2276,280,405,1607,1974
29,BEXAR,29,2082,292082,495,3443,381,3062,45,199,2839,2983,2557,346,2211,35,128,2050,2153
113,DALLAS,113,4043,1134043,2702,2893,99,2794,17,532,2251,2761,2043,75,1968,13,450,1499,1939
113,DALLAS,113,3982,1133982,2659,5658,2583,3075,1032,605,1292,1870,4059,1998,2061,719,395,824,1212
113,DALLAS,113,1703,1131703,2161,7234,1118,6116,1389,823,3890,4672,5248,968,4280,1070,567,2610,3163
339,MONTGOMERY,339,0087,3390087,6987,8055,5051,3004,720,783,1351,2066,5297,3397,1900,460,516,819,1298
345,MOTLEY,345,0004,3450004,7030,270,241,29,3,1,17,18,219,203,16,2,1,6,7
391,REFUGIO,391,0004,3910004,7528,940,219,721,20,167,548,692,707,171,536,13,119,403,512
449,TITUS,449,0002,4490002,8653,1032,472,560,13,168,365,524,758,382,376,10,129,225,348
29,BEXAR,29,1111,291111,361,5452,1131,4321,257,522,3583,4037,4078,930,3148,186,391,2569,2929
201,HARRIS,201,0909,2010909,5127,4131,2040,2091,798,384,874,1235,2776,1416,1360,531,245,558,795
113,DALLAS,113,2090,1132090,2276,103,41,62,8,15,40,54,81,34,47,7,13,27,40
413,SCHLEICHER,413,0004,4130004,7680,644,422,222,11,12,198,202,483,344,139,6,7,120,122
355,NUECES,355,0112,3550112,7228,3306,1021,2285,71,184,2051,2187,2652,903,1749,51,128,1558,1669
29,BEXAR,29,4188,294188,999,0,0,0,0,0,0,0,0,0,0,0,0,0,0
201,HARRIS,201,0612,2010612,4829,4566,3349,1217,116,191,795,974,3382,2587,795,85,128,486,606
113,DALLAS,113,2045,1132045,2250,2651,1805,846,187,159,441,591,2096,1463,633,152,113,313,426
117,DEAF SMITH,117,0002,1170002,2914,4598,743,3855,14,67,3743,3773,3185,607,2578,12,40,2490,2509
135,ECTOR,135,0303,1350303,3229,4262,973,3289,61,254,2949,3153,3296,844,2452,48,187,2195,2346
241,JASPER,241,0017,2410017,6020,1543,1398,145,13,28,69,96,1157,1081,76,6,17,34,50
341,MOORE,341,0301,3410301,7016,5340,1165,4175,267,164,3664,3809,3811,961,2850,183,101,2483,2577
121,DENTON,121,3159,1213159,3083,8048,4556,3492,240,636,2372,2961,5975,3661,2314,188,421,1487,1895
113,DALLAS,113,1732,1131732,2190,2981,667,2314,966,617,734,1337,2309,586,1723,771,434,507,937
189,HALE,189,0203,1890203,4148,1352,125,1227,10,88,1138,1210,970,107,863,8,55,796,849
349,NAVARRO,349,0109,3490109,7059,741,359,382,7,46,306,347,529,292,237,4,22,194,216
439,TARRANT,439,1012,4391012,7849,3942,1260,2682,143,1096,1425,2482,2945,1100,1845,115,788,913,1684
201,HARRIS,201,0737,2010737,4955,71,21,50,0,10,40,48,61,21,40,0,9,31,39
29,BEXAR,29,1068,291068,318,5413,988,4425,177,477,3815,4214,3564,733,2831,93,271,2429,2678
187,GUADALUPE,187,0308,1870308,4122,2911,1733,1178,131,245,768,990,2170,1352,818,86,173,507,667
201,HARRIS,201,0969,2010969,5187,792,2,790,6,709,74,777,625,2,623,4,567,46,610
31,BLANCO,31,0102,310102,1042,2768,2043,725,29,34,570,600,2234,1714,520,15,27,404,428
453,TRAVIS,453,0230,4530230,8805,5522,3929,1593,791,105,570,662,4521,3254,1267,655,75,445,510
201,HARRIS,201,0757,2010757,4975,8920,380,8540,1071,3831,3704,7424,6160,314,5846,804,2637,2411,4998
53,BURNET,53,0008,530008,1357,1607,1209,398,10,73,265,334,1337,1061,276,8,48,177,221
453,TRAVIS,453,0345,4530345,8888,4193,2547,1646,451,170,923,1073,3366,2099,1267,335,135,713,833
121,DENTON,121,4178,1214178,3103,3050,1557,1493,229,329,871,1178,2475,1365,1110,193,251,596,834
201,HARRIS,201,0800,2010800,5018,7238,2905,4333,406,1508,2437,3852,5448,2383,3065,303,1071,1658,2681
51,BURLESON,51,0113,510113,1337,1040,742,298,11,91,165,254,824,611,213,8,67,112,177
451,TOM GREEN,451,0421,4510421,8699,5020,3032,1988,220,280,1393,1646,3959,2550,1409,174,191,957,1137
201,HARRIS,201,0015,2010015,4231,4111,2954,1157,650,48,390,436,2941,2216,725,395,29,251,278
249,JIM WELLS,249,0009,2490009,6146,1362,132,1230,2,9,1221,1228,921,118,803,2,4,798,802
41,BRAZOS,41,0040,410040,1231,4863,3734,1129,309,115,566,664,3865,3037,828,238,88,402,482
121,DENTON,121,4220,1214220,3146,4131,2742,1389,69,181,982,1144,3014,2102,912,47,108,628,727
255,KARNES,255,0003,2550003,6209,154,119,35,2,4,29,32,127,104,23,1,2,20,21
439,TARRANT,439,1586,4391586,8018,32,0,32,6,15,8,23,24,0,24,5,11,5,16
453,TRAVIS,453,0170,4530170,8762,6411,1931,4480,328,1317,2815,4045,5018,1701,3317,254,985,2015,2958
439,TARRANT,439,2058,4392058,8081,62,34,28,5,5,17,22,49,29,20,5,5,9,14
133,EASTLAND,133,0009,1330009,3209,657,595,62,1,6,41,47,583,535,48,0,3,34,37
201,HARRIS,201,0694,2010694,4912,3131,666,2465,526,922,1034,1905,2226,549,1677,410,561,697,1236
233,HUTCHINSON,233,0011,2330011,5977,2753,1835,918,21,89,688,762,1932,1421,511,14,36,353,386
329,MIDLAND,329,0207,3290207,6827,4356,2526,1830,57,442,1230,1645,3415,2055,1360,43,345,891,1222
41,BRAZOS,41,0102,410102,1294,9,6,3,0,1,2,3,4,3,1,0,1,0,1
113,DALLAS,113,1328,1131328,2144,45,7,38,4,13,22,34,31,3,28,3,10,14,24
245,JEFFERSON,245,0055,2450055,6083,443,9,434,4,377,51,428,368,9,359,3,312,43,355
191,HALL,191,0101,1910101,4168,713,308,405,11,98,294,386,523,265,258,3,61,185,243
439,TARRANT,439,1117,4391117,7892,2697,1950,747,104,92,453,532,2209,1644,565,80,70,337,400
113,DALLAS,113,2309,1132309,2359,3801,1046,2755,1271,887,586,1441,3397,990,2407,1117,777,488,1246
57,CALHOUN,57,0007,570007,1400,3696,1479,2217,541,103,1521,1606,2862,1252,1610,414,82,1057,1135
187,GUADALUPE,187,0221,1870221,4105,45,16,29,0,1,29,29,44,16,28,0,0,28,28
113,DALLAS,113,2110,1132110,2296,1295,35,1260,16,244,1002,1235,947,27,920,11,190,719,903
453,TRAVIS,453,0386C,4530386C,8931,61,45,16,5,0,8,8,43,35,8,1,0,7,7
121,DENTON,121,1053,1211053,2977,785,307,478,31,290,142,427,619,265,354,24,203,115,316
61,CAMERON,61,0051,610051,1463,3820,126,3694,5,15,3677,3685,2590,101,2489,5,10,2478,2484
339,MONTGOMERY,339,0055,3390055,6953,4025,1654,2371,19,90,2211,2290,2692,1277,1415,18,65,1296,1358
39,BRAZORIA,39,0055,390055,1168,5246,2679,2567,79,916,1538,2389,3893,2131,1762,53,629,1019,1623
227,HOWARD,227,0045,2270045,5914,1494,811,683,42,75,571,630,1082,648,434,30,51,354,397
113,DALLAS,113,2025,1132025,2233,3073,2667,406,141,36,183,212,2654,2346,308,103,24,136,157
29,BEXAR,29,2012,292012,424,2990,81,2909,22,41,2863,2885,2230,69,2161,16,25,2124,2141
201,HARRIS,201,0926,2010926,5144,5572,2151,3421,924,667,1794,2416,3984,1607,2377,651,462,1213,1656
201,HARRIS,201,0632,2010632,4849,100,49,51,1,10,39,49,68,35,33,1,10,21,31
141,EL PASO,141,0022,1410022,3335,4562,1035,3527,121,144,3251,3357,3680,900,2780,94,105,2554,2639
121,DENTON,121,3116,1213116,3040,9235,2524,6711,4122,1569,988,2495,7056,2089,4967,3074,1154,694,1817
201,HARRIS,201,0863,2010863,5081,953,34,919,8,572,346,904,700,32,668,5,430,238,660
183,GREGG,183,0015,1830015,4042,3901,1708,2193,16,692,1406,2080,2818,1332,1486,9,552,856,1402
439,TARRANT,439,1351,4391351,7955,0,0,0,0,0,0,0,0,0,0,0,0,0,0
139,ELLIS,139,1018,1391018,3272,5611,1525,4086,42,1014,3004,3991,4069,1274,2795,14,739,2000,2735
337,MONTAGUE,337,0013,3370013,6890,1298,1104,194,1,5,105,109,1002,862,140,1,4,72,75
453,TRAVIS,453,0471,4530471,8994,6879,1761,5118,251,634,4212,4764,5035,1478,3557,173,436,2904,3303
39,BRAZORIA,39,0078,390078,1191,4823,1604,3219,84,1308,1780,3066,4056,1401,2655,65,1180,1376,2537
121,DENTON,121,4181,1214181,3106,6650,4165,2485,380,678,1283,1912,4840,3201,1639,259,428,827,1243
121,DENTON,121,2096,1212096,3020,5144,2876,2268,1563,200,401,590,3607,2035,1572,1100,138,257,391
201,HARRIS,201,0717,2010717,4935,4185,143,4042,296,1466,2296,3713,3090,124,2966,267,1136,1561,2674
29,BEXAR,29,1005,291005,255,1516,80,1436,6,21,1419,1430,1182,62,1120,2,14,1109,1118
37,BOWIE,37,008C,37008C,1105,3336,2231,1105,13,613,354,954,2878,1930,948,9,536,299,826
453,TRAVIS,453,0253,4530253,8825,6169,1323,4846,675,880,3341,4121,4300,1081,3219,539,595,2096,2645
201,HARRIS,201,0777,2010777,4995,3785,218,3567,42,189,3325,3499,2487,165,2322,34,104,2164,2264
423,SMITH,423,0074,4230074,7786,961,730,231,97,69,53,122,798,627,171,66,67,31,98
15,AUSTIN,15,0311,150311,126,2349,612,1737,33,437,1264,1659,1732,488,1244,25,318,876,1182
201,HARRIS,201,0675A,2010675A,4892,5997,2681,3316,156,794,2294,3047,4336,2105,2231,117,551,1492,2013
27,BELL,27,0309,270309,229,1826,1330,496,26,102,324,410,1492,1130,362,18,71,228,292
453,TRAVIS,453,0173,4530173,8765,2165,1344,821,82,212,492,695,1733,1129,604,57,163,349,510
35,BOSQUE,35,0009,350009,1062,1566,983,583,18,61,444,497,1219,824,395,9,37,301,337
173,GLASSCOCK,173,0004,1730004,3956,275,147,128,1,10,121,125,188,106,82,1,9,77,81
321,MATAGORDA,321,001A,321001A,6764,3869,1891,1978,62,181,1695,1845,2897,1562,1335,42,127,1113,1230
21,BASTROP,21,4024,214024,169,3724,1650,2074,42,175,1803,1958,2690,1335,1355,27,117,1152,1266
201,HARRIS,201,0820,2010820,5038,2742,694,2048,170,660,1207,1830,1988,556,1432,125,478,800,1261
453,TRAVIS,453,0120,4530120,8722,4494,770,3724,56,995,2713,3656,3429,726,2703,40,868,1809,2647
181,GRAYSON,181,0204,1810204,3999,166,103,63,0,2,60,62,126,83,43,0,1,42,43
453,TRAVIS,453,0322,4530322,8868,3891,3149,742,304,51,327,368,2941,2433,508,193,34,224,252
121,DENTON,121,3139,1213139,3063,6383,4325,2058,1097,244,560,791,4889,3446,1443,742,190,378,565
439,TARRANT,439,1270,4391270,7932,1289,467,822,30,206,575,775,957,420,537,23,145,356,498
29,BEXAR,29,1022,291022,272,1643,49,1594,4,11,1589,1589,1231,34,1197,4,6,1194,1194
123,DEWITT,123,0201,1230201,3166,725,447,278,3,47,226,261,555,361,194,3,30,157,181
113,DALLAS,113,1304,1131304,2127,3215,755,2460,60,408,1969,2358,2334,662,1672,47,287,1315,1593
339,MONTGOMERY,339,0096,3390096,6996,8372,3783,4589,706,1205,2506,3664,5768,2770,2998,496,736,1631,2343
187,GUADALUPE,187,0218,1870218,4102,145,30,115,0,2,114,115,98,19,79,0,1,79,79
105,CROCKETT,105,0002,1050002,1998,802,348,454,8,5,435,437,594,306,288,8,4,273,275
219,HOCKLEY,219,0016,2190016,5828,2838,1782,1056,13,107,899,997,2199,1465,734,10,91,591,679
201,HARRIS,201,0949,2010949,5167,3047,527,2520,390,1212,920,2112,2420,466,1954,310,982,664,1631
29,BEXAR,29,2094,292094,507,194,126,68,11,1,47,48,152,108,44,6,1,28,29
195,HANSFORD,195,0003,1950003,4188,389,231,158,0,3,148,148,300,185,115,0,0,105,105
439,TARRANT,439,1739,4391739,8061,223,14,209,3,171,34,201,123,9,114,2,94,18,112
61,CAMERON,61,0031,610031,1443,595,102,493,2,3,488,488,431,92,339,2,3,337,337
137,EDWARDS,137,0002,1370002,3252,344,235,109,10,9,93,97,287,208,79,6,9,66,70
355,NUECES,355,0010,3550010,7125,1436,782,654,4,14,598,608,1123,679,444,2,10,412,420
113,DALLAS,113,2417,1132417,2379,468,199,269,56,57,152,201,396,190,206,49,38,111,145
245,JEFFERSON,245,0032,2450032,6060,335,261,74,29,23,21,44,304,239,65,27,22,14,36
245,JEFFERSON,245,0075,2450075,6103,1448,233,1215,234,700,282,967,1205,224,981,222,539,220,746
29,BEXAR,29,1065,291065,315,4461,708,3753,19,62,3678,3703,3259,595,2664,13,31,2621,2633
201,HARRIS,201,0077,2010077,4294,0,0,0,0,0,0,0,0,0,0,0,0,0,0
55,CALDWELL,55,0204,550204,1380,2239,1288,951,12,69,798,861,1663,1068,595,6,31,490,519
201,HARRIS,201,0035,2010035,4251,443,261,182,25,14,132,146,349,194,155,20,12,112,124
201,HARRIS,201,1012,2011012,5230,4583,169,4414,734,632,3069,3668,3199,145,3054,581,461,2008,2456
29,BEXAR,29,2032,292032,444,1158,25,1133,10,47,1075,1120,805,21,784,7,17,757,774
439,TARRANT,439,1424,4391424,7975,12,8,4,0,3,3,4,10,8,2,0,2,2,2
503,YOUNG,503,0006,5030006,9615,259,198,61,3,3,41,44,213,168,45,3,1,29,30
251,JOHNSON,251,0008,2510008,6166,7190,2879,4311,52,122,3900,3999,5190,2348,2842,31,66,2550,2613
347,NACOGDOCHES,347,0024,3470024,7039,3122,1224,1898,46,1269,578,1829,2501,1113,1388,35,943,401,1334
185,GRIMES,185,0012,1850012,4059,1472,869,603,6,169,406,567,1174,749,425,4,140,263,403
141,EL PASO,141,0002,1410002,3315,6502,468,6034,44,116,5818,5907,5043,429,4614,32,89,4426,4504
231,HUNT,231,214B,231214B,5974,1875,1448,427,16,23,329,351,1481,1225,256,13,9,183,192
201,HARRIS,201,0906,2010906,5124,6467,3179,3288,1409,577,1209,1751,4212,2209,2003,846,371,714,1068
453,TRAVIS,453,0446,4530446,8974,4546,2767,1779,191,267,1245,1487,3835,2438,1397,158,213,948,1145
327,MENARD,327,0005,3270005,6807,88,79,9,0,0,8,8,71,65,6,0,0,6,6
47,BROOKS,47,0001,470001,1314,1764,118,1646,13,12,1623,1632,1292,97,1195,13,9,1173,1182
339,MONTGOMERY,339,0017,3390017,6910,7532,4460,3072,67,210,2582,2772,5453,3511,1942,44,154,1577,1724
223,HOPKINS,223,0024,2230024,5871,1096,924,172,5,19,88,107,853,737,116,4,10,61,71
29,BEXAR,29,1127,291127,378,1082,50,1032,4,16,1023,1027,814,42,772,4,10,766,769
439,TARRANT,439,1009,4391009,7846,2252,1350,902,57,283,521,792,1748,1144,604,33,169,351,515
121,DENTON,121,4198,1214198,3123,3834,3189,645,73,56,402,449,2839,2414,425,58,32,250,279
451,TOM GREEN,451,0146,4510146,8679,7641,2010,5631,85,391,5056,5383,5944,1787,4157,57,283,3705,3957
351,NEWTON,351,0019,3510019,7102,256,216,40,0,28,3,31,197,168,29,0,19,3,22
201,HARRIS,201,0883,2010883,5101,6668,298,6370,157,2321,3958,6187,4670,256,4414,123,1658,2670,4276
441,TAYLOR,441,0207,4410207,8616,516,403,113,13,9,76,80,386,313,73,7,4,43,46
113,DALLAS,113,1111,1131111,2084,4933,362,4571,68,767,3725,4457,3223,287,2936,42,558,2327,2868
453,TRAVIS,453,0370,4530370,8911,6206,3753,2453,297,142,1825,1948,4722,3043,1679,208,83,1231,1308
41,BRAZOS,41,0060,410060,1251,146,110,36,2,12,15,27,110,85,25,2,9,9,18
339,MONTGOMERY,339,0074,3390074,6973,5440,2596,2844,98,240,2365,2582,3976,2102,1874,58,164,1527,1681
39,BRAZORIA,39,0035,390035,1148,2487,1687,800,16,39,659,698,1949,1375,574,15,27,457,484
113,DALLAS,113,1729,1131729,2187,4355,528,3827,366,687,2734,3399,3107,464,2643,261,497,1832,2321
121,DENTON,121,1033,1211033,2957,4402,3084,1318,491,304,436,716,2814,2007,807,301,209,258,450
245,JEFFERSON,245,0009,2450009,6037,5296,3911,1385,323,208,778,961,4155,3141,1014,238,173,534,691
27,BELL,27,0208,270208,212,7450,2038,5412,563,2921,2013,4642,5429,1679,3750,394,2014,1289,3174
113,DALLAS,113,1007,1131007,2021,490,424,66,27,4,29,33,373,320,53,24,3,21,24
113,DALLAS,113,2130,1132130,2316,6785,701,6084,150,909,5041,5896,4801,648,4153,120,741,3293,3999
423,SMITH,423,0022,4230022,7743,1726,952,774,38,449,344,720,1568,934,634,30,392,267,588
439,TARRANT,439,1641,4391641,8038,5623,1879,3744,664,1917,1141,3004,4157,1518,2639,474,1360,758,2094
265,KERR,265,0118,2650118,6292,884,634,250,25,49,169,214,797,596,201,20,45,129,173
5,ANGELINA,5,0037,50037,63,845,555,290,6,104,169,271,595,423,172,4,51,107,158
135,ECTOR,135,0103,1350103,3212,5252,1498,3754,21,93,3582,3648,3631,1143,2488,14,64,2364,2409
167,GALVESTON,167,0384,1670384,3893,1827,1209,618,50,67,446,504,1413,1007,406,35,45,279,319
99,CORYELL,99,0206,990206,1978,6931,2926,4005,435,1690,1789,3312,4402,2022,2380,267,969,1029,1924
41,BRAZOS,41,0106,410106,1297,831,281,550,23,265,259,506,630,255,375,19,175,172,341
453,TRAVIS,453,0281,4530281,8845,4060,3174,886,100,88,563,638,3347,2713,634,74,64,392,446
469,VICTORIA,469,0023,4690023,9143,2299,1510,789,12,75,666,724,1744,1198,546,5,53,446,493
189,HALE,189,0409,1890409,4165,1593,426,1167,19,115,1025,1126,1163,357,806,11,83,698,775
339,MONTGOMERY,339,0058,3390058,6956,2995,2429,566,160,48,302,346,2273,1922,351,98,27,185,210
121,DENTON,121,4201,1214201,3126,3014,2193,821,216,160,350,503,2113,1566,547,147,106,222,327
439,TARRANT,439,1477,4391477,7995,3863,157,3706,32,727,2981,3676,2599,141,2458,21,563,1890,2438
113,DALLAS,113,2107,1132107,2293,64,18,46,4,18,27,42,50,17,33,1,14,17,30
113,DALLAS,113,1402,1131402,2147,7574,1223,6351,48,1586,4706,6227,5139,1027,4112,34,1060,2979,4020
215,HIDALGO,215,0213,2150213,5765,511,47,464,0,0,461,461,368,37,331,0,0,330,330
455,TRINITY,455,0012,4550012,9017,159,141,18,0,9,9,18,128,111,17,0,8,9,17
439,TARRANT,439,1346,4391346,7952,2536,98,2438,10,1294,1142,2409,1629,85,1544,2,874,665,1530
127,DIMMIT,127,0007,1270007,3186,1084,162,922,10,7,909,912,814,149,665,10,4,652,655
29,BEXAR,29,2009,292009,421,6076,1416,4660,1501,904,2288,3104,4607,1152,3455,986,651,1808,2410
339,MONTGOMERY,339,0020,3390020,6913,5612,1487,4125,66,409,3602,3971,3951,1228,2723,47,285,2349,2615
201,HARRIS,201,0840,2010840,5058,3372,530,2842,78,1045,1712,2716,2466,466,2000,63,776,1156,1901
27,BELL,27,0101,270101,189,9266,6534,2732,407,673,1491,2089,7294,5325,1969,292,510,1032,1493
227,HOWARD,227,0037,2270037,5911,0,0,0,0,0,0,0,0,0,0,0,0,0,0
453,TRAVIS,453,0202,4530202,8785,3721,2419,1302,520,188,547,724,3460,2299,1161,457,176,484,651
39,BRAZORIA,39,0032,390032,1145,4104,2752,1352,35,289,938,1209,3196,2243,953,27,208,624,826
41,BRAZOS,41,0063,410063,1254,2501,1944,557,44,97,346,441,2092,1662,430,33,76,259,335
201,HARRIS,201,0866,2010866,5084,0,0,0,0,0,0,0,0,0,0,0,0,0,0
245,JEFFERSON,245,0095,2450095,6123,1069,429,640,214,189,229,407,843,374,469,165,144,151,288
141,EL PASO,141,0045,1410045,3358,6273,1157,5116,261,800,4120,4803,4620,948,3672,188,573,2902,3425
13,ATASCOSA,13,0012,130012,106,2271,591,1680,22,44,1606,1635,1679,499,1180,15,25,1136,1153
29,BEXAR,29,1150,291150,401,4615,1046,3569,296,579,2762,3246,3235,816,2419,203,385,1838,2184
181,GRAYSON,181,0404,1810404,4019,5824,4929,895,76,131,299,424,4561,3979,582,48,76,177,251
453,TRAVIS,453,0474,4530474,8997,2221,491,1730,78,69,1555,1603,1611,414,1197,58,40,1063,1099
351,NEWTON,351,0001,3510001,7082,1252,967,285,7,191,45,225,963,778,185,5,124,27,143
113,DALLAS,113,1709,1131709,2167,7567,865,6702,684,1615,4405,5973,5462,701,4761,526,1218,3017,4204
187,GUADALUPE,187,0127,1870127,4082,9,7,2,0,0,1,1,9,7,2,0,0,1,1
113,DALLAS,113,2085,1132085,2273,329,245,84,14,17,48,62,298,228,70,10,17,39,53
29,BEXAR,29,1108,291108,358,2852,775,2077,136,418,1574,1930,2069,622,1447,108,303,1052,1326
139,ELLIS,139,1041,1391041,3295,3491,2716,775,65,217,394,592,2659,2154,505,43,134,252,378
29,BEXAR,29,2052,292052,464,2037,137,1900,11,39,1856,1873,1561,117,1444,10,27,1404,1418
201,HARRIS,201,0992,2010992,5210,2237,578,1659,91,283,1280,1529,1649,492,1157,65,193,893,1068
231,HUNT,231,0216,2310216,5954,3040,2141,899,24,138,625,761,2236,1648,588,16,82,399,479
183,GREGG,183,0012,1830012,4039,7174,5745,1429,67,390,688,1052,5188,4275,913,25,244,407,647
221,HOOD,221,0310,2210310,5848,3007,2728,279,31,17,124,139,2545,2337,208,25,8,85,92
189,HALE,189,0111,1890111,4145,2082,500,1582,6,68,1504,1542,1522,425,1097,6,46,1033,1062
423,SMITH,423,0042,4230042,7763,5607,4069,1538,106,632,589,1199,4440,3399,1041,72,422,372,787
113,DALLAS,113,2022,1132022,2230,891,711,180,66,21,72,86,678,562,116,45,9,50,56
343,MORRIS,343,0101,3430101,7019,1236,388,848,17,602,201,798,910,311,599,15,440,125,561
201,HARRIS,201,0886,2010886,5104,1653,762,891,493,98,281,377,1466,704,762,411,84,247,330
355,NUECES,355,0030,3550030,7145,239,32,207,4,74,127,199,192,30,162,1,65,92,155
113,DALLAS,113,2152,1132152,2336,3304,1136,2168,218,879,1069,1908,2785,1094,1691,194,653,840,1463
177,GONZALES,177,0013,1770013,3976,505,331,174,2,3,158,161,390,263,127,2,3,114,117
459,UPSHUR,459,0017,4590017,9060,3721,2495,1226,52,651,403,1033,2750,1938,812,31,427,252,676
417,SHACKELFORD,417,0406B,4170406B,7700,11,9,2,0,0,2,2,2,2,0,0,0,0,0
225,HOUSTON,225,0016,2250016,5891,399,333,66,4,8,30,38,329,277,52,4,4,24,28
41,BRAZOS,41,0017,410017,1208,6878,2367,4511,81,1205,3154,4308,5293,2013,3280,58,870,2273,3120
453,TRAVIS,453,0418,4530418,8954,5335,2177,3158,424,434,2250,2639,4608,2074,2534,374,354,1747,2072
439,TARRANT,439,1108,4391108,7889,2676,2058,618,119,96,353,446,2193,1733,460,95,77,250,324
53,BURNET,53,0011,530011,1360,563,501,62,7,9,32,41,451,413,38,2,5,17,22
245,JEFFERSON,245,0052,2450052,6080,663,17,646,7,569,72,637,528,16,512,6,458,46,504
113,DALLAS,113,1060,1131060,2041,5123,4014,1109,189,153,623,758,4094,3326,768,134,84,451,528
113,DALLAS,113,2520,1132520,2399,6298,2504,3794,1235,1542,902,2406,4833,2091,2742,937,1051,650,1674
27,BELL,27,0312,270312,232,3358,2272,1086,35,108,852,944,2451,1758,693,17,62,523,580
329,MIDLAND,329,0411,3290411,6850,4536,3334,1202,173,90,800,876,3237,2463,774,113,57,512,560
201,HARRIS,201,0823,2010823,5041,5872,1549,4323,873,947,2493,3372,4364,1287,3077,663,633,1735,2346
135,ECTOR,135,0306,1350306,3232,3805,631,3174,109,309,2713,2994,2758,534,2224,81,215,1893,2090
453,TRAVIS,453,0256,4530256,8828,4939,2561,2378,1134,350,813,1138,4178,2236,1942,936,294,643,922
29,BEXAR,29,2114,292114,527,5527,781,4746,67,492,4233,4640,3959,681,3278,52,311,2923,3197
167,GALVESTON,167,0167,1670167,3850,4892,3510,1382,201,320,723,1011,4183,3127,1056,161,229,543,755
121,DENTON,121,3156,1213156,3080,1252,1011,241,49,35,112,143,977,824,153,35,22,65,85
439,TARRANT,439,1723,4391723,8058,2899,917,1982,338,1244,437,1650,2091,746,1345,231,849,289,1114
433,STONEWALL,433,0001,4330001,7826,326,248,78,4,9,63,67,257,200,57,4,5,43,47
241,JASPER,241,0014,2410014,6017,3990,3104,886,5,567,191,754,2956,2379,577,2,371,108,475
453,TRAVIS,453,0348A,4530348A,8891,4355,2527,1828,886,122,761,860,2714,1618,1096,542,73,443,505
167,GALVESTON,167,0436,1670436,3913,4588,510,4078,59,3361,683,3979,3505,417,3088,46,2621,429,3012
199,HARDIN,199,0011,1990011,4208,2450,2157,293,7,61,110,171,1906,1720,186,5,32,56,88
29,BEXAR,29,1045,291045,295,7715,446,7269,76,214,7003,7152,5349,377,4972,60,124,4774,4880
113,DALLAS,113,1144,1131144,2104,4327,3020,1307,122,539,588,1106,3133,2219,914,72,406,379,776
201,HARRIS,201,0760,2010760,4978,3175,2521,654,142,129,287,409,2400,1958,442,111,93,182,270
123,DEWITT,123,0301,1230301,3169,1986,1267,719,6,65,650,700,1573,1033,540,6,45,487,525
439,TARRANT,439,1418,4391418,7972,0,0,0,0,0,0,0,0,0,0,0,0,0,0
189,HALE,189,0105,1890105,4142,653,173,480,9,66,406,465,466,154,312,9,49,254,298
113,DALLAS,113,2019,1132019,2227,2064,1661,403,187,56,138,182,1600,1329,271,123,43,84,121
201,HARRIS,201,0903,2010903,5121,5251,2730,2521,434,290,1678,1954,3697,2027,1670,271,208,1119,1317
347,NACOGDOCHES,347,0015,3470015,7036,2674,1915,759,32,356,277,622,1989,1480,509,20,243,165,402
201,HARRIS,201,0860,2010860,5078,4887,1796,3091,724,524,1808,2300,3775,1496,2279,619,393,1227,1601
453,TRAVIS,453,0415,4530415,8951,4391,2434,1957,265,179,1474,1623,3647,2200,1447,180,149,1052,1185
245,JEFFERSON,245,0029,2450029,6057,2748,2114,634,16,73,494,562,2052,1640,412,9,52,311,359
245,JEFFERSON,245,0072,2450072,6100,7626,2697,4929,567,3495,821,4262,6052,2367,3685,446,2595,576,3149
113,DALLAS,113,2082,1132082,2270,5793,1538,4255,174,485,3563,4007,4539,1330,3209,138,416,2604,2996
339,MONTGOMERY,339,0093,3390093,6993,10936,4662,6274,248,559,5336,5827,7237,3434,3803,179,342,3163,3473
439,TARRANT,439,1576,4391576,8015,998,29,969,41,283,651,928,655,18,637,34,196,410,604
29,BEXAR,29,1105,291105,355,2673,245,2428,52,121,2274,2366,1775,212,1563,27,71,1458,1519
453,TRAVIS,453,0365,4530365,8908,2997,2338,659,187,41,337,376,2158,1733,425,108,30,218,248
193,HAMILTON,193,0023,1930023,4185,1455,1170,285,17,9,236,243,1131,932,199,14,5,162,166
55,CALDWELL,55,0201,550201,1377,1816,758,1058,23,129,914,1005,1332,645,687,14,66,586,649
139,ELLIS,139,1038,1391038,3292,5469,3711,1758,104,796,748,1524,3940,2814,1126,68,505,453,951
113,DALLAS,113,2306,1132306,2356,2157,937,1220,110,84,998,1068,1667,789,878,90,54,707,752
29,BEXAR,29,3132,293132,736,3373,939,2434,128,456,1903,2288,2834,871,1963,109,344,1545,1839
133,EASTLAND,133,0006,1330006,3206,504,400,104,2,5,86,89,397,327,70,1,3,54,57
29,BEXAR,29,2029,292029,441,3279,76,3203,90,188,2955,3111,1954,43,1911,33,81,1808,1878
41,BRAZOS,41,0099,410099,1291,7,1,6,0,0,5,5,5,0,5,0,0,4,4
85,COLLIN,85,0043,850043,1672,5649,2435,3214,382,1457,1286,2685,3989,1874,2115,254,918,845,1736
289,LEON,289,0014,2890014,6438,327,243,84,3,37,37,74,273,207,66,3,30,28,58
113,DALLAS,113,3604,1133604,2608,4276,557,3719,64,2958,687,3606,3322,509,2813,58,2247,491,2717
439,TARRANT,439,3331,4393331,8310,4065,3146,919,483,135,213,343,3062,2434,628,320,101,146,242
61,CAMERON,61,0008,610008,1420,1137,24,1113,2,5,1104,1108,788,22,766,1,5,761,765
201,HARRIS,201,0263,2010263,4480,6513,3341,3172,902,838,1365,2133,4779,2614,2165,666,535,915,1412
113,DALLAS,113,2127,1132127,2313,8276,1753,6523,1537,3173,1845,4935,6115,1450,4665,1186,2186,1281,3435
367,PARKER,367,0415,3670415,7374,5142,4034,1108,188,167,583,737,3629,2932,697,112,109,365,464
143,ERATH,143,0023,1430023,3544,1011,600,411,6,5,377,381,761,486,275,5,3,246,248
67,CASS,67,020E,67020E,1543,286,209,77,0,48,10,58,256,186,70,0,47,9,56
135,ECTOR,135,0409,1350409,3249,3201,443,2758,13,47,2680,2715,2230,350,1880,11,31,1829,1857
349,NAVARRO,349,0404,3490404,7079,1780,1182,598,13,103,422,519,1339,943,396,8,71,270,337
201,HARRIS,201,1112,2011112,5330,4932,2797,2135,256,396,1388,1751,3781,2288,1493,188,259,961,1197
455,TRINITY,455,0006,4550006,9011,286,246,40,0,10,22,31,231,206,25,0,7,10,17
267,KIMBLE,267,0002,2670002,6309,788,525,263,23,2,224,225,638,461,177,22,2,143,144
201,HARRIS,201,0177,2010177,4394,3362,2012,1350,525,259,510,755,2967,1809,1158,458,223,431,647
355,NUECES,355,0087,3550087,7202,2379,424,1955,27,103,1831,1900,1814,372,1442,19,70,1346,1402
355,NUECES,355,0024,3550024,7139,1657,183,1474,10,137,1343,1458,1256,163,1093,9,97,989,1081
29,BEXAR,29,2046,292046,458,2445,396,2049,31,38,1976,2005,2026,351,1675,24,32,1609,1635
475,WARD,475,004W,475004W,9203,98,60,38,1,1,36,36,74,49,25,1,0,24,24
113,DALLAS,113,3085,1133085,2522,1051,243,808,3,108,703,794,743,228,515,2,76,441,505
459,UPSHUR,459,0012,4590012,9054,1058,896,162,3,26,99,125,787,687,100,2,26,53,79
357,OCHILTREE,357,0001,3570001,7245,2321,717,1604,14,17,1545,1554,1612,559,1053,8,5,1022,1026
29,BEXAR,29,3003,293003,607,2239,794,1445,122,127,1220,1307,1669,639,1030,92,81,856,919
479,WEBB,479,0231,4790231,9246,3319,101,3218,24,16,3169,3179,2387,70,2317,21,10,2280,2286
73,CHEROKEE,73,0037,730037,1586,891,428,463,6,134,289,422,652,364,288,3,91,164,255
365,PANOLA,365,0020,3650020,7331,543,464,79,6,18,28,45,397,335,62,5,12,20,31
29,BEXAR,29,3046,293046,650,1672,1035,637,80,38,500,529,1365,886,479,55,28,375,399
467,VAN ZANDT,467,004B,467004B,9117,2994,2335,659,38,83,421,497,2182,1786,396,27,46,242,286
439,TARRANT,439,3152,4393152,8267,71,51,20,6,3,11,14,52,39,13,2,3,7,10
469,VICTORIA,469,0020,4690020,9140,1894,1242,652,8,49,567,605,1480,1028,452,6,34,390,419
61,CAMERON,61,0068,610068,1480,6177,116,6061,16,20,6016,6020,4126,79,4047,13,6,4020,4021
141,EL PASO,141,0082,1410082,3395,3361,81,3280,44,35,3217,3240,2691,69,2622,32,27,2569,2588
439,TARRANT,439,2488,4392488,8181,4017,776,3241,857,1591,788,2331,2945,647,2298,653,1109,503,1595
259,KENDALL,259,2120,2592120,6266,2582,2088,494,21,30,374,401,2029,1693,336,16,22,250,271
439,TARRANT,439,2029,4392029,8075,3604,2027,1577,253,646,609,1232,2691,1600,1091,192,446,389,827
361,ORANGE,361,0013,3610013,7268,2726,1423,1303,56,830,376,1187,1985,1150,835,48,502,234,734
149,FAYETTE,149,0110,1490110,3587,1265,1046,219,4,31,144,170,1025,885,140,1,17,90,106
273,KLEBERG,273,0032,2730032,6332,1207,150,1057,31,175,855,1008,844,121,723,18,125,576,693
29,BEXAR,29,2131,292131,544,846,314,532,43,54,438,489,785,303,482,41,51,392,441
201,HARRIS,201,0306,2010306,4523,2092,1475,617,271,67,224,284,1718,1250,468,217,48,155,201
203,HARRISON,203,0013,2030013,5396,3338,2762,576,69,178,226,400,2404,2024,380,42,118,151,266
439,TARRANT,439,2581,4392581,8204,4123,1242,2881,371,1260,1225,2443,3054,1018,2036,273,904,823,1705
201,HARRIS,201,0114,2010114,4331,4157,2536,1621,216,452,893,1296,3013,1944,1069,143,309,553,845
283,LA SALLE,283,0003,2830003,6395,1301,118,1183,5,4,1172,1173,948,99,849,2,1,842,843
201,HARRIS,201,0012,2010012,4228,1786,373,1413,21,264,1104,1360,1259,291,968,15,172,757,926
29,BEXAR,29,3069,293069,673,4562,2008,2554,306,221,2023,2215,3623,1764,1859,201,129,1484,1607
201,HARRIS,201,1049,2011049,5267,1021,52,969,139,155,684,824,787,49,738,119,123,500,614
253,JONES,253,0001,2530001,6203,3580,1910,1670,33,252,1334,1558,2652,1547,1105,12,176,870,1032
141,EL PASO,141,0145,1410145,3458,5360,201,5159,24,94,5067,5122,4069,158,3911,10,58,3836,3883
209,HAYS,209,0225,2090225,5459,124,86,38,0,3,35,38,100,70,30,0,3,27,30
141,EL PASO,141,0042,1410042,3355,4995,132,4863,37,58,4809,4829,3528,100,3428,20,35,3386,3405
201,HARRIS,201,0946,2010946,5164,1232,320,912,131,120,670,775,942,275,667,107,80,475,547
29,BEXAR,29,2049,292049,461,5639,517,5122,120,512,4601,4989,4214,455,3759,72,318,3393,3671
113,DALLAS,113,2410,1132410,2376,3854,1279,2575,182,748,1611,2323,3096,1193,1903,141,582,1139,1698
201,HARRIS,201,0074,2010074,4291,4281,2906,1375,293,176,785,949,3531,2512,1019,235,117,546,658
465,VAL VERDE,465,0041,4650041,9100,3693,222,3471,15,29,3431,3449,2585,168,2417,7,18,2393,2407
459,UPSHUR,459,0015A,4590015A,9057,3178,2563,615,9,84,374,453,2360,1975,385,6,39,225,264
355,NUECES,355,0027,3550027,7142,1260,140,1120,5,15,1094,1105,909,124,785,3,11,766,775
29,BEXAR,29,2006,292006,418,80,9,71,0,2,69,71,71,9,62,0,2,60,62
29,BEXAR,29,2091,292091,504,5619,1487,4132,417,864,2921,3664,4744,1326,3418,359,687,2391,2994
113,DALLAS,113,2149,1132149,2333,2812,1299,1513,130,412,918,1315,2383,1163,1220,116,358,700,1049
455,TRINITY,455,0009,4550009,9014,744,650,94,4,36,44,77,574,511,63,3,26,23,47
237,JACK,237,0006,2370006,5994,1948,1499,449,25,28,342,363,1443,1166,277,11,19,204,218
209,HAYS,209,0128,2090128,5439,971,234,737,15,48,651,694,706,186,520,9,34,454,486
141,EL PASO,141,0210,1410210,3524,0,0,0,0,0,0,0,0,0,0,0,0,0,0
187,GUADALUPE,187,0124,1870124,4079,10,0,10,0,1,9,10,9,0,9,0,0,9,9
61,CAMERON,61,0071,610071,1483,7582,224,7358,26,28,7309,7321,5258,198,5060,22,15,5031,5040
141,EL PASO,141,0085,1410085,3398,4017,133,3884,24,34,3831,3843,2937,107,2830,18,17,2799,2810
201,HARRIS,201,1095,2011095,5313,5065,1873,3192,547,225,2382,2587,3914,1544,2370,446,169,1711,1874
245,JEFFERSON,245,0049,2450049,6077,1556,82,1474,125,218,1128,1342,1123,76,1047,105,168,771,937
251,JOHNSON,251,0005,2510005,6163,4060,3005,1055,74,235,613,825,2990,2313,677,45,127,374,498
201,HARRIS,201,0032,2010032,4248,6382,3359,3023,814,780,1271,1988,6076,3282,2794,779,725,1176,1852
29,BEXAR,29,3026,293026,630,1863,1408,455,49,26,337,358,1389,1079,310,30,16,225,238
113,DALLAS,113,3103,1133103,2545,4901,507,4394,80,3351,989,4272,3517,444,3073,58,2357,656,2980
473,WALLER,473,0208,4730208,9183,3032,1356,1676,25,425,1172,1564,2201,1103,1098,17,312,718,1016
201,HARRIS,201,0200,2010200,4417,5683,3863,1820,599,249,863,1093,5183,3629,1554,492,214,740,941
113,DALLAS,113,3022,1133022,2459,3716,69,3647,14,2483,1171,3606,2593,55,2538,13,1797,743,2514
265,KERR,265,0107,2650107,6289,1409,952,457,7,12,383,390,1183,836,347,7,10,276,283
363,PALO PINTO,363,0024,3630024,7311,436,299,137,11,22,94,115,328,242,86,7,14,56,70
141,EL PASO,141,0128,1410128,3441,8230,867,7363,193,620,6651,7129,5351,618,4733,112,386,4235,4588
439,TARRANT,439,1631,4391631,8035,477,140,337,13,265,62,320,358,127,231,9,168,50,218
199,HARDIN,199,0008,1990008,4205,1072,962,110,5,8,56,60,862,790,72,3,2,31,33
463,UVALDE,463,0006,4630006,9074,213,154,59,1,1,55,55,186,142,44,0,1,41,41
141,EL PASO,141,0039,1410039,3352,1824,184,1640,26,110,1514,1599,1521,169,1352,17,70,1259,1318
439,TARRANT,439,2268,4392268,8118,2990,799,2191,391,686,1119,1777,2252,688,1564,337,450,758,1202
29,BEXAR,29,1042,291042,292,1667,55,1612,5,26,1595,1604,1277,42,1235,1,17,1224,1230
201,HARRIS,201,1052,2011052,5270,0,0,0,0,0,0,0,0,0,0,0,0,0,0
303,LUBBOCK,303,0005,3030005,6521,1932,448,1484,8,292,1172,1461,1728,430,1298,8,274,1012,1284
29,BEXAR,29,2174,292174,587,3566,1232,2334,300,269,1791,2016,2856,1111,1745,230,178,1340,1493
61,CAMERON,61,0088,610088,1500,6214,212,6002,58,52,5905,5940,3950,144,3806,35,25,3745,3765
141,EL PASO,141,0102,1410102,3415,4389,352,4037,57,176,3813,3946,3315,307,3008,42,126,2828,2935
113,DALLAS,113,3800,1133800,2628,7245,248,6997,52,5679,1302,6914,5152,215,4937,43,4053,840,4875
201,HARRIS,201,0326,2010326,4543,2135,184,1951,10,35,1896,1923,1553,173,1380,6,20,1344,1363
139,ELLIS,139,1055,1391055,3309,3731,2512,1219,64,547,506,1032,2890,2046,844,43,413,317,721
141,EL PASO,141,0059,1410059,3372,4644,558,4086,62,240,3826,3999,3480,474,3006,44,169,2790,2927
201,HARRIS,201,1006,2011006,5224,2698,125,2573,215,2013,337,2330,1955,105,1850,184,1430,227,1644
201,HARRIS,201,0220,2010220,4437,8597,1922,6675,83,214,6378,6530,5868,1642,4226,51,121,4015,4106
201,HARRIS,201,1069,2011069,5287,0,0,0,0,0,0,0,0,0,0,0,0,0,0
29,BEXAR,29,3150,293150,756,55,5,50,7,2,45,47,35,4,31,5,0,29,29
113,DALLAS,113,4009,1134009,2671,4230,207,4023,25,86,3908,3979,3085,174,2911,10,59,2829,2882
439,TARRANT,439,2419,4392419,8161,0,0,0,0,0,0,0,0,0,0,0,0,0,0
257,KAUFMAN,257,0025,2570025,6246,2032,1114,918,15,285,562,843,1480,869,611,8,199,356,554
113,DALLAS,113,3202,1133202,2565,3359,567,2792,72,1545,1184,2690,2572,513,2059,63,1200,786,1967
439,TARRANT,439,3214,4393214,8287,4911,2694,2217,521,535,1025,1527,3920,2277,1643,390,378,752,1115
439,TARRANT,439,3667,4393667,8393,180,104,76,36,24,16,34,145,82,63,32,20,10,26
277,LAMAR,277,002E,277002E,6352,796,707,89,0,19,40,59,620,558,62,0,10,26,36
251,JOHNSON,251,0024,2510024,6183,5728,3676,2052,72,304,1465,1750,4253,2894,1359,47,184,947,1122
29,BEXAR,29,1085,291085,335,4158,439,3719,57,202,3484,3639,2934,390,2544,47,134,2360,2482
113,DALLAS,113,3065,1133065,2502,3826,73,3753,14,2251,1501,3731,2773,65,2708,11,1777,927,2694
479,WEBB,479,0128,4790128,9226,4179,59,4120,8,20,4100,4107,2681,32,2649,5,19,2636,2643
55,CALDWELL,55,0104,550104,1374,1007,497,510,10,54,435,485,682,365,317,7,16,280,294
439,TARRANT,439,1472,4391472,7992,419,328,91,25,18,46,64,396,319,77,20,15,42,57
201,HARRIS,201,0157,2010157,4374,4367,136,4231,39,2128,2057,4153,3184,115,3069,26,1712,1336,3026
67,CASS,67,0001,670001,1526,4393,3208,1185,27,735,257,986,3574,2700,874,20,557,167,720
245,JEFFERSON,245,0092,2450092,6120,1681,1041,640,41,372,203,568,1337,841,496,36,294,149,439
29,BEXAR,29,1147,291147,398,4408,880,3528,251,460,2882,3266,3128,667,2461,177,321,1969,2249
355,NUECES,355,0044,3550044,7159,2089,97,1992,10,35,1962,1986,1564,86,1478,1,22,1456,1473
201,HARRIS,201,0094,2010094,4311,1978,74,1904,86,50,1755,1799,1358,71,1287,65,40,1173,1208
113,DALLAS,113,1749,1131749,2207,6954,2040,4914,1807,1500,1554,3008,5455,1751,3704,1460,1089,1086,2152
29,BEXAR,29,3089,293089,693,4720,2732,1988,167,168,1595,1732,3606,2197,1409,116,122,1118,1224
287,LEE,287,0203,2870203,6415,578,461,117,3,18,83,100,455,376,79,2,18,51,68
355,NUECES,355,0070,3550070,7185,5698,1036,4662,181,404,4100,4410,4109,864,3245,126,253,2857,3077
439,TARRANT,439,2660,4392660,8224,743,181,562,27,40,493,531,541,156,385,20,27,332,359
61,CAMERON,61,0025,610025,1437,1819,116,1703,2,6,1695,1696,1307,89,1218,0,2,1214,1215
479,WEBB,479,0407,4790407,9289,1284,23,1261,6,1,1244,1244,923,19,904,1,1,898,898
439,TARRANT,439,1257,4391257,7929,3649,857,2792,127,999,1685,2625,2587,725,1862,84,709,1061,1740
201,HARRIS,201,0389,2010389,4606,4236,1328,2908,1383,765,755,1513,4131,1326,2805,1378,694,726,1417
277,LAMAR,277,003D,277003D,6355,1309,1145,164,1,25,49,74,1076,954,122,1,19,29,48
113,DALLAS,113,3088,1133088,2525,191,21,170,0,59,114,170,117,19,98,0,38,63,98
29,BEXAR,29,3006,293006,610,1342,603,739,52,34,625,654,1086,534,552,39,20,467,485
201,HARRIS,201,1158,2011158,5376,0,0,0,0,0,0,0,0,0,0,0,0,0,0
363,PALO PINTO,363,0002,3630002,7291,16,16,0,0,0,0,0,16,16,0,0,0,0,0
73,CHEROKEE,73,0043,730043,1589,2913,1038,1875,15,501,1316,1796,2064,854,1210,6,350,822,1168
85,COLLIN,85,0247,850247,1876,2873,2039,834,300,161,255,415,1982,1457,525,182,99,160,258
39,BRAZORIA,39,0039,390039,1152,6573,2997,3576,149,379,2935,3262,4832,2374,2458,81,250,2005,2233
449,TITUS,449,0012,4490012,8663,487,278,209,3,14,182,193,369,228,141,3,9,120,126
317,MARTIN,317,003A,317003A,6748,193,137,56,0,3,52,53,143,108,35,0,1,31,32
429,STEPHENS,429,0002,4290002,7813,2084,1556,528,20,47,411,450,1628,1295,333,11,27,254,277
121,DENTON,121,3143,1213143,3067,2465,1518,947,518,116,263,368,1730,1117,613,325,79,180,254
439,TARRANT,439,4572,4394572,8557,63,2,61,1,26,34,59,41,2,39,0,15,24,39
441,TAYLOR,441,0304,4410304,8620,5675,3481,2194,483,601,1023,1561,4640,2992,1648,360,436,735,1136
453,TRAVIS,453,0124,4530124,8726,6441,448,5993,94,1319,4626,5863,4402,406,3996,69,1001,2941,3895
121,DENTON,121,2080,1212080,3004,5170,1899,3271,2114,570,530,1074,3405,1360,2045,1269,391,336,715
329,MIDLAND,329,0103,3290103,6811,6997,3220,3777,305,588,2743,3257,5111,2600,2511,198,377,1792,2151
201,HARRIS,201,0596,2010596,4813,7848,1965,5883,208,2369,3274,5539,5580,1649,3931,152,1530,2193,3676
15,AUSTIN,15,0415,150415,130,2324,1229,1095,13,302,765,1044,1763,1004,759,9,200,528,714
439,TARRANT,439,1084,4391084,7876,0,0,0,0,0,0,0,0,0,0,0,0,0,0
3,ANDREWS,3,0002,30002,24,4589,2444,2145,56,82,1918,1983,3186,1832,1354,34,46,1203,1242
37,BOWIE,37,002C,37002C,1089,2512,376,2136,11,1705,408,2096,1813,314,1499,4,1200,278,1474
93,COMANCHE,93,0007,930007,1939,596,360,236,1,4,225,228,471,314,157,1,3,148,150
113,DALLAS,113,4667,1134667,2898,0,0,0,0,0,0,0,0,0,0,0,0,0,0
339,MONTGOMERY,339,0024,3390024,6917,4983,2871,2112,210,738,1048,1755,3755,2308,1447,141,523,690,1200
49,BROWN,49,0109,490109,1321,394,341,53,6,10,32,40,320,285,35,6,5,17,22
27,BELL,27,0105,270105,193,2732,2019,713,48,42,531,561,1958,1501,457,35,24,318,336
107,CROSBY,107,0027,1070027,2002,1371,655,716,9,53,675,699,1032,550,482,4,26,451,466
121,DENTON,121,4205A,1214205A,3130,4538,3323,1215,476,120,490,608,3319,2531,788,306,87,320,406
113,DALLAS,113,1092,1131092,2065,13127,607,12520,65,4906,7603,12388,8964,508,8456,55,3433,4973,8346
167,GALVESTON,167,0230,1670230,3874,5357,1592,3765,34,2066,1665,3655,3998,1323,2675,21,1496,1135,2589
41,BRAZOS,41,0067,410067,1258,759,276,483,8,34,437,470,491,230,261,5,21,230,251
201,HARRIS,201,0721,2010721,4939,3816,2444,1372,583,129,600,719,2955,1989,966,432,84,397,474
29,BEXAR,29,1006,291006,256,4005,190,3815,27,45,3760,3776,3089,153,2936,13,26,2894,2908
161,FREESTONE,161,0007B,1610007B,3811,95,68,27,2,20,7,26,81,57,24,2,18,5,23
187,GUADALUPE,187,0222,1870222,4106,24,3,21,0,0,21,21,16,0,16,0,0,16,16
201,HARRIS,201,0953,2010953,5171,1414,344,1070,20,59,980,1033,1092,305,787,16,44,712,755
29,BEXAR,29,4215,294215,1026,375,105,270,0,0,259,259,284,96,188,0,0,179,179
339,MONTGOMERY,339,0080B,3390080B,6980,200,115,85,13,34,35,68,143,83,60,5,26,28,53
453,TRAVIS,453,0206,4530206,8789,3069,2253,816,272,108,388,484,2738,2027,711,257,85,328,402
113,DALLAS,113,4024,1134024,2686,4604,232,4372,310,2905,1176,4021,3035,203,2832,266,1772,789,2537
121,DENTON,121,1011,1211011,2935,2175,1813,362,35,35,222,249,1671,1432,239,21,17,138,155
121,DENTON,121,2094,1212094,3018,6135,1638,4497,2853,905,689,1542,4564,1366,3198,1955,688,491,1150
139,ELLIS,139,1013,1391013,3267,3310,1316,1994,13,194,1740,1922,2502,1118,1384,5,139,1194,1326
387,RED RIVER,387,13-1,38713-1,7512,808,672,136,2,80,29,109,611,512,99,1,55,20,75
401,RUSK,401,0114,4010114,7595,2281,1575,706,15,339,268,601,1725,1223,502,12,264,156,418
439,TARRANT,439,4711,4394711,8591,4222,1497,2725,1011,556,1091,1619,3049,1183,1866,738,355,717,1060
439,TARRANT,439,1005,4391005,7844,1471,65,1406,20,791,595,1378,1037,56,981,17,578,381,955
453,TRAVIS,453,0381D,4530381D,8923,71,34,37,14,4,19,23,61,31,30,11,2,17,19
453,TRAVIS,453,0272,4530272,8840,7177,4752,2425,1324,197,745,923,4828,3351,1477,832,102,436,534
181,GRAYSON,181,0309,1810309,4014,1590,929,661,29,36,466,499,1131,699,432,13,16,311,327
201,HARRIS,201,0046,2010046,4263,5033,471,4562,76,949,3531,4453,3810,425,3385,62,542,2767,3301
201,HARRIS,201,0378,2010378,4595,4114,2218,1896,200,430,1206,1591,3069,1752,1317,150,282,823,1086
201,HARRIS,201,0129,2010129,4346,4423,3011,1412,351,357,649,989,3415,2322,1093,266,304,472,770
301,LOVING,301,0004,3010004,6516,9,7,2,1,1,0,1,2,1,1,1,1,0,1
361,ORANGE,361,0008,3610008,7263,3711,2853,858,88,498,209,693,2760,2231,529,58,277,138,406
29,BEXAR,29,1122B,291122B,373,186,43,143,13,65,67,131,142,39,103,12,52,41,92
29,BEXAR,29,3101,293101,705,3644,1576,2068,282,220,1541,1736,2880,1340,1540,203,173,1140,1296
113,DALLAS,113,2043,1132043,2248,2908,2232,676,221,115,310,405,2125,1669,456,149,80,204,274
113,DALLAS,113,3304,1133304,2580,5361,1893,3468,436,1129,1810,2898,4124,1628,2496,352,817,1225,2025
141,EL PASO,141,0060,1410060,3373,3392,1019,2373,138,352,1914,2201,2772,922,1850,107,280,1459,1702
147,FANNIN,147,0007,1470007,3576,707,570,137,1,14,83,97,562,471,91,1,8,51,59
355,NUECES,355,0088,3550088,7203,3723,1089,2634,107,174,2319,2476,2838,928,1910,68,118,1688,1797
439,TARRANT,439,4478,4394478,8531,0,0,0,0,0,0,0,0,0,0,0,0,0,0
439,TARRANT,439,1153,4391153,7904,3099,135,2964,33,1530,1415,2918,2254,115,2139,23,1161,956,2105
439,TARRANT,439,2727,4392727,8236,804,564,240,75,72,83,153,629,445,184,59,59,56,115
439,TARRANT,439,2556,4392556,8199,2526,1769,757,153,228,319,544,1986,1451,535,119,166,210,374
491,WILLIAMSON,491,0429,4910429,9527,4152,1691,2461,72,441,1900,2290,3112,1431,1681,45,296,1297,1567
157,FORT BEND,157,3047,1573047,3705,1143,348,795,641,63,86,146,895,290,605,487,44,74,118
167,GALVESTON,167,0429,1670429,3908,3545,1793,1752,303,552,892,1399,2548,1372,1176,210,365,579,920
201,HARRIS,201,0815,2010815,5033,0,0,0,0,0,0,0,0,0,0,0,0,0,0
201,HARRIS,201,0484,2010484,4701,7458,3091,4367,1087,1490,1767,3165,5873,2661,3212,812,1071,1245,2284
303,LUBBOCK,303,0067,3030067,6576,3802,1841,1961,78,275,1532,1786,2899,1535,1364,54,177,1063,1230
339,MONTGOMERY,339,0015,3390015,6908,5053,3726,1327,158,202,823,997,3959,3027,932,112,125,564,679
45,BRISCOE,45,0004,450004,1312,365,311,54,2,3,49,51,305,264,41,2,1,37,38
85,COLLIN,85,0015,850015,1644,3499,1359,2140,532,385,1186,1556,2726,1179,1547,449,263,802,1059
113,DALLAS,113,3922,1133922,2640,151,2,149,3,57,84,141,105,0,105,3,48,50,98
121,DENTON,121,1048,1211048,2972,6361,2400,3961,390,2502,1064,3450,4484,1876,2608,288,1585,679,2221
201,HARRIS,201,0092,2010092,4309,2945,2071,874,259,103,447,533,2291,1693,598,190,71,284,347
201,HARRIS,201,0424,2010424,4641,2282,859,1423,225,266,909,1166,1726,724,1002,166,179,635,808
215,HIDALGO,215,0085,2150085,5637,6984,188,6796,20,29,6752,6767,4723,137,4586,14,23,4554,4565
231,HUNT,231,0431,2310431,5969,794,452,342,2,69,245,312,613,361,252,2,53,176,229
443,TERRELL,443,0003,4430003,8637,197,112,85,5,5,73,75,157,93,64,0,2,57,59
453,TRAVIS,453,0436,4530436,8969,3089,1765,1324,134,145,959,1078,2656,1577,1079,106,113,789,882
453,TRAVIS,453,0343B,4530343B,8886,71,43,28,17,0,12,12,47,29,18,13,0,5,5
477,WASHINGTON,477,0406,4770406,9218,3577,1854,1723,74,959,633,1555,2999,1626,1373,56,818,448,1243
105,CROCKETT,105,0003,1050003,1999,762,371,391,1,6,361,366,602,314,288,0,5,263,267
113,DALLAS,113,2147,1132147,2331,2571,2006,565,105,71,326,384,2058,1650,408,70,58,221,273
141,EL PASO,141,0014,1410014,3327,6038,1577,4461,599,320,3526,3803,4269,1179,3090,415,214,2443,2634
157,FORT BEND,157,2055,1572055,3659,1662,22,1640,10,1114,530,1628,1282,18,1264,4,899,370,1256
157,FORT BEND,157,1057,1571057,3622,8892,3893,4999,1080,1980,1828,3754,6255,2887,3368,743,1318,1201,2496
173,GLASSCOCK,173,0002,1730002,3954,283,181,102,1,6,100,101,213,135,78,1,4,77,78
487,WILBARGER,487,0020,4870020,9364,2680,1190,1490,61,206,1173,1360,1945,968,977,32,133,763,891
497,WISE,497,0008,4970008,9573,2421,1737,684,27,36,527,559,1886,1403,483,12,25,365,387
501,YOAKUM,501,0303,5010303,9610,974,334,640,3,8,623,629,673,228,445,1,3,434,435
201,HARRIS,201,0732,2010732,4950,3618,1619,1999,508,260,1192,1421,2779,1323,1456,387,192,834,1014
201,HARRIS,201,1064,2011064,5282,4776,575,4201,2317,638,1285,1898,3443,414,3029,1681,478,897,1364
439,TARRANT,439,1339,4391339,7950,4710,2790,1920,178,890,795,1622,3914,2459,1455,153,658,569,1200
439,TARRANT,439,3196,4393196,8282,2739,2085,654,144,104,334,430,2226,1764,462,104,74,229,298
457,TYLER,457,0007,4570007,9032,711,636,75,2,14,42,55,560,506,54,0,9,30,39
479,WEBB,479,0359,4790359,9278,7156,309,6847,80,70,6704,6749,5319,251,5068,79,52,4937,4976
29,BEXAR,29,1020,291020,270,2933,294,2639,24,45,2575,2596,2200,266,1934,18,32,1880,1895
29,BEXAR,29,2106,292106,519,1479,242,1237,32,120,1090,1188,977,192,785,21,64,693,750
75,CHILDRESS,75,0401,750401,1598,1358,961,397,30,43,301,340,1016,739,277,24,27,205,230
85,COLLIN,85,0218,850218,1847,6414,2516,3898,2820,517,450,951,4483,1897,2586,1835,374,288,657
113,DALLAS,113,2911,1132911,2434,988,196,792,546,91,144,232,673,163,510,341,69,92,161
113,DALLAS,113,1727,1131727,2185,608,129,479,10,27,442,466,432,112,320,5,13,303,313
491,WILLIAMSON,491,0206,4910206,9424,3133,2440,693,61,71,451,517,2304,1844,460,38,43,296,336
209,HAYS,209,0115,2090115,5434,3851,1443,2408,151,423,1843,2215,3099,1276,1823,117,329,1378,1676
215,HIDALGO,215,0131,2150131,5683,39,2,37,0,1,36,37,32,2,30,0,0,30,30
321,MATAGORDA,321,0012,3210012,6762,552,249,303,8,6,274,279,376,189,187,5,2,166,168
339,MONTGOMERY,339,0111,3390111,7011,4289,2088,2201,20,81,1985,2049,3008,1610,1398,16,40,1238,1269
439,TARRANT,439,2180,4392180,8096,5167,587,4580,265,2068,2297,4286,3546,466,3080,197,1422,1493,2864
451,TOM GREEN,451,0137,4510137,8677,4723,1648,3075,75,233,2767,2944,3703,1428,2275,50,147,2036,2168
141,EL PASO,141,0206,1410206,3519,1958,31,1927,0,7,1918,1918,1396,19,1377,0,3,1375,1375
141,EL PASO,141,0200,1410200,3513,834,78,756,13,47,698,740,549,52,497,10,28,460,484
157,FORT BEND,157,4039,1574039,3762,1357,426,931,545,185,196,371,1056,351,705,432,137,138,268
157,FORT BEND,157,4072,1574072,3768,125,70,55,2,1,52,53,109,69,40,2,0,38,38
201,HARRIS,201,0630,2010630,4847,9022,406,8616,402,6398,1968,8197,6425,361,6064,309,4507,1304,5718
201,HARRIS,201,0878,2010878,5096,2818,1694,1124,275,286,534,798,2075,1317,758,179,181,369,541
29,BEXAR,29,4146,294146,957,80,20,60,2,16,43,55,62,19,43,2,11,27,38
61,CAMERON,61,0086,610086,1498,3978,135,3843,40,31,3771,3790,2853,107,2746,32,24,2686,2705
113,DALLAS,113,20A8,11320A8,2285,145,25,120,9,51,54,104,117,22,95,9,44,35,79
113,DALLAS,113,4533,1134533,2826,2196,273,1923,142,278,1489,1756,1562,234,1328,106,188,1015,1200
113,DALLAS,113,4539,1134539,2832,0,0,0,0,0,0,0,0,0,0,0,0,0,0
121,DENTON,121,4196,1214196,3121,5903,4403,1500,282,269,771,1012,3833,2922,911,170,154,456,599
377,PRESIDIO,377,0007,3770007,7449,1583,666,917,20,28,860,883,1322,604,718,13,11,680,689
439,TARRANT,439,1460,4391460,7990,7568,1137,6431,233,4658,1531,6091,5579,1023,4556,178,3289,1065,4297
453,TRAVIS,453,0200,4530200,8783,4754,3553,1201,366,162,580,724,4283,3246,1037,320,125,505,616
453,TRAVIS,453,0186,4530186,8777,5857,1541,4316,1153,1415,1825,3114,4567,1359,3208,949,930,1342,2214
483,WHEELER,483,0201,4830201,9318,1227,795,432,5,11,395,401,934,665,269,2,4,243,244
485,WICHITA,485,0104,4850104,9324,5310,3580,1730,230,684,668,1286,4443,3045,1398,195,559,521,1023
189,HALE,189,0317,1890317,4160,222,139,83,0,3,74,77,166,115,51,0,0,47,47
201,HARRIS,201,0238,2010238,4455,3012,32,2980,14,1449,1522,2943,2247,25,2222,9,1190,1023,2193
201,HARRIS,201,0778,2010778,4996,799,124,675,24,243,412,648,559,87,472,22,165,290,449
201,HARRIS,201,0232,2010232,4449,2719,1648,1071,538,142,361,495,1945,1241,704,365,91,219,308
215,HIDALGO,215,0231,2150231,5783,981,109,872,37,7,828,828,689,100,589,28,5,554,554
273,KLEBERG,273,0012,2730012,6324,2891,1076,1815,96,39,1638,1665,2187,871,1316,78,31,1163,1190
27,BELL,27,0304,270304,224,506,311,195,11,37,146,172,399,277,122,9,27,89,107
29,BEXAR,29,3205,293205,811,0,0,0,0,0,0,0,0,0,0,0,0,0,0
35,BOSQUE,35,0007,350007,1060,829,697,132,11,7,85,92,683,595,88,6,7,54,61
43,BREWSTER,43,0006,430006,1306,756,498,258,7,11,196,206,674,471,203,7,10,143,153
89,COLORADO,89,0305,890305,1893,2401,1631,770,13,223,512,719,1947,1406,541,12,160,342,499
113,DALLAS,113,1323,1131323,2139,0,0,0,0,0,0,0,0,0,0,0,0,0,0
255,KARNES,255,0015,2550015,6221,237,66,171,4,5,158,163,187,59,128,3,4,117,121
293,LIMESTONE,293,0206,2930206,6470,554,414,140,2,59,68,126,441,348,93,2,39,45,84
349,NAVARRO,349,0107,3490107,7057,3258,1189,2069,10,156,1864,2006,2211,903,1308,8,103,1156,1258
363,PALO PINTO,363,0015,3630015,7303,1143,964,179,11,14,102,114,912,784,128,9,11,68,77
439,TARRANT,439,3647,4393647,8385,6657,3912,2745,793,809,997,1762,4990,3025,1965,574,564,720,1258
491,WILLIAMSON,491,0318,4910318,9470,532,221,311,211,34,65,95,384,176,208,135,26,43,66
135,ECTOR,135,0204,1350204,3221,5437,2649,2788,99,282,2291,2530,3992,2106,1886,85,188,1511,1676
185,GRIMES,185,0014,1850014,4060,2270,1471,799,17,64,633,694,1736,1221,515,11,40,396,435
201,HARRIS,201,0924,2010924,5142,0,0,0,0,0,0,0,0,0,0,0,0,0,0
201,HARRIS,201,0675B,2010675B,4893,0,0,0,0,0,0,0,0,0,0,0,0,0,0
203,HARRISON,203,0005,2030005,5388,1095,851,244,8,146,51,194,961,768,193,6,117,30,146
231,HUNT,231,215A,231215A,5975,8475,5330,3145,197,565,2097,2632,5889,3946,1943,119,351,1260,1604
15,AUSTIN,15,0309,150309,124,860,679,181,4,21,130,143,674,552,122,1,15,86,98
29,BEXAR,29,3061,293061,665,3682,1065,2617,138,384,2102,2448,2848,952,1896,109,246,1520,1753
29,BEXAR,29,4100,294100,911,1368,408,960,140,246,574,801,1007,330,677,95,176,391,559
41,BRAZOS,41,0015,410015,1206,2478,1937,541,58,145,272,403,2153,1724,429,42,105,216,313
61,CAMERON,61,0040,610040,1452,4865,585,4280,29,24,4228,4236,3548,554,2994,20,8,2956,2960
85,COLLIN,85,0118,850118,1747,6370,3967,2403,1179,345,708,1029,4711,3088,1623,790,242,463,691
417,SHACKELFORD,417,0405,4170405,7698,274,240,34,6,3,26,29,218,193,25,4,0,20,20
503,YOUNG,503,0007,5030007,9616,166,139,27,0,2,17,18,124,107,17,0,1,7,8
213,HENDERSON,213,003M,213003M,5534,2331,1839,492,22,64,335,396,1815,1486,329,12,48,210,255
219,HOCKLEY,219,0021,2190021,5829,3783,1344,2439,16,154,2222,2352,2754,1089,1665,8,103,1503,1595
245,JEFFERSON,245,0047,2450047,6075,3377,464,2913,165,704,2035,2725,2374,382,1992,140,500,1341,1829
277,LAMAR,277,3C7G,2773C7G,6370,3500,2080,1420,79,856,345,1176,2702,1696,1006,65,606,216,811
305,LYNN,305,0001,3050001,6616,1239,393,846,5,69,731,797,878,315,563,2,44,485,529
355,NUECES,355,0042,3550042,7157,545,326,219,13,21,182,199,457,276,181,9,19,150,166
103,CRANE,103,0001,1030001,1993,1178,451,727,5,9,701,707,870,395,475,2,4,460,462
113,DALLAS,113,3097,1133097,2534,206,10,196,1,125,71,196,146,10,136,0,99,37,136
121,DENTON,121,3151,1213151,3075,4717,2843,1874,938,328,497,810,3420,2180,1240,623,235,324,551
199,HARDIN,199,0009,1990009,4206,3970,3061,909,60,591,185,765,3062,2407,655,49,415,126,536
201,HARRIS,201,1070,2011070,5288,733,36,697,1,32,671,691,513,29,484,0,21,465,480
201,HARRIS,201,0530,2010530,4747,2549,85,2464,20,73,2392,2439,1971,73,1898,10,52,1845,1881
29,BEXAR,29,4126,294126,937,3263,1349,1914,158,587,1169,1687,2311,1058,1253,111,389,722,1089
29,BEXAR,29,2027,292027,439,2028,312,1716,44,83,1589,1655,1672,288,1384,39,55,1277,1326
61,CAMERON,61,0023,610023,1435,566,63,503,4,2,493,495,399,55,344,1,2,336,338
77,CLAY,77,0008,770008,1601,1245,1088,157,17,14,83,95,958,854,104,13,8,43,51
91,COMAL,91,0408,910408,1933,4129,3179,950,84,56,684,731,3483,2759,724,60,42,510,547
113,DALLAS,113,2904,1132904,2431,50,6,44,7,15,15,27,38,6,32,7,5,11,15
465,VAL VERDE,465,0030,4650030,9095,3712,622,3090,67,131,2888,2980,2722,536,2186,46,77,2033,2098
497,WISE,497,0030,4970030,9593,3029,2120,909,71,127,612,729,2192,1599,593,47,84,384,463
241,JASPER,241,0009,2410009,6012,2718,2469,249,13,88,71,159,2113,1933,180,8,64,57,121
251,JOHNSON,251,0019,2510019,6178,6209,4630,1579,79,265,1006,1248,4758,3729,1029,60,175,610,778
299,LLANO,299,0205,2990205,6510,958,834,124,10,11,56,67,819,732,87,8,1,39,40
309,MCLENNAN,309,0044,3090044,6676,5660,4284,1376,138,376,759,1109,3984,3137,847,94,227,437,654
339,MONTGOMERY,339,0108,3390108,7008,5062,3006,2056,675,388,831,1200,3586,2158,1428,451,277,588,851
439,TARRANT,439,4737A,4394737A,8597,2230,1157,1073,142,316,592,878,1631,916,715,102,201,395,583
113,DALLAS,113,3325,1133325,2597,3322,478,2844,204,1787,877,2616,2260,376,1884,159,1144,570,1693
113,DALLAS,113,1139,1131139,2099,36,9,27,11,4,8,10,28,7,21,9,2,4,6
201,HARRIS,201,0301,2010301,4518,6246,763,5483,17,111,5384,5452,4461,646,3815,13,78,3739,3793
201,HARRIS,201,0798,2010798,5016,889,211,678,18,67,591,648,689,203,486,12,50,421,466
201,HARRIS,201,0135,2010135,4352,5096,3395,1701,533,390,662,1040,4458,3025,1433,438,333,549,874
209,HAYS,209,0451,2090451,5514,2307,1773,534,123,58,296,349,1543,1237,306,61,28,168,195
9,ARCHER,9,0010,90010,84,1088,964,124,15,10,75,84,821,736,85,10,9,49,57
29,BEXAR,29,2004,292004,416,6181,304,5877,68,314,5529,5797,4438,220,4218,38,219,3963,4166
29,BEXAR,29,2169,292169,582,2069,619,1450,78,84,1274,1335,1691,573,1118,61,44,991,1024
37,BOWIE,37,0021,370021,1080,407,299,108,1,64,17,81,330,249,81,0,50,13,63
73,CHEROKEE,73,0026,730026,1578,1631,875,756,14,419,300,719,1189,667,522,8,311,181,492
113,DALLAS,113,1103,1131103,2076,1310,95,1215,9,119,1097,1209,953,87,866,3,95,774,863
463,UVALDE,463,0004,4630004,9072,421,291,130,2,0,118,118,366,263,103,2,0,91,91
479,WEBB,479,0176B,4790176B,9238,135,0,135,1,0,134,134,70,0,70,1,0,69,69
345,MOTLEY,345,0005,3450005,7031,154,116,38,7,4,27,30,119,92,27,5,2,17,19
391,REFUGIO,391,001A,391001A,7529,801,245,556,10,50,498,540,638,200,438,8,39,389,424
439,TARRANT,439,4634,4394634,8574,1848,1294,554,193,120,213,331,1801,1269,532,188,110,207,317
439,TARRANT,439,2030,4392030,8076,7433,1667,5766,621,3563,1643,5067,4842,1216,3626,489,2101,1057,3084
439,TARRANT,439,2745,4392745,8242,248,188,60,30,11,18,29,223,167,56,29,10,16,26
453,TRAVIS,453,0141,4530141,8740,7876,2236,5640,1507,1524,2566,4012,6091,1943,4148,1145,1114,1825,2894
201,HARRIS,201,1153,2011153,5371,0,0,0,0,0,0,0,0,0,0,0,0,0,0
213,HENDERSON,213,004B,213004B,5537,2750,1755,995,30,355,566,888,2150,1469,681,28,228,371,590
223,HOPKINS,223,0020,2230020,5869,883,741,142,1,16,89,105,688,590,98,1,9,53,62
245,JEFFERSON,245,0007,2450007,6035,2544,900,1644,33,1032,558,1547,1959,781,1178,23,758,378,1104
277,LAMAR,277,1A5A,2771A5A,6367,1496,790,706,43,370,245,606,1102,647,455,26,242,145,387
303,LUBBOCK,303,0019,3030019,6533,3296,445,2851,18,370,2480,2798,2419,387,2032,13,264,1743,1984
27,BELL,27,0307,270307,227,7247,1717,5530,70,2394,3061,5345,5309,1434,3875,32,1800,1973,3726
29,BEXAR,29,2146,292146,559,255,27,228,5,17,204,218,177,25,152,5,12,132,143
41,BRAZOS,41,0032,410032,1223,1140,700,440,32,83,314,385,920,614,306,22,56,218,263
85,COLLIN,85,0184,850184,1813,5903,2519,3384,1468,911,771,1653,5009,2267,2742,1169,734,645,1364
113,DALLAS,113,4514,1134514,2809,3591,795,2796,49,346,2361,2674,2553,686,1867,35,225,1562,1778
121,DENTON,121,4218,1214218,3144,636,456,180,38,33,101,129,465,348,117,23,27,59,81
477,WASHINGTON,477,0311,4770311,9215,1598,1263,335,24,122,140,257,1308,1055,253,22,98,88,184
355,NUECES,355,0107,3550107,7223,6814,3197,3617,161,132,3253,3349,4933,2452,2481,96,79,2224,2293
369,PARMER,369,0401,3690401,7386,559,369,190,1,5,180,182,409,275,134,1,4,129,131
439,TARRANT,439,1704,4391704,8050,3982,2548,1434,162,387,761,1124,2720,1801,919,112,252,466,706
439,TARRANT,439,3626,4393626,8382,1031,828,203,66,46,64,108,898,746,152,45,34,52,85
439,TARRANT,439,2655,4392655,8219,2343,783,1560,102,691,764,1429,1915,730,1185,80,535,547,1069
453,TRAVIS,453,0341,4530341,8883,3601,2196,1405,158,203,945,1124,2845,1794,1051,116,151,689,832
141,EL PASO,141,0160,1410160,3473,4944,114,4830,35,60,4763,4794,3644,93,3551,21,39,3503,3529
161,FREESTONE,161,0005A,1610005A,3805,3728,2244,1484,16,640,780,1408,2814,1829,985,7,471,458,926
189,HALE,189,0103,1890103,4140,1215,159,1056,3,63,991,1043,864,123,741,2,30,703,729
201,HARRIS,201,0587,2010587,4804,7025,950,6075,298,2840,2956,5693,4981,813,4168,209,1958,1956,3872
201,HARRIS,201,0918,2010918,5136,38,14,24,0,21,4,24,38,14,24,0,21,4,24
281,LAMPASAS,281,0007,2810007,6390,1303,772,531,10,34,437,469,976,641,335,8,15,274,287
27,BELL,27,0117,270117,204,0,0,0,0,0,0,0,0,0,0,0,0,0,0
29,BEXAR,29,3139C,293139C,745,202,89,113,16,13,87,100,144,67,77,8,13,57,70
61,CAMERON,61,0046,610046,1458,7171,365,6806,44,30,6728,6741,5110,312,4798,30,21,4741,4750
85,COLLIN,85,0161,850161,1790,443,316,127,16,18,74,90,353,267,86,10,11,55,64
113,DALLAS,113,3017,1133017,2454,1320,189,1131,6,886,249,1117,1124,186,938,5,747,190,926
141,EL PASO,141,0137,1410137,3450,2790,75,2715,24,133,2577,2686,2214,53,2161,21,108,2050,2146
491,WILLIAMSON,491,0276,4910276,9450,2526,1745,781,196,97,415,503,1761,1248,513,135,68,257,318
333,MILLS,333,0001,3330001,6868,1111,850,261,5,8,224,232,896,716,180,4,7,150,157
355,NUECES,355,0085,3550085,7200,1010,65,945,5,25,927,940,753,50,703,5,17,686,698
373,POLK,373,0013,3730013,7409,479,425,54,0,4,20,24,388,349,39,0,4,12,16
423,SMITH,423,0020,4230020,7741,1726,249,1477,25,304,1142,1435,1233,211,1022,16,200,792,989
439,TARRANT,439,1064,4391064,7864,0,0,0,0,0,0,0,0,0,0,0,0,0,0
439,TARRANT,439,3725,4393725,8405,3806,2412,1394,306,282,736,1000,2957,1973,984,225,203,491,683
189,HALE,189,0407,1890407,4163,2048,1090,958,30,87,824,895,1592,943,649,24,50,553,596
201,HARRIS,201,0278,2010278,4495,6757,768,5989,43,191,5787,5932,4803,671,4132,31,136,3982,4086
201,HARRIS,201,0941,2010941,5159,2447,1070,1377,208,323,826,1120,1978,937,1041,175,246,587,816
249,JIM WELLS,249,0018,2490018,6155,677,63,614,1,19,601,609,489,51,438,0,10,428,434
253,JONES,253,0002,2530002,6204,3942,2389,1553,41,239,1192,1411,3099,2005,1094,33,162,842,998
317,MARTIN,317,0002,3170002,6745,1277,454,823,9,50,758,800,817,296,521,4,30,482,508
29,BEXAR,29,2182A,292182A,602,172,98,74,10,25,47,64,120,76,44,7,10,28,37
37,BOWIE,37,005C,37005C,1100,6379,4626,1753,389,833,349,1163,4990,3730,1260,281,590,254,833
41,BRAZOS,41,0081,410081,1272,95,56,39,0,12,24,36,81,50,31,0,8,21,29
41,BRAZOS,41,0075,410075,1266,6856,3531,3325,447,1326,1457,2718,5675,3154,2521,393,883,1134,1980
85,COLLIN,85,0135,850135,1764,7146,2465,4681,3341,713,524,1220,5084,1975,3109,2177,504,351,842
113,DALLAS,113,4113,1134113,2766,4604,176,4428,54,181,4230,4362,3330,153,3177,40,107,3046,3126
329,MIDLAND,329,0406,3290406,6845,3792,2157,1635,345,178,1032,1195,2972,1756,1216,259,140,751,881
367,PARKER,367,0125,3670125,7343,4278,3344,934,23,66,616,676,3293,2667,626,13,28,390,415
387,RED RIVER,387,03-1A,38703-1A,7509,1350,496,854,18,677,134,796,1049,411,638,13,513,81,591
423,SMITH,423,0043,4230043,7764,2019,1395,624,29,227,331,539,1588,1170,418,22,144,212,351
439,TARRANT,439,1543,4391543,8007,2046,239,1807,76,1164,583,1717,1350,183,1167,64,709,394,1094
479,WEBB,479,0268,4790268,9258,1094,24,1070,5,5,1060,1064,642,13,629,4,5,621,625
139,ELLIS,139,1010,1391010,3264,3205,1848,1357,58,327,899,1211,2411,1531,880,41,221,549,763
141,EL PASO,141,0117,1410117,3430,4650,417,4233,97,128,4057,4144,3681,370,3311,70,89,3170,3242
201,HARRIS,201,1127,2011127,5345,2577,274,2303,286,1473,564,1998,2003,263,1740,229,1068,448,1499
201,HARRIS,201,0961,2010961,5179,5037,128,4909,340,1651,2982,4556,3417,107,3310,281,1092,1960,3020
201,HARRIS,201,0464,2010464,4681,4602,1994,2608,265,727,1583,2282,3471,1600,1871,201,507,1125,1620
221,HOOD,221,0112,2210112,5843,3127,2338,789,17,56,561,613,2470,1921,549,12,36,366,401
29,BEXAR,29,3021,293021,625,2911,2396,515,75,19,383,395,2140,1818,322,49,11,238,248
29,BEXAR,29,2047,292047,459,2541,341,2200,22,106,2073,2154,2051,308,1743,18,79,1636,1709
39,BRAZORIA,39,0010,390010,1123,1483,912,571,7,36,479,509,1142,753,389,4,20,321,341
113,DALLAS,113,4153,1134153,2789,327,59,268,5,178,86,259,292,58,234,5,170,62,227
113,DALLAS,113,4004,1134004,2666,3446,738,2708,157,254,2276,2514,2783,687,2096,131,226,1712,1930
113,DALLAS,113,3619,1133619,2623,1079,161,918,2,267,640,888,699,142,557,1,164,393,543
479,WEBB,479,0370,4790370,9281,3887,180,3707,115,44,3550,3587,2595,129,2466,93,31,2344,2368
201,HARRIS,201,1110,2011110,5328,3036,1691,1345,573,315,444,748,2341,1366,975,433,209,309,513
201,HARRIS,201,0613,2010613,4830,5137,272,4865,392,1750,2750,4445,3777,245,3532,326,1305,1920,3190
209,HAYS,209,0423C,2090423C,5494,0,0,0,0,0,0,0,0,0,0,0,0,0,0
237,JACK,237,0004,2370004,5992,1022,861,161,3,7,115,121,753,654,99,2,4,67,70
441,TAYLOR,441,0301,4410301,8617,5281,3143,2138,169,600,1322,1860,4038,2561,1477,120,414,873,1258
467,VAN ZANDT,467,003D,467003D,9115,4294,3713,581,43,76,311,383,3369,2970,399,28,61,198,255
113,DALLAS,113,3613,1133613,2617,1054,203,851,0,547,304,842,790,192,598,0,391,206,589
113,DALLAS,113,1302,1131302,2125,5115,1390,3725,158,2209,1354,3508,3926,1291,2635,121,1557,937,2466
123,DEWITT,123,0101,1230101,3164,3771,1802,1969,29,488,1445,1897,3190,1584,1606,14,407,1148,1548
139,ELLIS,139,1033,1391033,3287,2737,1936,801,52,281,410,680,1886,1361,525,27,204,249,451
141,EL PASO,141,0017,1410017,3330,2646,590,2056,176,44,1843,1877,2037,506,1531,120,27,1386,1406
163,FRIO,163,0008,1630008,3828,2432,386,2046,3,21,1996,2005,1683,314,1369,0,13,1340,1347
5,ANGELINA,5,0034,50034,61,3313,2238,1075,203,453,367,811,2735,1905,830,169,352,263,614
29,BEXAR,29,3121,293121,725,5045,2251,2794,561,310,1918,2177,3696,1732,1964,371,199,1350,1525
55,CALDWELL,55,0404,550404,1392,4424,774,3650,19,91,3514,3589,2840,639,2201,13,57,2093,2149
113,DALLAS,113,3037,1133037,2474,771,23,748,1,351,403,747,547,21,526,1,287,241,525
113,DALLAS,113,1083,1131083,2056,4589,487,4102,37,299,3762,4028,3327,443,2884,17,228,2621,2836
121,DENTON,121,4212,1214212,3138,722,528,194,43,34,92,125,540,400,140,34,23,60,82
453,TRAVIS,453,0113,4530113,8717,3375,1664,1711,119,434,1130,1528,2672,1390,1282,87,354,799,1142
469,VICTORIA,469,0018,4690018,9138,5893,3501,2392,29,208,2055,2233,4587,2889,1698,17,154,1424,1562
489,WILLACY,489,008A,489008A,9381,937,37,900,2,5,894,896,694,27,667,1,4,662,664
247,JIM HOGG,247,0003,2470003,6135,1207,111,1096,3,1,1061,1062,884,100,784,2,0,758,758
303,LUBBOCK,303,0039,3030039,6553,2412,1699,713,14,38,585,616,1860,1366,494,9,25,387,408
355,NUECES,355,0101,3550101,7217,5449,1724,3725,66,149,3473,3579,4042,1452,2590,42,78,2414,2475
439,TARRANT,439,1099,4391099,7884,2246,378,1868,44,621,1184,1785,1597,331,1266,36,450,765,1207
439,TARRANT,439,1719,4391719,8056,3917,2831,1086,171,286,536,793,2991,2223,768,134,201,363,540
439,TARRANT,439,4531,4394531,8548,4676,2748,1928,117,254,1401,1645,3551,2227,1324,78,165,955,1114
139,ELLIS,139,1053,1391053,3307,2771,1448,1323,47,651,557,1180,2112,1195,917,33,480,343,811
177,GONZALES,177,0008,1770008,3971,559,306,253,1,19,229,242,411,249,162,1,15,142,153
201,HARRIS,201,0421,2010421,4638,3964,1277,2687,291,1311,1090,2331,2949,1013,1936,196,970,752,1677
201,HARRIS,201,1084,2011084,5302,694,361,333,40,91,188,275,522,288,234,29,61,136,195
209,HAYS,209,0320,2090320,5471,2611,2010,601,32,29,447,469,2124,1702,422,29,17,298,315
225,HOUSTON,225,0017,2250017,5892,2861,1065,1796,10,982,806,1779,2762,979,1783,10,980,796,1767
29,BEXAR,29,3145,293145,751,5442,2428,3014,714,314,1955,2231,4052,1921,2131,497,208,1395,1584
41,BRAZOS,41,0100,410100,1292,3027,1947,1080,488,172,372,529,2161,1437,724,327,111,251,355
61,CAMERON,61,0003,610003,1415,9059,784,8275,47,73,8163,8191,6212,599,5613,23,36,5545,5563
85,COLLIN,85,0204,850204,1833,468,295,173,51,58,61,116,355,236,119,34,33,46,79
97,COOKE,97,0001,970001,1956,403,345,58,5,4,39,43,348,306,42,2,4,30,34
113,DALLAS,113,3060,1133060,2497,1653,21,1632,3,1339,291,1622,1252,19,1233,2,1064,164,1225
309,MCLENNAN,309,0069,3090069,6702,2479,2011,468,22,88,272,350,1908,1569,339,15,67,178,242
355,NUECES,355,0127,3550127,7243,1949,1020,929,99,53,764,805,1409,742,667,60,36,561,590
367,PARKER,367,0325,3670325,7366,2494,2061,433,7,16,293,309,1913,1627,286,5,8,189,197
439,TARRANT,439,1167,4391167,7907,2368,1126,1242,84,202,913,1092,1811,963,848,52,138,627,756
491,WILLIAMSON,491,0173,4910173,9407,3487,2265,1222,225,176,748,899,2708,1864,844,143,121,528,632
141,EL PASO,141,0143,1410143,3456,3820,72,3748,15,27,3714,3729,2997,57,2940,10,9,2920,2926
181,GRAYSON,181,0202,1810202,3997,6604,4811,1793,86,476,828,1292,5197,4000,1197,61,300,533,829
187,GUADALUPE,187,0306,1870306,4120,5091,2744,2347,275,715,1329,1974,3920,2197,1723,201,571,923,1443
201,HARRIS,201,0321,2010321,4538,5352,383,4969,39,115,4829,4919,3822,343,3479,27,92,3367,3444
201,HARRIS,201,0984,2010984,5202,1263,47,1216,35,387,744,1124,765,37,728,29,244,420,658
201,HARRIS,201,0444,2010444,4661,6144,1931,4213,373,298,3513,3751,4593,1644,2949,307,219,2378,2567
29,BEXAR,29,2021,292021,433,5490,153,5337,36,105,5208,5270,3927,117,3810,23,68,3714,3763
29,BEXAR,29,3078,293078,682,4001,2013,1988,182,207,1570,1746,3183,1720,1463,126,138,1158,1281
113,DALLAS,113,2303,1132303,2354,4278,1587,2691,81,112,2440,2536,3355,1404,1951,73,80,1747,1817
113,DALLAS,113,4612,1134612,2852,544,210,334,6,29,297,324,443,192,251,4,29,217,244
113,DALLAS,113,3504,1133504,2603,923,569,354,189,62,80,137,680,427,253,135,43,57,98
121,DENTON,121,4176,1214176,3101,3801,2648,1153,209,333,509,821,3055,2250,805,173,219,327,532
339,MONTGOMERY,339,0036,3390036,6931,6723,3707,3016,60,179,2651,2809,4762,2884,1878,46,119,1605,1711
355,NUECES,355,0065,3550065,7180,5241,2279,2962,179,754,2041,2712,4558,2001,2557,134,732,1689,2348
375,POTTER,375,0225,3750225,7429,4613,915,3698,73,192,3409,3553,3245,742,2503,48,99,2296,2382
413,SCHLEICHER,413,0002,4130002,7678,611,230,381,4,7,361,365,474,198,276,2,6,259,263
439,TARRANT,439,1251,4391251,7927,5256,780,4476,308,2917,1274,4112,3537,631,2906,228,1907,770,2638
439,TARRANT,439,2466,4392466,8176,2052,493,1559,131,517,907,1408,1522,427,1095,106,388,587,964
141,EL PASO,141,0037,1410037,3350,6797,452,6345,31,138,6235,6319,5227,412,4815,18,88,4734,4796
151,FISHER,151,0001,1510001,3599,875,672,203,4,20,163,177,654,530,124,2,11,89,99
167,GALVESTON,167,0165,1670165,3848,3972,2452,1520,314,358,772,1098,2749,1772,977,206,216,477,683
201,HARRIS,201,0544,2010544,4761,580,25,555,3,168,388,552,448,25,423,3,148,275,420
289,LEON,289,0009,2890009,6433,516,436,80,2,8,41,46,428,370,58,2,4,28,31
309,MCLENNAN,309,0050,3090050,6682,3757,1260,2497,88,1059,1328,2323,2848,1107,1741,70,731,874,1588
5,ANGELINA,5,0014,50014,41,3034,1732,1302,43,575,624,1181,2268,1419,849,33,375,383,756
29,BEXAR,29,4226,294226,1037,228,128,100,19,23,56,74,167,112,55,10,16,23,38
29,BEXAR,29,2126,292126,539,3263,616,2647,95,169,2398,2524,2463,535,1928,73,116,1734,1829
67,CASS,67,0014,670014,1535,3443,2734,709,39,442,114,548,2684,2222,462,27,280,65,343
73,CHEROKEE,73,0035,730035,1584,1617,970,647,10,265,336,595,1276,806,470,7,217,211,427
113,DALLAS,113,4090,1134090,2746,270,33,237,5,49,185,232,220,32,188,4,44,139,183
473,WALLER,473,0420,4730420,9195,4419,2807,1612,359,338,821,1132,3158,2121,1037,223,206,525,724
227,HOWARD,227,0041,2270041,5912,29,13,16,0,6,14,16,17,10,7,0,2,5,7
349,NAVARRO,349,0308,3490308,7074,418,374,44,2,7,25,32,386,346,40,2,6,24,30
393,ROBERTS,393,0001,3930001,7535,232,195,37,6,9,17,24,167,150,17,0,5,6,11
397,ROCKWALL,397,003BA,397003BA,7572,5070,3509,1561,202,488,750,1212,3801,2748,1053,143,312,492,791
439,TARRANT,439,2003,4392003,8070,1253,840,413,55,104,231,325,990,707,283,32,60,161,216
451,TOM GREEN,451,0402,4510402,8697,5429,2759,2670,217,383,1964,2296,4319,2348,1971,177,300,1392,1663
133,EASTLAND,133,0007,1330007,3207,2933,2473,460,34,40,305,338,2314,2022,292,28,19,177,192
135,ECTOR,135,0404,1350404,3244,4315,807,3508,10,34,3451,3464,3005,623,2382,4,14,2340,2347
157,FORT BEND,157,3140,1573140,3742,4150,1779,2371,1485,395,444,829,3321,1466,1855,1187,290,331,615
201,HARRIS,201,0152,2010152,4369,8138,534,7604,34,772,6804,7515,5890,468,5422,21,538,4856,5364
201,HARRIS,201,1147,2011147,5365,197,17,180,3,15,168,177,119,15,104,2,6,98,104
201,HARRIS,201,0650,2010650,4867,5347,2743,2604,885,534,1140,1648,4281,2355,1926,676,345,847,1182
29,BEXAR,29,4169,294169,980,495,261,234,17,33,187,210,410,240,170,9,32,129,152
29,BEXAR,29,4083,294083,894,1373,391,982,84,408,513,878,890,287,603,51,247,297,529
29,BEXAR,29,3041,293041,645,637,322,315,22,15,272,285,506,279,227,20,10,196,205
85,COLLIN,85,0098,850098,1727,3201,1318,1883,98,220,1546,1744,2494,1212,1282,73,182,1011,1180
99,CORYELL,99,0104,990104,1976,7204,3878,3326,354,1415,1366,2638,5351,3067,2284,256,936,887,1760
113,DALLAS,113,2119,1132119,2305,1435,178,1257,57,173,1043,1197,986,140,846,47,135,673,796
491,WILLIAMSON,491,0119,4910119,9387,5802,3106,2696,304,440,1907,2293,4286,2472,1814,201,292,1259,1534
493,WILSON,493,0103,4930103,9550,2738,1102,1636,13,44,1535,1566,2078,894,1184,10,30,1113,1134
201,HARRIS,201,1004,2011004,5222,1163,563,600,33,47,503,547,916,485,431,25,30,362,391
245,JEFFERSON,245,0027,2450027,6055,2428,802,1626,83,947,591,1516,1811,698,1113,69,631,402,1022
265,KERR,265,0406,2650406,6304,4368,3199,1169,43,66,966,1017,3525,2713,812,34,41,644,676
439,TARRANT,439,4563,4394563,8554,0,0,0,0,0,0,0,0,0,0,0,0,0,0
439,TARRANT,439,3325,4393325,8305,1763,1056,707,47,97,474,564,1372,896,476,34,51,312,359
479,WEBB,479,0458,4790458,9301,8225,244,7981,51,55,7874,7910,5581,168,5413,35,27,5336,5359
141,EL PASO,141,0074,1410074,3387,4336,186,4150,34,91,4061,4107,3449,167,3282,22,62,3211,3247
177,GONZALES,177,0014,1770014,3977,168,95,73,1,3,55,57,119,70,49,1,2,32,33
201,HARRIS,201,0841,2010841,5059,7726,772,6954,194,3336,3416,6599,5378,651,4727,153,2263,2269,4456
201,HARRIS,201,0010,2010010,4226,3587,385,3202,68,143,2991,3115,2902,332,2570,55,127,2379,2497
201,HARRIS,201,0755,2010755,4973,7122,764,6358,320,989,5079,6000,5268,664,4604,253,761,3602,4322
201,HARRIS,201,1090,2011090,5308,829,223,606,155,131,315,432,600,194,406,118,81,198,276
29,BEXAR,29,1040,291040,290,5427,206,5221,29,58,5165,5184,3979,170,3809,24,34,3769,3778
41,BRAZOS,41,0094,410094,1286,0,0,0,0,0,0,0,0,0,0,0,0,0,0
55,CALDWELL,55,0102,550102,1372,1126,638,488,8,24,436,457,864,535,329,5,15,295,308
91,COMAL,91,0207,910207,1913,2866,2185,681,90,121,392,500,2180,1710,470,55,83,258,334
113,DALLAS,113,2402,1132402,2368,5407,1790,3617,1765,566,1229,1773,4448,1584,2864,1476,409,907,1302
115,DAWSON,115,0011,1150011,2909,339,204,135,4,4,130,134,217,133,84,4,4,79,83
453,TRAVIS,453,0410,4530410,8946,2970,2118,852,195,69,518,567,2622,1898,724,159,52,445,489
453,TRAVIS,453,0366,4530366,8909,4348,3652,696,83,47,428,458,3481,2985,496,49,30,291,313
257,KAUFMAN,257,0020,2570020,6241,3034,1560,1474,123,140,1143,1272,2229,1255,974,100,101,715,810
309,MCLENNAN,309,0063,3090063,6696,5802,4633,1169,253,272,523,783,4197,3449,748,149,186,318,497
355,NUECES,355,0121,3550121,7237,2838,578,2260,60,224,1980,2165,2199,521,1678,44,173,1449,1603
361,ORANGE,361,0031,3610031,7286,2659,2305,354,38,36,179,214,2033,1808,225,20,20,108,128
365,PANOLA,365,0008,3650008,7323,335,274,61,5,35,18,53,243,207,36,3,27,6,33
439,TARRANT,439,3562,4393562,8368,183,147,36,5,4,25,26,135,116,19,4,1,11,12
121,DENTON,121,2071,1212071,2995,5759,4141,1618,341,390,727,1080,4339,3255,1084,239,261,461,705
181,GRAYSON,181,0105,1810105,3991,1405,1266,139,9,13,80,91,1056,963,93,7,7,51,58
201,HARRIS,201,0401,2010401,4618,3653,62,3591,21,1884,1709,3552,2702,59,2643,15,1466,1179,2614
215,HIDALGO,215,0062,2150062,5614,4106,797,3309,193,71,3011,3077,3327,701,2626,150,59,2377,2434
215,HIDALGO,215,0148,2150148,5700,335,7,328,2,3,327,328,214,7,207,2,2,206,207
215,HIDALGO,215,0111,2150111,5663,4022,506,3516,59,46,3420,3444,3221,472,2749,52,39,2664,2685
13,ATASCOSA,13,0010,130010,104,958,266,692,12,21,623,637,753,228,525,11,9,474,481
65,CARSON,65,0201,650201,1521,1457,1232,225,15,29,141,167,1121,957,164,15,22,99,120
85,COLLIN,85,0141,850141,1770,4447,2252,2195,1077,507,520,1016,3477,1867,1610,780,373,375,745
113,DALLAS,113,1004,1131004,2019,2706,1471,1235,98,746,359,1089,2000,1113,887,70,552,239,784
113,DALLAS,113,2080,1132080,2268,622,114,508,9,16,477,488,451,95,356,8,8,332,338
157,FORT BEND,157,2128,1572128,3685,4777,2966,1811,747,383,633,995,3562,2265,1297,558,280,413,682
303,LUBBOCK,303,0122,3030122,6596,2978,1468,1510,40,243,1200,1416,2208,1222,986,35,149,774,912
439,TARRANT,439,4350,4394350,8511,1896,1402,494,77,78,295,371,1607,1227,380,57,57,226,283
439,TARRANT,439,1559,4391559,8013,369,63,306,17,130,158,286,267,59,208,9,105,93,196
439,TARRANT,439,3072,4393072,8262,3497,2761,736,271,100,276,367,2718,2203,515,194,74,177,244
453,TRAVIS,453,0164,4530164,8760,4599,1830,2769,636,717,1402,2072,3629,1506,2123,489,564,1042,1570
169,GARZA,169,0001,1690001,3934,856,536,320,9,45,279,313,672,448,224,3,34,189,218
193,HAMILTON,193,0017,1930017,4183,292,211,81,1,3,62,65,240,187,53,1,3,38,41
201,HARRIS,201,0215,2010215,4432,3370,1874,1496,888,116,440,545,2567,1544,1023,601,89,296,377
221,HOOD,221,0313,2210313,5849,4079,3419,660,70,51,433,473,3483,2999,484,42,30,303,328
245,JEFFERSON,245,0070,2450070,6098,4591,970,3621,848,1824,973,2734,3330,836,2494,605,1238,648,1854
277,LAMAR,277,001E,277001E,6347,1072,924,148,3,6,76,82,817,711,106,3,6,58,64
29,BEXAR,29,2083,292083,496,1043,207,836,7,37,790,821,856,186,670,7,23,640,657
381,RANDALL,381,0228,3810228,7470,6442,4957,1485,267,192,890,1061,5179,4094,1085,205,134,635,757
427,STARR,427,0005,4270005,7802,181,3,178,0,0,178,178,133,2,131,0,0,131,131
113,DALLAS,113,1725,1131725,2183,635,353,282,9,68,190,251,553,347,206,4,46,136,180
209,HAYS,209,0336,2090336,5478,3943,2350,1593,117,262,1138,1351,3430,2101,1329,95,211,950,1137
215,HIDALGO,215,0258,2150258,5810,34,0,34,0,0,34,34,26,0,26,0,0,26,26
249,JIM WELLS,249,0005,2490005,6142,301,32,269,5,4,261,262,239,27,212,1,1,205,206
293,LIMESTONE,293,0304,2930304,6474,1130,723,407,6,131,251,377,862,595,267,4,86,160,244
327,MENARD,327,0004B,3270004B,6806,6,1,5,0,4,1,5,4,0,4,0,4,0,4
29,BEXAR,29,1126,291126,377,0,0,0,0,0,0,0,0,0,0,0,0,0,0
29,BEXAR,29,4230,294230,1041,4075,693,3382,146,1565,1751,3176,2787,538,2249,101,1033,1102,2086
85,COLLIN,85,0082,850082,1711,4935,2407,2528,297,888,1272,2125,3599,1940,1659,236,534,822,1340
85,COLLIN,85,0076,850076,1705,5145,2910,2235,1090,513,506,997,3881,2357,1524,727,368,330,690
113,DALLAS,113,2409,1132409,2375,5428,754,4674,174,174,4302,4436,4005,656,3349,152,126,3039,3141
121,DENTON,121,3115,1213115,3039,5519,1623,3896,2019,1181,645,1785,4227,1329,2898,1541,835,462,1282
265,KERR,265,0101,2650101,6288,3807,2760,1047,64,86,828,896,3159,2370,789,49,60,611,662
339,MONTGOMERY,339,0054,3390054,6952,5263,1771,3492,43,182,3158,3301,3491,1393,2098,26,107,1856,1944
403,SABINE,403,0002,4030002,7616,1711,1579,132,6,29,55,81,1539,1435,104,4,22,38,59
439,TARRANT,439,2571,4392571,8203,0,0,0,0,0,0,0,0,0,0,0,0,0,0
453,TRAVIS,453,0321,4530321,8867,2567,2031,536,188,25,268,292,1765,1463,302,92,15,151,166
491,WILLIAMSON,491,0436,4910436,9531,1926,1215,711,35,61,591,643,1432,984,448,18,44,353,394
157,FORT BEND,157,3045,1573045,3703,2999,986,2013,612,538,825,1345,2255,807,1448,438,369,606,963
157,FORT BEND,157,1122,1571122,3626,5103,3550,1553,567,180,713,872,3773,2721,1052,390,125,455,570
201,HARRIS,201,0736,2010736,4954,2384,1506,878,206,102,511,605,2022,1321,701,156,74,407,478
201,HARRIS,201,0073,2010073,4290,3305,1522,1783,162,264,1328,1577,2576,1259,1317,123,211,954,1162
215,HIDALGO,215,0066,2150066,5618,2209,112,2097,7,20,2072,2082,1723,99,1624,5,11,1603,1610
215,HIDALGO,215,0072,2150072,5624,2057,142,1915,52,39,1839,1856,1555,120,1435,36,27,1379,1394
29,BEXAR,29,4213,294213,1024,8,3,5,1,0,3,3,4,3,1,0,0,0,0
29,BEXAR,29,4207,294207,1018,0,0,0,0,0,0,0,0,0,0,0,0,0,0
29,BEXAR,29,1104,291104,354,5214,1043,4171,232,535,3450,3891,4108,912,3196,172,398,2607,2969
29,BEXAR,29,2065A,292065A,477,3720,754,2966,276,461,2301,2670,2436,553,1883,171,258,1453,1685
85,COLLIN,85,0059,850059,1688,5890,3501,2389,849,650,780,1404,4289,2648,1641,614,423,522,926
113,DALLAS,113,2301,1132301,2352,3009,2059,950,124,174,572,728,2569,1847,722,103,130,419,538
473,WALLER,473,0207,4730207,9182,5707,4100,1607,50,136,1218,1342,4218,3208,1010,35,78,731,806
491,WILLIAMSON,491,0401,4910401,9508,8530,3602,4928,360,1437,3018,4333,5920,2710,3210,250,925,1919,2789
389,REEVES,389,0002,3890002,7516,1925,197,1728,36,41,1644,1676,1386,171,1215,19,27,1154,1181
407,SAN JACINTO,407,0006,4070006,7639,2475,2030,445,14,220,108,325,2102,1758,344,9,161,77,238
439,TARRANT,439,2484,4392484,8180,8214,1293,6921,1400,3172,2399,5455,6161,1123,5038,1104,2266,1680,3893
439,TARRANT,439,3323,4393323,8303,4198,3232,966,470,118,279,382,3324,2624,700,330,72,197,268
453,TRAVIS,453,0434,4530434,8967,3590,1680,1910,146,232,1491,1698,3165,1564,1601,114,188,1252,1424
453,TRAVIS,453,0280,4530280,8844,4400,3529,871,82,79,556,620,3646,3015,631,65,58,378,427
121,DENTON,121,2092,1212092,3016,6993,3806,3187,1029,1022,1073,2008,6330,3569,2761,880,853,945,1737
201,HARRIS,201,0759,2010759,4977,3748,1251,2497,775,575,1129,1669,2883,1067,1816,595,419,787,1192
215,HIDALGO,215,0089,2150089,5641,39,9,30,0,1,29,29,24,9,15,0,0,14,14
265,KERR,265,0410,2650410,6305,339,260,79,13,0,51,51,288,229,59,11,0,40,40
339,MONTGOMERY,339,0076,3390076,6975,6045,4726,1319,120,265,768,1002,4726,3786,940,79,178,530,694
339,MONTGOMERY,339,0070,3390070,6969,3566,2549,1017,340,97,485,573,2658,1993,665,224,55,314,367
29,BEXAR,29,1081,291081,331,4025,2037,1988,181,477,1370,1771,3252,1870,1382,130,349,924,1225
113,DALLAS,113,2047,1132047,2252,3326,2466,860,136,189,447,625,2406,1817,589,89,139,310,442
117,DEAF SMITH,117,0004,1170004,2916,4618,860,3758,20,86,3666,3712,3126,678,2448,11,42,2389,2414
121,DENTON,121,4161,1214161,3085,5414,2640,2774,335,594,1734,2283,3815,1996,1819,239,377,1108,1467
147,FANNIN,147,0012,1470012,3580,1725,1531,194,7,18,112,129,1363,1213,150,7,14,79,93
157,FORT BEND,157,3169,1573169,3749,1401,83,1318,1206,65,46,109,1005,66,939,864,46,26,72
453,TRAVIS,453,0465,4530465,8990,5026,1686,3340,249,678,2403,3006,4214,1571,2643,225,547,1835,2335
471,WALKER,471,0104,4710104,9159,2803,2015,788,17,193,506,698,2247,1668,579,12,168,339,506
497,WISE,497,0012,4970012,9577,2661,2124,537,13,34,413,438,2059,1704,355,11,16,265,279
201,HARRIS,201,0196,2010196,4413,721,52,669,13,153,517,658,538,47,491,10,125,366,483
201,HARRIS,201,0028,2010028,4244,8793,3042,5751,554,2041,3090,5004,6748,2662,4086,423,1444,2118,3497
201,HARRIS,201,0859,2010859,5077,1708,149,1559,15,538,1004,1530,1286,132,1154,15,434,701,1130
409,SAN PATRICIO,409,0118,4090118,7662,4270,1061,3209,26,54,3091,3131,3270,952,2318,19,42,2222,2253
439,TARRANT,439,4256,4394256,8495,2907,168,2739,6,79,2658,2724,1988,152,1836,5,45,1780,1822
439,TARRANT,439,3386,4393386,8326,3206,2540,666,188,118,266,376,2405,1972,433,130,79,163,238
25,BEE,25,0016,250016,185,1760,546,1214,28,62,1125,1174,1336,474,862,19,46,794,832
113,DALLAS,113,2519,1132519,2398,6698,1573,5125,326,751,4020,4743,4657,1297,3360,245,518,2559,3060
121,DENTON,121,1015,1211015,2939,2203,1019,1184,114,419,616,1005,1485,741,744,75,253,373,611
121,DENTON,121,3138,1213138,3062,5383,2993,2390,1602,259,482,719,3852,2295,1557,1021,178,307,473
151,FISHER,151,0012,1510012,3603,928,567,361,7,42,297,334,767,482,285,6,26,234,258
157,FORT BEND,157,3110,1573110,3726,4717,1628,3089,2062,397,644,1011,3720,1413,2307,1559,289,447,719
453,TRAVIS,453,0347,4530347,8890,4452,3143,1309,539,100,587,662,3078,2235,843,363,60,356,408
455,TRINITY,455,0008,4550008,9013,564,506,58,2,8,26,34,455,416,39,1,3,13,16
469,VICTORIA,469,0016,4690016,9136,666,434,232,7,33,165,192,525,360,165,3,24,112,135
493,WILSON,493,0207,4930207,9554,4281,2253,2028,51,103,1830,1911,3254,1818,1436,32,63,1285,1345
201,HARRIS,201,0050,2010050,4267,8131,2160,5971,1614,2150,2192,4239,6135,1758,4377,1282,1508,1551,3002
201,HARRIS,201,0713,2010713,4931,4310,1155,3155,617,1119,1371,2441,3246,950,2296,478,786,984,1743
201,HARRIS,201,0173,2010173,4390,4082,2707,1375,600,210,522,717,2752,1886,866,379,135,312,442
427,STARR,427,0011,4270011,7808,7045,90,6955,7,4,6938,6939,5135,76,5059,6,4,5047,5048
439,TARRANT,439,4179,4394179,8472,3066,1194,1872,76,506,1248,1725,2326,1035,1291,55,345,850,1180
439,TARRANT,439,3502,4393502,8349,1948,1627,321,81,32,150,177,1463,1259,204,50,16,94,106
29,BEXAR,29,4061,294061,872,5726,917,4809,151,1275,3453,4620,4027,758,3269,102,899,2289,3131
29,BEXAR,29,4144,294144,955,703,389,314,18,70,220,281,600,356,244,14,46,172,215
29,BEXAR,29,3019,293019,623,0,0,0,0,0,0,0,0,0,0,0,0,0,0
113,DALLAS,113,4640,1134640,2876,7297,1100,6197,1004,2707,2479,5069,5295,982,4313,820,1783,1659,3396
113,DALLAS,113,3102,1133102,2544,5657,675,4982,124,3198,1668,4781,4008,571,3437,92,2236,1088,3287
121,DENTON,121,4200,1214200,3125,78,73,5,1,0,4,4,60,56,4,0,0,4,4
467,VAN ZANDT,467,003B,467003B,9113,3259,2233,1026,28,437,469,894,2471,1795,676,10,304,292,589
379,RAINS,379,0204,3790204,7453,1026,797,229,1,43,132,171,775,623,152,1,25,84,108
419,SHELBY,419,0003,4190003,7702,421,346,75,4,13,54,66,309,263,46,3,4,33,37
423,SMITH,423,0073,4230073,7785,1071,398,673,9,340,311,642,833,346,487,6,249,217,461
439,TARRANT,439,1627,4391627,8034,526,338,188,29,33,108,138,326,218,108,21,18,51,67
453,TRAVIS,453,0193,4530193,8781,4553,1830,2723,489,1036,1188,2164,3497,1517,1980,388,752,808,1531
457,TYLER,457,0005,4570005,9030,265,196,69,0,59,4,63,214,164,50,0,41,3,44
141,EL PASO,141,0144,1410144,3457,4315,150,4165,29,53,4088,4122,3258,122,3136,8,29,3094,3115
167,GALVESTON,167,0226,1670226,3872,4237,2473,1764,58,434,1151,1568,3306,2080,1226,40,294,785,1071
199,HARDIN,199,0007,1990007,4204,1070,988,82,4,20,27,46,837,790,47,2,10,15,25
201,HARRIS,201,0236,2010236,4453,3664,32,3632,16,1506,2160,3618,2626,29,2597,8,1232,1377,2583
201,HARRIS,201,0568,2010568,4785,4896,2869,2027,823,226,872,1080,3790,2311,1479,644,161,580,735
309,MCLENNAN,309,0073,3090073,6706,1614,1298,316,8,41,200,238,1199,1000,199,4,20,121,141
27,BELL,27,0311,270311,231,4461,3380,1081,69,137,727,835,3546,2771,775,41,89,512,577
29,BEXAR,29,1018,291018,268,1888,84,1804,16,31,1761,1777,1441,72,1369,13,23,1327,1342
29,BEXAR,29,2150,292150,563,30,4,26,3,6,19,22,17,2,15,0,3,12,15
71,CHAMBERS,71,0008,710008,1559,6465,4629,1836,75,348,1292,1606,4459,3283,1176,41,235,782,1007
113,DALLAS,113,4117,1134117,2770,235,82,153,5,111,37,147,226,82,144,2,109,32,140
113,DALLAS,113,3001,1133001,2438,1338,58,1280,22,878,393,1254,824,58,766,18,508,248,746
321,MATAGORDA,321,001C,321001C,6766,1581,294,1287,17,890,388,1254,1137,229,908,13,648,232,879
351,NEWTON,351,0015,3510015,7098,362,304,58,1,39,6,45,289,240,49,0,32,5,37
439,TARRANT,439,4050,4394050,8426,4648,365,4283,43,765,3509,4238,3108,264,2844,28,499,2320,2809
439,TARRANT,439,2173,4392173,8094,1266,864,402,128,93,147,239,1031,735,296,97,68,93,161
439,TARRANT,439,3661,4393661,8389,0,0,0,0,0,0,0,0,0,0,0,0,0,0
453,TRAVIS,453,0117,4530117,8721,3484,1605,1879,106,701,1057,1728,2839,1395,1444,78,581,757,1322
145,FALLS,145,0203,1450203,3563,2469,867,1602,17,1000,606,1578,2351,853,1498,17,905,592,1477
157,FORT BEND,157,4067,1574067,3766,4975,1078,3897,1209,1664,1071,2687,3649,847,2802,912,1149,745,1874
187,GUADALUPE,187,0214,1870214,4098,1054,587,467,22,25,389,403,760,431,329,18,11,267,274
201,HARRIS,201,0342,2010342,4559,3075,252,2823,45,961,1838,2758,2137,215,1922,35,646,1239,1867
201,HARRIS,201,0674,2010674,4891,6952,4036,2916,364,820,1584,2379,5183,3185,1998,271,558,1036,1584
225,HOUSTON,225,0011,2250011,5887,157,123,34,3,21,4,25,135,105,30,2,20,2,22
29,BEXAR,29,4107,294107,918,1473,521,952,147,369,466,804,1212,476,736,119,291,332,607
29,BEXAR,29,4190,294190,1001,19,7,12,3,7,4,9,15,5,10,2,5,3,7
29,BEXAR,29,3065,293065,669,5160,2145,3015,528,365,2104,2428,3901,1721,2180,398,259,1487,1730
41,BRAZOS,41,0059,410059,1250,45,31,14,0,0,14,14,33,22,11,0,0,11,11
85,COLLIN,85,0122,850122,1751,6470,4978,1492,438,381,549,905,4868,3844,1024,322,257,348,593
105,CROCKETT,105,0001,1050001,1997,797,229,568,9,14,538,548,639,178,461,7,10,441,448
485,WICHITA,485,0108,4850108,9328,7113,4828,2285,143,781,1163,1866,5476,4008,1468,90,472,710,1156
287,LEE,287,0102,2870102,6411,381,171,210,1,140,67,205,309,142,167,0,122,42,164
303,LUBBOCK,303,0065,3030065,6574,2163,993,1170,14,79,1050,1118,1647,842,805,9,61,701,756
309,MCLENNAN,309,0028,3090028,6660,1855,921,934,25,363,526,870,1406,747,659,19,257,363,614
373,POLK,373,0011,3730011,7407,612,369,243,6,137,82,219,471,295,176,5,107,55,162
409,SAN PATRICIO,409,0112,4090112,7656,2475,343,2132,12,45,2069,2108,1885,279,1606,9,35,1556,1586
423,SMITH,423,0018,4230018,7739,3110,248,2862,35,2157,659,2786,2271,228,2043,29,1597,383,1974
201,HARRIS,201,1028,2011028,5246,5950,2356,3594,290,1493,1793,3210,3967,1600,2367,194,979,1147,2100
201,HARRIS,201,0034,2010034,4250,4297,2596,1701,462,356,837,1163,3945,2416,1529,423,312,744,1038
201,HARRIS,201,1114,2011114,5332,6848,521,6327,198,3114,3048,6034,4765,465,4300,165,2180,1961,4067
215,HIDALGO,215,0026,2150026,5578,2323,87,2236,13,13,2196,2207,1773,74,1699,11,9,1664,1673
245,JEFFERSON,245,0051,2450051,6079,909,37,872,39,360,478,829,666,31,635,30,289,314,600
273,KLEBERG,273,0022,2730022,6328,1316,354,962,77,104,781,874,1128,340,788,67,84,628,707
113,DALLAS,113,2145,1132145,2329,5035,3264,1771,268,397,1034,1406,4712,3167,1545,243,334,896,1212
113,DALLAS,113,1110,1131110,2083,50,0,50,0,5,45,50,40,0,40,0,2,38,40
113,DALLAS,113,2041,1132041,2246,6689,4160,2529,596,976,851,1803,6152,3901,2251,551,862,742,1585
113,DALLAS,113,32T0,11332T0,2578,0,0,0,0,0,0,0,0,0,0,0,0,0,0
121,DENTON,121,3155,1213155,3079,5584,4207,1377,394,250,600,839,4135,3224,911,278,185,348,528
141,EL PASO,141,0098,1410098,3411,2308,376,1932,42,54,1829,1877,1913,344,1569,33,37,1483,1520
29,BEXAR,29,1064,291064,314,2567,392,2175,18,37,2126,2137,1883,302,1581,14,24,1546,1556
35,BOSQUE,35,0011,350011,1064,1061,901,160,3,9,92,99,854,740,114,2,5,60,65
45,BRISCOE,45,0002,450002,1310,358,239,119,1,11,101,109,270,189,81,1,6,70,76
57,CALHOUN,57,0003,570003,1396,754,533,221,8,16,172,181,619,467,152,6,6,110,115
77,CLAY,77,0012,770012,1605,451,365,86,5,4,48,52,366,301,65,3,3,36,39
85,COLLIN,85,0013,850013,1642,2136,1625,511,114,119,211,325,1421,1112,309,73,70,122,191
309,MCLENNAN,309,0086,3090086,6720,3981,1432,2549,34,1165,1338,2443,2882,1199,1683,26,816,796,1602
341,MOORE,341,0203,3410203,7015,149,98,51,1,5,36,40,108,73,35,1,1,25,26
361,ORANGE,361,0006,3610006,7261,2242,1881,361,28,107,160,259,1783,1506,277,24,87,110,193
367,PARKER,367,0200,3670200,7347,3198,2182,1016,28,85,764,842,2497,1766,731,18,69,534,599
439,TARRANT,439,3465,4393465,8343,6551,3638,2913,507,786,1513,2241,4597,2697,1900,320,507,981,1454
201,HARRIS,201,0179,2010179,4396,3974,1226,2748,264,268,2195,2436,3145,1071,2074,222,213,1600,1800
203,HARRISON,203,0009,2030009,5392,2491,1672,819,19,383,352,730,1886,1308,578,13,300,205,503
215,HIDALGO,215,0172,2150172,5724,72,1,71,0,0,71,71,52,0,52,0,0,52,52
229,HUDSPETH,229,0001,2290001,5933,1299,714,585,16,12,561,569,1214,700,514,16,8,494,500
241,JASPER,241,0016,2410016,6019,516,460,56,1,10,20,29,399,367,32,1,7,6,12
259,KENDALL,259,2080,2592080,6265,2611,2089,522,46,38,355,387,1945,1613,332,34,20,218,236
93,COMANCHE,93,0005,930005,1937,1015,737,278,3,5,251,253,806,629,177,2,3,157,158
113,DALLAS,113,4067,1134067,2724,4538,420,4118,30,146,3919,4045,3402,366,3036,26,110,2878,2977
113,DALLAS,113,2512,1132512,2392,2188,1160,1028,391,267,351,597,1758,998,760,292,188,243,422
121,DENTON,121,1009,1211009,2933,420,271,149,6,9,119,126,330,230,100,5,3,80,82
139,ELLIS,139,1011,1391011,3265,4191,2198,1993,46,542,1305,1831,3220,1830,1390,25,401,859,1252
201,HARRIS,201,0719,2010719,4937,4143,886,3257,34,216,2994,3165,2987,769,2218,26,149,2010,2138
15,AUSTIN,15,0413,150413,128,2303,1493,810,13,121,659,765,1752,1204,548,9,86,441,519
29,BEXAR,29,3105,293105,709,5326,2077,3249,170,465,2614,3000,3984,1689,2295,116,337,1793,2098
61,CAMERON,61,0044,610044,1456,5035,1450,3585,198,163,3196,3312,3815,1241,2574,173,125,2265,2359
113,DALLAS,113,2106,1132106,2292,2607,1483,1124,201,435,440,865,2524,1456,1068,192,407,419,819
113,DALLAS,113,1056,1131056,2037,2020,591,1429,38,111,1256,1354,1491,516,975,26,85,835,919
113,DALLAS,113,1062,1131062,2043,104,14,90,0,2,88,88,78,14,64,0,0,62,62
503,YOUNG,503,0005,5030005,9614,4149,3325,824,30,58,648,697,3186,2672,514,17,33,386,415
223,HOPKINS,223,002A,223002A,5873,2011,987,1024,28,628,316,930,1542,783,759,22,483,212,688
305,LYNN,305,0005,3050005,6620,109,68,41,1,3,36,37,86,51,35,1,3,30,31
355,NUECES,355,0086,3550086,7201,790,426,364,17,19,319,329,644,359,285,17,11,242,251
439,TARRANT,439,1311,4391311,7948,2994,619,2375,165,1499,713,2173,2246,526,1720,140,1097,478,1562
439,TARRANT,439,4487,4394487,8535,0,0,0,0,0,0,0,0,0,0,0,0,0,0
439,TARRANT,439,3213,4393213,8286,3106,1895,1211,31,208,905,1085,2348,1556,792,22,119,568,676
141,EL PASO,141,0058,1410058,3371,3384,564,2820,147,405,2329,2643,2532,511,2021,121,265,1636,1873
157,FORT BEND,157,3062,1573062,3709,4620,1347,3273,1296,1378,605,1928,3817,1210,2607,1073,1077,441,1489
157,FORT BEND,157,1041,1571041,3620,2632,1677,955,110,203,606,792,2015,1377,638,79,131,393,513
175,GOLIAD,175,0012,1750012,3958,573,362,211,3,49,150,198,450,303,147,2,37,100,136
201,HARRIS,201,0819,2010819,5037,202,125,77,15,23,40,59,157,93,64,15,20,29,47
201,HARRIS,201,1068,2011068,5286,5656,699,4957,1068,1413,2509,3862,4444,621,3823,922,1056,1869,2885
1,ANDERSON,1,0024,10024,22,1274,1087,187,17,38,93,131,987,861,126,9,25,65,90
29,BEXAR,29,4004,294004,815,1072,312,760,44,150,563,701,965,312,653,43,132,473,599
53,BURNET,53,0007,530007,1356,803,685,118,3,11,63,74,693,602,91,3,9,42,51
113,DALLAS,113,4022,1134022,2684,3013,933,2080,440,748,886,1607,2694,917,1777,373,694,694,1373
113,DALLAS,113,1327,1131327,2143,6883,1544,5339,342,2681,2271,4880,5041,1278,3763,283,1849,1574,3382
121,DENTON,121,1055,1211055,2979,1492,1011,481,69,162,196,353,1149,825,324,46,110,124,231
491,WILLIAMSON,491,0412,4910412,9514,2229,1250,979,24,93,825,903,1654,1010,644,20,35,542,577
301,LOVING,301,0002,3010002,6514,1,1,0,0,0,0,0,1,1,0,0,0,0,0
363,PALO PINTO,363,0020,3630020,7307,235,217,18,3,2,5,6,210,196,14,3,2,3,4
439,TARRANT,439,1011,4391011,7848,3175,211,2964,60,492,2422,2891,2255,195,2060,51,370,1634,1999
443,TERRELL,443,0002A,4430002A,8635,159,32,127,2,2,123,124,134,27,107,1,2,104,105
453,TRAVIS,453,0445,4530445,8973,3929,2105,1824,185,241,1360,1567,3204,1819,1385,150,193,1008,1175
473,WALLER,473,0101,4730101,9176,3157,1355,1802,16,441,1285,1718,2337,1161,1176,3,310,813,1118
121,DENTON,121,2098,1212098,3022,927,358,569,392,85,88,163,776,318,458,330,61,48,108
201,HARRIS,201,0968,2010968,5186,5023,601,4422,231,2433,1777,4130,3421,435,2986,163,1623,1168,2767
201,HARRIS,201,0090,2010090,4307,3242,2366,876,97,128,542,647,2537,1947,590,71,83,343,412
201,HARRIS,201,0133,2010133,4350,3885,2632,1253,688,79,438,494,2661,1881,780,422,45,267,304
201,HARRIS,201,0428,2010428,4645,5870,366,5504,2083,1305,2141,3406,4417,299,4118,1689,926,1513,2418
231,HUNT,231,214A,231214A,5973,4500,3286,1214,48,93,893,980,3427,2644,783,33,61,534,592
29,BEXAR,29,2005,292005,417,1545,192,1353,24,35,1297,1319,1265,168,1097,19,31,1045,1067
61,CAMERON,61,0090,610090,1502,1098,46,1052,0,7,1047,1047,790,33,757,0,2,755,755
113,DALLAS,113,2151,1132151,2335,368,239,129,17,22,78,100,325,218,107,13,14,70,84
113,DALLAS,113,4537,1134537,2830,30,6,24,1,11,12,22,21,3,18,0,10,9,18
113,DALLAS,113,3308,1133308,2584,5403,1122,4281,58,964,3245,4170,3643,955,2688,39,614,1998,2602
141,EL PASO,141,0104,1410104,3417,5247,759,4488,85,282,4167,4370,4150,666,3484,62,204,3228,3391
485,WICHITA,485,0102,4850102,9322,1498,1141,357,62,101,151,238,1195,942,253,55,62,100,155
219,HOCKLEY,219,0015,2190015,5827,826,525,301,3,7,264,270,657,441,216,3,3,187,190
339,MONTGOMERY,339,0019,3390019,6912,5566,4336,1230,40,415,602,1003,4298,3415,883,24,318,391,702
439,TARRANT,439,1476,4391476,7994,360,61,299,4,16,282,294,247,57,190,2,12,175,185
439,TARRANT,439,2743,4392743,8240,30,8,22,5,0,13,13,23,8,15,5,0,6,6
453,TRAVIS,453,0255,4530255,8827,5551,2254,3297,851,887,1498,2327,4460,1988,2472,665,642,1112,1723
463,UVALDE,463,0008,4630008,9076,2702,530,2172,7,13,2141,2148,2006,449,1557,5,6,1535,1541
157,FORT BEND,157,2075,1572075,3666,3113,114,2999,127,2060,845,2862,2330,97,2233,108,1546,591,2113
157,FORT BEND,157,2061,1572061,3663,7551,2676,4875,2541,1496,825,2287,4994,1799,3195,1675,967,529,1479
167,GALVESTON,167,0435,1670435,3912,2024,673,1351,82,711,556,1244,1533,545,988,70,524,389,901
201,HARRIS,201,0528,2010528,4745,3644,288,3356,37,1196,2101,3276,2592,226,2366,31,889,1414,2293
201,HARRIS,201,0776,2010776,4994,5771,2147,3624,230,1653,1724,3313,4196,1739,2457,184,1126,1109,2212
201,HARRIS,201,0282,2010282,4499,5455,1989,3466,669,1256,1594,2758,4232,1507,2725,514,1053,1210,2186
85,COLLIN,85,0019,850019,1648,2019,1506,513,185,94,185,274,1617,1216,401,147,77,129,204
113,DALLAS,113,4073,1134073,2730,3056,717,2339,14,155,2108,2257,2368,654,1714,9,117,1524,1641
113,DALLAS,113,1731,1131731,2189,0,0,0,0,0,0,0,0,0,0,0,0,0,0
121,DENTON,121,1052,1211052,2976,4645,2175,2470,244,1323,821,2071,3094,1545,1549,151,803,504,1280
139,ELLIS,139,1017,1391017,3271,4892,2601,2291,47,408,1774,2135,3569,2092,1477,25,260,1122,1373
141,EL PASO,141,0204,1410204,3517,3151,175,2976,52,92,2867,2930,2017,116,1901,33,50,1825,1867
401,RUSK,401,0214,4010214,7599,3048,2138,910,15,424,350,767,2470,1824,646,9,343,190,531
439,TARRANT,439,2319,4392319,8140,3448,2191,1257,244,391,556,916,2695,1838,857,151,262,375,619
451,TOM GREEN,451,0213,4510213,8681,3830,3118,712,40,35,542,565,2720,2257,463,20,19,351,365
453,TRAVIS,453,0385A,4530385A,8927,4385,2611,1774,1321,73,327,395,3174,2023,1151,849,56,194,245
477,WASHINGTON,477,0419,4770419,9222,838,515,323,33,85,186,267,637,423,214,32,56,115,169
491,WILLIAMSON,491,0314,4910314,9468,6768,4016,2752,200,594,1899,2443,5535,3429,2106,154,451,1437,1865
161,FREESTONE,161,0008,1610008,3812,779,671,108,2,24,69,92,668,586,82,1,19,53,71
185,GRIMES,185,0010,1850010,4058,2210,1803,407,20,45,257,298,1785,1496,289,17,29,168,194
201,HARRIS,201,0382,2010382,4599,3246,796,2450,24,418,1994,2377,2174,668,1506,23,271,1195,1445
201,HARRIS,201,0136,2010136,4353,2752,296,2456,85,2128,268,2363,2283,277,2006,74,1756,193,1926
201,HARRIS,201,0922,2010922,5140,0,0,0,0,0,0,0,0,0,0,0,0,0,0
215,HIDALGO,215,0129,2150129,5681,258,30,228,3,4,223,224,184,29,155,1,2,152,153
29,BEXAR,29,2051,292051,463,1312,425,887,72,131,678,790,1226,406,820,68,119,619,723
29,BEXAR,29,3025,293025,629,2165,1581,584,109,39,403,436,1653,1221,432,77,38,295,327
39,BRAZORIA,39,0014,390014,1127,7659,5071,2588,73,995,1374,2320,5784,3936,1848,58,704,950,1634
83,COLEMAN,83,0001,830001,1625,1965,1545,420,19,65,281,332,1621,1308,313,15,43,199,241
113,DALLAS,113,2103,1132103,2289,2594,605,1989,65,341,1590,1901,2023,534,1489,54,266,1165,1410
113,DALLAS,113,4149,1134149,2787,186,11,175,0,4,166,170,134,5,129,0,1,126,127
467,VAN ZANDT,467,004D,467004D,9119,5247,4111,1136,30,285,629,899,4192,3388,804,17,227,391,613
479,WEBB,479,0403,4790403,9285,2386,48,2338,3,7,2326,2326,1640,31,1609,3,7,1600,1600
215,HIDALGO,215,0152,2150152,5704,4971,416,4555,58,31,4446,4461,3510,369,3141,41,16,3057,3065
251,JOHNSON,251,0043,2510043,6202,4940,1891,3049,385,1475,1172,2577,3385,1409,1976,264,936,734,1641
309,MCLENNAN,309,0067,3090067,6700,4346,3572,774,5,129,500,616,3355,2860,495,4,80,312,388
331,MILAM,331,0419,3310419,6866,3287,1842,1445,27,406,934,1309,2488,1533,955,19,287,584,854
355,NUECES,355,0083,3550083,7198,1888,136,1752,23,114,1632,1724,1392,103,1289,13,67,1214,1271
453,TRAVIS,453,0204,4530204,8787,4443,2847,1596,664,175,686,842,4178,2675,1503,624,156,651,789
113,DALLAS,113,1300,1131300,2123,6520,1292,5228,129,883,4193,5026,4559,1133,3426,94,582,2713,3266
113,DALLAS,113,3617,1133617,2621,3882,179,3703,36,3137,535,3634,2856,158,2698,33,2333,319,2640
121,DENTON,121,4194,1214194,3119,721,592,129,2,28,76,100,539,445,94,1,13,53,66
201,HARRIS,201,0988,2010988,5206,4818,2898,1920,69,574,1187,1724,3442,2204,1238,51,382,733,1094
201,HARRIS,201,0822,2010822,5040,2543,22,2521,26,1350,1170,2496,1911,20,1891,22,1109,770,1867
201,HARRIS,201,0491,2010491,4708,5779,2793,2986,1035,763,1112,1838,5079,2553,2526,851,645,939,1573
13,ATASCOSA,13,0014,130014,108,259,170,89,1,1,80,81,212,145,67,1,1,59,60
29,BEXAR,29,1024,291024,274,5007,785,4222,182,410,3685,4019,3811,698,3113,150,300,2671,2935
29,BEXAR,29,3166,293166,772,875,269,606,31,58,520,565,722,246,476,29,50,395,440
29,BEXAR,29,3002,293002,606,3179,1537,1642,274,142,1236,1353,2377,1208,1169,186,94,867,953
37,BOWIE,37,008B,37008B,1104,5168,3587,1581,46,1040,319,1344,3989,2901,1088,33,710,195,903
41,BRAZOS,41,0079,410079,1270,147,79,68,0,10,57,67,103,61,42,0,10,31,41
453,TRAVIS,453,0172,4530172,8764,606,328,278,52,38,186,218,450,268,182,15,23,137,156
479,WEBB,479,0275A,4790275A,9262,2040,39,2001,8,7,1996,1999,1262,20,1242,3,5,1239,1241
491,WILLIAMSON,491,0210,4910210,9428,3613,2498,1115,177,181,677,847,2482,1764,718,111,125,418,537
309,MCLENNAN,309,0089,3090089,6723,182,20,162,6,30,122,150,147,16,131,4,30,94,122
349,NAVARRO,349,0105,3490105,7055,550,309,241,7,41,176,210,376,233,143,3,19,107,123
355,NUECES,355,0105,3550105,7221,2081,84,1997,11,15,1973,1976,1493,59,1434,4,9,1420,1421
421,SHERMAN,421,0301,4210301,7719,302,164,138,5,4,127,129,217,132,85,3,3,77,78
439,TARRANT,439,3140,4393140,8266,2860,1939,921,96,139,567,679,2201,1585,616,74,85,362,440
453,TRAVIS,453,0386B,4530386B,8930,5,0,5,0,1,4,5,4,0,4,0,0,4,4
85,COLLIN,85,0139,850139,1768,9115,3194,5921,3371,1547,915,2388,6404,2529,3875,2132,1048,608,1627
113,DALLAS,113,2077,1132077,2266,2126,1254,872,163,180,522,689,1618,985,633,122,135,360,491
215,HIDALGO,215,0009,2150009,5561,4858,294,4564,49,31,4481,4505,3606,251,3355,33,23,3286,3307
245,JEFFERSON,245,0031,2450031,6059,1788,1435,353,37,54,201,255,1402,1148,254,22,39,142,181
257,KAUFMAN,257,0004,2570004,6225,3075,2291,784,43,258,419,668,2214,1711,503,34,167,244,407
303,LUBBOCK,303,0044,3030044,6557,2062,1284,778,10,48,676,723,1574,1022,552,10,25,480,505
9,ARCHER,9,0008,90008,82,371,333,38,3,3,23,24,307,281,26,3,0,12,12
29,BEXAR,29,4104,294104,915,3739,1184,2555,204,356,2006,2306,2740,955,1785,152,258,1364,1596
29,BEXAR,29,1001,291001,251,1026,329,697,31,32,630,650,891,307,584,26,22,528,547
29,BEXAR,29,2002,292002,414,2105,81,2024,11,37,1982,2007,1659,72,1587,7,24,1555,1574
41,BRAZOS,41,0056,410056,1247,15,15,0,0,0,0,0,15,15,0,0,0,0,0
113,DALLAS,113,3064,1133064,2501,3283,68,3215,27,2542,663,3177,2521,55,2466,14,2019,441,2446
453,TRAVIS,453,0364,4530364,8907,3609,2617,992,332,115,454,556,2647,1995,652,209,81,303,374
453,TRAVIS,453,0138,4530138,8738,7916,2228,5688,1775,1583,2383,3818,6254,1921,4333,1391,1159,1769,2844
497,WISE,497,0006,4970006,9571,3556,2371,1185,42,135,884,1000,2554,1798,756,33,91,541,619
209,HAYS,209,0423A,2090423A,5492,3350,1254,2096,114,199,1797,1954,2484,996,1488,77,144,1256,1380
287,LEE,287,0202,2870202,6414,3014,1631,1383,27,365,970,1316,2199,1327,872,17,221,609,825
349,NAVARRO,349,0403,3490403,7078,2242,1786,456,13,100,268,364,1694,1409,285,9,67,153,218
357,OCHILTREE,357,0003,3570003,7247,2612,1542,1070,15,12,971,978,1851,1170,681,8,4,611,615
439,TARRANT,439,1186,4391186,7911,913,705,208,69,45,82,127,809,648,161,54,35,61,96
439,TARRANT,439,2028,4392028,8074,1770,1247,523,74,139,262,388,1411,1050,361,51,92,166,257
123,DEWITT,123,0203,1230203,3168,1642,967,675,2,117,558,651,1205,771,434,2,77,339,412
141,EL PASO,141,0184,1410184,3497,0,0,0,0,0,0,0,0,0,0,0,0,0,0
165,GAINES,165,0003,1650003,3832,5532,3967,1565,20,39,1474,1502,3502,2518,984,12,23,924,943
189,HALE,189,0318,1890318,4161,1795,1019,776,14,34,693,722,1285,782,503,6,23,448,471
201,HARRIS,201,0611,2010611,4828,4042,40,4002,15,2519,1523,3980,2946,34,2912,14,1958,953,2894
201,HARRIS,201,0276,2010276,4493,3058,31,3027,14,2279,760,2998,2371,28,2343,8,1854,493,2321
29,BEXAR,29,2025,292025,437,4480,387,4093,21,106,3958,4040,3276,328,2948,12,71,2851,2907
61,CAMERON,61,0070,610070,1482,2293,89,2204,9,9,2177,2183,1694,66,1628,9,8,1604,1610
113,DALLAS,113,3041,1133041,2478,897,24,873,0,224,648,866,617,24,593,0,175,417,586
113,DALLAS,113,1401,1131401,2146,1275,135,1140,5,180,960,1131,874,111,763,3,129,634,758
121,DENTON,121,4216,1214216,3142,1732,951,781,146,280,319,582,1359,801,558,114,179,231,403
195,HANSFORD,195,0002,1950002,4187,109,69,40,1,4,34,34,71,50,21,1,0,18,18
439,TARRANT,439,1106,4391106,7888,3434,97,3337,13,2090,1249,3315,2504,72,2432,3,1691,739,2417
439,TARRANT,439,4540,4394540,8552,5972,2658,3314,748,896,1648,2479,4456,2140,2316,560,589,1105,1667
439,TARRANT,439,2181,4392181,8097,4183,2532,1651,147,541,851,1377,3292,2143,1149,123,365,576,935
439,TARRANT,439,4057,4394057,8429,955,647,308,47,95,132,224,915,635,280,42,86,119,205
465,VAL VERDE,465,0023,4650023,9093,271,97,174,4,6,160,164,212,85,127,4,4,113,117
201,HARRIS,201,0634,2010634,4851,6209,1972,4237,167,1451,2536,3902,4528,1646,2882,137,928,1738,2623
201,HARRIS,201,0965,2010965,5183,1053,325,728,32,25,663,679,727,264,463,29,16,407,420
221,HOOD,221,0218,2210218,5847,2840,2563,277,30,16,141,153,2518,2295,223,22,12,105,113
337,MONTAGUE,337,0015,3370015,6892,759,644,115,7,11,66,75,614,531,83,7,7,42,49
375,POTTER,375,0324,3750324,7433,6233,4602,1631,324,316,819,1108,4936,3781,1155,246,227,541,752
397,ROCKWALL,397,0004A,3970004A,7556,2309,1317,992,81,145,687,828,1595,1005,590,37,75,413,486
41,BRAZOS,41,0098,410098,1290,13,8,5,0,1,5,5,12,8,4,0,1,4,4
85,COLLIN,85,0159,850159,1788,6396,2352,4044,939,896,2158,3016,4409,1728,2681,691,598,1332,1910
95,CONCHO,95,0407,950407,1954,185,163,22,6,3,10,12,163,145,18,4,2,8,10
97,COOKE,97,0006,970006,1960,2991,2567,424,8,30,224,246,2350,2075,275,7,5,138,142
141,EL PASO,141,0141,1410141,3454,2602,117,2485,6,48,2435,2457,1990,99,1891,5,26,1856,1869
167,GALVESTON,167,0245,1670245,3875,1906,372,1534,17,937,579,1480,1385,300,1085,9,687,370,1042
391,REFUGIO,391,004A,391004A,7533,561,203,358,8,15,334,347,444,175,269,4,10,252,260
423,SMITH,423,0076,4230076,7788,2977,435,2542,38,597,1894,2467,2090,362,1728,33,446,1240,1673
439,TARRANT,439,1622,4391622,8031,62,22,40,8,7,22,29,45,16,29,8,7,11,18
439,TARRANT,439,4118,4394118,8452,2368,1275,1093,143,573,366,918,1937,1110,827,122,399,285,671
439,TARRANT,439,1348,4391348,7954,1212,898,314,35,76,181,247,965,728,237,30,56,124,179
439,TARRANT,439,2548,4392548,8197,2300,1614,686,122,217,281,472,1675,1217,458,95,137,171,293
171,GILLESPIE,171,0015,1710015,3952,878,777,101,1,5,74,75,775,706,69,1,1,49,50
187,GUADALUPE,187,0304,1870304,4118,5389,2911,2478,295,613,1535,2084,4166,2368,1798,204,452,1077,1502
201,HARRIS,201,1151,2011151,5369,5988,3334,2654,778,520,1242,1719,3877,2229,1648,497,342,719,1042
223,HOPKINS,223,0017,2230017,5867,1877,1508,369,15,53,251,302,1380,1140,240,8,32,159,191
245,JEFFERSON,245,0005,2450005,6033,2569,879,1690,67,1110,494,1585,1905,764,1141,53,754,315,1062
245,JEFFERSON,245,0011,2450011,6039,943,321,622,3,451,166,611,820,317,503,3,366,128,493
29,BEXAR,29,3045,293045,649,1900,1185,715,106,25,548,570,1573,1027,546,86,17,408,424
39,BRAZORIA,39,0034,390034,1147,10268,4995,5273,136,229,4633,4829,7645,4035,3610,106,156,3109,3253
45,BRISCOE,45,0006,450006,1313,99,74,25,3,1,25,25,71,56,15,2,0,15,15
85,COLLIN,85,0182,850182,1811,5897,3125,2772,1231,735,719,1416,4321,2460,1861,812,474,484,943
113,DALLAS,113,4518,1134518,2813,6621,1105,5516,214,541,4694,5203,4651,960,3691,181,391,3056,3433
139,ELLIS,139,1057,1391057,3311,3352,2137,1215,114,575,458,1016,2537,1688,849,92,408,295,698
211,HEMPHILL,211,0301,2110301,5518,681,537,144,7,4,122,125,514,420,94,5,0,83,83
241,JASPER,241,0013,2410013,6016,658,473,185,1,133,28,161,519,378,141,0,104,15,119
251,JOHNSON,251,0023,2510023,6182,3829,3060,769,22,73,545,612,2923,2382,541,18,49,354,400
309,MCLENNAN,309,0048,3090048,6680,1542,313,1229,14,317,893,1198,1126,273,853,11,208,621,827
481,WHARTON,481,0101,4810101,9305,869,399,470,10,232,222,446,694,331,363,10,200,146,345
141,EL PASO,141,0041,1410041,3354,1682,85,1597,16,37,1554,1576,1381,79,1302,11,19,1275,1285
141,EL PASO,141,0164,1410164,3477,6732,155,6577,42,59,6501,6517,4991,121,4870,25,26,4811,4821
167,GALVESTON,167,0172,1670172,3852,1069,645,424,20,168,235,399,961,589,372,19,137,211,348
177,GONZALES,177,0012,1770012,3975,280,133,147,6,10,131,137,200,111,89,3,3,80,82
181,GRAYSON,181,0403,1810403,4018,4655,4048,607,43,71,193,259,3984,3531,453,29,36,133,169
201,HARRIS,201,0299,2010299,4516,6127,675,5452,105,670,4697,5315,4318,602,3716,80,467,3164,3595
11,ARMSTRONG,11,0101,110101,88,473,419,54,4,4,32,35,356,316,40,2,2,21,22
29,BEXAR,29,3143,293143,749,2018,701,1317,139,102,1075,1149,1646,628,1018,110,74,827,882
39,BRAZORIA,39,0057,390057,1170,1969,998,971,37,61,824,880,1476,798,678,29,53,552,602
61,CAMERON,61,0001,610001,1413,2059,378,1681,11,21,1650,1658,1580,349,1231,6,10,1212,1216
107,CROSBY,107,0039,1070039,2003,1218,462,756,8,59,698,744,884,380,504,0,39,461,496
113,DALLAS,113,1107,1131107,2080,2383,171,2212,13,183,2018,2191,1648,146,1502,7,122,1368,1487
453,TRAVIS,453,0145,4530145,8744,2878,912,1966,90,477,1396,1819,2068,750,1318,59,335,911,1213
491,WILLIAMSON,491,0164,4910164,9405,767,400,367,47,91,218,305,620,346,274,32,70,153,223
201,HARRIS,201,0442,2010442,4659,5618,4093,1525,221,301,835,1118,4407,3319,1088,157,227,579,793
251,JOHNSON,251,0001,2510001,6159,640,472,168,10,33,109,133,447,346,101,5,13,65,77
303,LUBBOCK,303,0078,3030078,6580,4108,2898,1210,285,137,693,824,3120,2310,810,206,79,445,521
355,NUECES,355,0125,3550125,7241,4971,1460,3511,370,296,2882,3130,3515,1120,2395,237,198,1944,2128
373,POLK,373,0017,3730017,7413,2345,1927,418,16,124,222,343,1940,1643,297,9,102,140,240
439,TARRANT,439,4630,4394630,8572,0,0,0,0,0,0,0,0,0,0,0,0,0,0
121,DENTON,121,9303,1219303,3162,0,0,0,0,0,0,0,0,0,0,0,0,0,0
141,EL PASO,141,0021,1410021,3334,2752,946,1806,78,65,1649,1703,2260,822,1438,62,46,1317,1352
181,GRAYSON,181,0109,1810109,3995,6657,5039,1618,93,241,961,1191,4871,3828,1043,58,174,583,754
189,HALE,189,0420,1890420,4167,576,406,170,7,6,150,156,445,322,123,4,4,108,112
201,HARRIS,201,1108,2011108,5326,688,64,624,9,489,145,604,464,51,413,8,303,103,394
201,HARRIS,201,1031,2011031,5249,5691,1535,4156,45,807,3256,4020,3881,1242,2639,33,524,2022,2527
61,CAMERON,61,0027,610027,1439,4715,219,4496,13,29,4455,4462,3340,168,3172,5,15,3143,3148
99,CORYELL,99,0308,990308,1980,6413,5084,1329,90,239,802,1019,4794,3965,829,58,141,478,606
113,DALLAS,113,3084,1133084,2521,1990,644,1346,93,605,630,1218,1767,615,1152,91,543,507,1040
113,DALLAS,113,1143,1131143,2103,2364,1986,378,78,95,155,248,1599,1338,261,50,75,97,171
113,DALLAS,113,3952,1133952,2644,257,28,229,6,181,51,225,178,22,156,5,122,35,152
127,DIMMIT,127,0006,1270006,3185,1533,150,1383,19,20,1333,1347,1129,128,1001,14,17,962,974
371,PECOS,371,0003,3710003,7390,238,121,117,4,17,93,107,187,102,85,1,15,67,80
439,TARRANT,439,1265,4391265,7931,3175,1094,2081,86,1203,755,1917,2441,975,1466,65,844,523,1342
439,TARRANT,439,1717,4391717,8054,4339,1802,2537,124,1019,1284,2257,3102,1467,1635,86,650,785,1420
439,TARRANT,439,4733,4394733,8595,4554,1795,2759,1100,866,754,1585,2942,1198,1744,735,531,449,963
189,HALE,189,0110,1890110,4144,519,305,214,3,4,196,198,403,261,142,3,3,126,127
201,HARRIS,201,0591,2010591,4808,5893,334,5559,28,239,5324,5514,4177,281,3896,18,184,3707,3859
201,HARRIS,201,1008,2011008,5226,2004,1397,607,35,148,379,516,1510,1109,401,20,93,247,335
469,VICTORIA,469,0031,4690031,9151,2447,876,1571,44,282,1254,1498,1877,773,1104,27,206,861,1049
473,WALLER,473,0419,4730419,9194,5631,1042,4589,58,1504,3012,4454,4055,873,3182,47,1064,2027,3068
131,DUVAL,131,0009,1310009,3200,1919,251,1668,3,140,1256,1391,1586,231,1355,0,136,1004,1137
201,HARRIS,201,0606,2010606,4823,1824,13,1811,12,1272,542,1797,1191,11,1180,7,867,319,1173
201,HARRIS,201,0108,2010108,4325,9880,1964,7916,259,3157,4306,7344,7113,1725,5388,229,2097,2898,4928
201,HARRIS,201,0649,2010649,4866,10702,705,9997,1923,3047,5104,8010,7893,606,7287,1644,2138,3548,5598
201,HARRIS,201,1146,2011146,5364,4911,2718,2193,678,178,1151,1323,3167,1842,1325,410,110,665,773
295,LIPSCOMB,295,0409,2950409,6489,296,106,190,0,4,181,184,214,82,132,0,2,124,126
13,ATASCOSA,13,0003,130003,97,2719,1068,1651,26,44,1521,1559,2013,860,1153,19,23,1064,1085
29,BEXAR,29,4125,294125,936,258,63,195,4,81,105,185,208,51,157,4,70,81,150
29,BEXAR,29,1096,291096,346,384,44,340,1,18,312,326,248,35,213,1,13,190,202
39,BRAZORIA,39,0066,390066,1179,7311,1550,5761,2552,2059,1177,3168,4864,1088,3776,1717,1306,748,2023
111,DALLAM,111,0009,1110009,2018,1680,611,1069,10,45,981,1024,1190,468,722,7,31,657,687
113,DALLAS,113,2056,1132056,2261,1572,1253,319,131,53,110,160,1341,1101,240,108,30,83,111
439,TARRANT,439,4344,4394344,8510,1770,1454,316,57,55,178,226,1522,1286,236,49,50,122,166
439,TARRANT,439,3063,4393063,8261,2338,1723,615,89,102,360,448,1858,1445,413,67,54,226,278
485,WICHITA,485,0303,4850303,9343,4138,1190,2948,51,1405,1477,2809,2973,994,1979,30,974,923,1872
497,WISE,497,0029,4970029,9592,1263,346,917,12,23,873,890,875,286,589,11,11,561,570
201,HARRIS,201,0208,2010208,4425,5013,409,4604,9,617,3966,4562,3580,346,3234,3,473,2734,3197
201,HARRIS,201,1046,2011046,5264,1908,534,1374,116,235,1018,1237,1447,456,991,96,177,710,880
245,JEFFERSON,245,0069,2450069,6097,5429,3394,2035,399,396,1145,1518,4127,2775,1352,297,251,712,958
277,LAMAR,277,001C,277001C,6346,412,364,48,4,12,17,28,311,283,28,4,6,11,17
355,NUECES,355,0064,3550064,7179,1156,711,445,34,45,334,368,897,583,314,24,19,229,247
375,POTTER,375,0224,3750224,7428,6793,1861,4932,129,434,4349,4705,4657,1504,3153,82,198,2803,2983
113,DALLAS,113,4611,1134611,2851,4965,1096,3869,136,333,3361,3672,3653,935,2718,106,249,2319,2560
121,DENTON,121,4175,1214175,3100,674,372,302,45,128,124,249,627,349,278,43,113,116,226
141,EL PASO,141,0030,1410030,3343,381,15,366,14,11,342,346,280,5,275,7,2,262,263
167,GALVESTON,167,4801,1674801,3933,0,0,0,0,0,0,0,0,0,0,0,0,0,0
193,HAMILTON,193,0015,1930015,4182,310,252,58,2,3,32,35,241,195,46,2,2,24,26
201,HARRIS,201,0797,2010797,5015,0,0,0,0,0,0,0,0,0,0,0,0,0,0
27,BELL,27,0412,270412,246,7055,1622,5433,430,3290,1765,4791,5036,1326,3710,328,2189,1166,3231
29,BEXAR,29,3181,293181,787,3498,1660,1838,374,219,1186,1376,2575,1321,1254,254,143,804,935
49,BROWN,49,0303,490303,1328,1943,1269,674,31,118,487,595,1406,952,454,21,71,320,389
85,COLLIN,85,0240,850240,1869,8017,5512,2505,503,622,1131,1735,5159,3647,1512,307,380,686,1055
113,DALLAS,113,2609,1132609,2410,26,2,24,6,1,11,12,14,0,14,5,0,4,4
121,DENTON,121,1027,1211027,2951,1407,590,817,174,334,278,607,997,449,548,131,222,179,396
315,MARION,315,0005,3150005,6738,896,662,234,7,166,29,191,745,559,186,6,142,17,157
361,ORANGE,361,0024,3610024,7279,2631,2190,441,102,46,256,292,1943,1663,280,82,21,138,159
431,STERLING,431,0002B,4310002B,7820,0,0,0,0,0,0,0,0,0,0,0,0,0,0
439,TARRANT,439,3539,4393539,8361,34,19,15,8,3,1,4,27,17,10,5,1,1,2
453,TRAVIS,453,0358,4530358,8902,4218,3031,1187,240,137,730,856,3313,2436,877,170,91,542,629
491,WILLIAMSON,491,0259,4910259,9443,2576,1677,899,279,147,425,563,1885,1260,625,191,106,274,379
141,EL PASO,141,0179,1410179,3492,1689,32,1657,8,23,1642,1649,1113,25,1088,5,14,1075,1081
183,GREGG,183,0006,1830006,4033,3904,2768,1136,225,472,321,772,2790,2071,719,154,273,213,482
201,HARRIS,201,0897,2010897,5115,3853,1277,2576,218,1162,1152,2263,3053,1097,1956,194,882,828,1687
201,HARRIS,201,0357,2010357,4574,5680,3689,1991,326,336,1188,1498,4040,2747,1293,241,189,750,928
215,HIDALGO,215,0104,2150104,5656,9209,251,8958,52,45,8862,8873,5780,186,5594,27,25,5535,5545
251,JOHNSON,251,0038,2510038,6197,1962,1163,799,13,49,643,688,1337,874,463,12,19,375,394
19,BANDERA,19,0408,190408,143,261,217,44,3,6,29,34,230,199,31,3,2,20,21
29,BEXAR,29,3201,293201,807,6426,3216,3210,533,625,2044,2613,4426,2319,2107,338,417,1301,1688
29,BEXAR,29,2063,292063,475,2469,1220,1249,115,126,974,1071,1894,1017,877,73,73,698,755
39,BRAZORIA,39,0026,390026,1139,7585,2266,5319,805,1193,3305,4424,5498,1805,3693,575,849,2200,3017
61,CAMERON,61,0059,610059,1471,520,406,114,14,15,81,92,495,403,92,11,11,65,73
85,COLLIN,85,0174,850174,1803,7116,3812,3304,659,1146,1333,2423,4996,2817,2179,445,724,851,1553
453,TRAVIS,453,0432,4530432,8965,1431,726,705,45,38,598,624,1235,657,578,32,25,498,513
479,WEBB,479,0447,4790447,9297,7985,435,7550,22,37,7476,7493,5157,277,4880,16,15,4837,4845
507,ZAVALA,507,0001,5070001,9629,854,107,747,7,5,736,739,654,76,578,7,2,572,572
203,HARRISON,203,0001,2030001,5384,3242,1839,1403,73,738,530,1261,2424,1492,932,41,529,303,828
215,HIDALGO,215,0164,2150164,5716,4128,523,3605,142,43,3415,3438,2896,467,2429,111,23,2275,2291
407,SAN JACINTO,407,0004,4070004,7637,1079,908,171,15,39,87,121,837,725,112,11,28,49,74
439,TARRANT,439,1414,4391414,7969,67,26,41,0,16,25,41,57,20,37,0,16,21,37
439,TARRANT,439,3321,4393321,8301,4252,2820,1432,168,131,1020,1131,3414,2381,1033,124,96,726,809
441,TAYLOR,441,0409,4410409,8633,1278,1020,258,9,33,147,173,953,779,174,8,16,92,106
141,EL PASO,141,0079,1410079,3392,1727,59,1668,17,22,1626,1642,1274,45,1229,13,17,1194,1208
157,FORT BEND,157,3105,1573105,3724,891,121,770,621,84,58,136,679,91,588,481,52,42,92
185,GRIMES,185,0008,1850008,4056,1067,755,312,6,100,185,278,817,605,212,5,71,112,181
201,HARRIS,201,0171,2010171,4388,3991,91,3900,43,1562,2317,3852,2682,78,2604,31,1095,1480,2568
201,HARRIS,201,0834,2010834,5052,624,20,604,7,532,71,600,350,13,337,7,297,38,333
201,HARRIS,201,0503,2010503,4720,4303,2688,1615,437,338,768,1066,3010,1878,1132,324,232,526,733
15,AUSTIN,15,0205,150205,120,3961,2835,1126,39,340,649,975,3067,2290,777,32,252,415,664
29,BEXAR,29,2040,292040,452,4831,689,4142,80,334,3728,4014,3745,601,3144,62,234,2836,3048
29,BEXAR,29,3178,293178,784,1,0,1,0,0,1,1,1,0,1,0,0,1,1
39,BRAZORIA,39,0003,390003,1116,7626,4406,3220,115,394,2563,2914,5700,3545,2155,68,234,1720,1941
201,HARRIS,201,0857,2010857,5075,0,0,0,0,0,0,0,0,0,0,0,0,0,0
201,HARRIS,201,0194,2010194,4411,3753,1766,1987,592,737,604,1313,3335,1635,1700,502,661,501,1142
453,TRAVIS,453,0402,4530402,8942,4629,2065,2564,232,358,1892,2216,4057,1918,2139,205,319,1547,1834
479,WEBB,479,0344,4790344,9274,5705,362,5343,136,45,5191,5205,4317,284,4033,107,24,3908,3917
339,MONTGOMERY,339,0052,3390052,6950,9815,4450,5365,139,355,4663,4960,6889,3547,3342,91,232,2833,3039
361,ORANGE,361,0027,3610027,7282,2908,2616,292,24,14,172,184,2254,2051,203,20,6,114,119
401,RUSK,401,0418,4010418,7614,3345,2168,1177,4,413,674,1081,2570,1770,800,1,312,418,726
439,TARRANT,439,1300,4391300,7946,4815,928,3887,285,1828,1796,3560,3471,828,2643,186,1250,1179,2416
439,TARRANT,439,3187,4393187,8278,2661,1628,1033,151,149,625,765,2004,1322,682,103,94,406,498
441,TAYLOR,441,0201,4410201,8610,4143,1478,2665,62,474,2093,2505,3116,1251,1865,42,320,1446,1737
201,HARRIS,201,0526,2010526,4743,2408,148,2260,40,143,2077,2201,1826,131,1695,32,110,1560,1652
203,HARRISON,203,0024,2030024,5407,1639,1154,485,11,244,162,404,1232,888,344,7,199,88,286
215,HIDALGO,215,0187,2150187,5739,5722,808,4914,12,23,4862,4866,4279,773,3506,7,16,3466,3469
245,JEFFERSON,245,0043,2450043,6071,4016,2535,1481,157,260,1061,1279,3059,2074,985,109,195,670,834
285,LAVACA,285,0223,2850223,6403,1882,1386,496,7,40,425,461,1455,1130,325,0,23,281,303
315,MARION,315,0002,3150002,6735,1662,1358,304,16,114,90,200,1408,1185,223,12,91,54,142
29,BEXAR,29,4042,294042,853,591,110,481,37,205,231,428,409,88,321,34,136,144,279
39,BRAZORIA,39,0072,390072,1185,3849,846,3003,1205,1216,606,1775,2638,599,2039,849,811,386,1174
63,CAMP,63,4004,634004,1517,3070,1764,1306,45,486,716,1193,2299,1410,889,35,351,450,798
85,COLLIN,85,0220,850220,1849,9015,2258,6757,4661,1114,865,1921,5689,1567,4122,2846,668,529,1171
113,DALLAS,113,4605,1134605,2845,5577,1308,4269,301,578,3344,3895,4079,1145,2934,225,395,2269,2642
113,DALLAS,113,3076,1133076,2513,0,0,0,0,0,0,0,0,0,0,0,0,0,0
439,TARRANT,439,4702,4394702,8587,2724,1449,1275,177,341,725,1043,1836,1002,834,112,206,482,677
351,NEWTON,351,0008B,3510008B,7090,163,41,122,1,109,3,112,137,37,100,1,89,1,90
361,ORANGE,361,0004,3610004,7259,947,66,881,6,826,47,869,651,54,597,2,552,41,589
375,POTTER,375,0124,3750124,7422,3599,2427,1172,129,164,791,932,2650,1915,735,71,76,503,572
399,RUNNELS,399,0010,3990010,7591,503,403,100,1,2,88,89,380,301,79,1,1,67,68
439,TARRANT,439,1237,4391237,7923,2773,293,2480,45,184,2264,2428,1866,254,1612,34,106,1476,1571
439,TARRANT,439,3039,4393039,8255,2355,1883,472,201,71,141,209,1741,1418,323,121,47,102,148
245,JEFFERSON,245,0066,2450066,6094,2061,1404,657,27,308,281,578,1582,1147,435,7,197,193,387
259,KENDALL,259,2020,2592020,6263,2702,2179,523,63,28,353,379,2210,1838,372,51,21,248,268
289,LEON,289,0002,2890002,6426,441,381,60,1,8,38,46,365,321,44,1,4,29,33
303,LUBBOCK,303,0121,3030121,6595,4780,3284,1496,113,172,1094,1224,3389,2414,975,85,98,682,768
321,MATAGORDA,321,0007,3210007,6758,335,242,93,14,5,74,77,255,192,63,13,0,48,48
339,MONTGOMERY,339,0032,3390032,6927,4848,2695,2153,312,472,1221,1676,3785,2285,1500,234,272,878,1139
113,DALLAS,113,1723,1131723,2181,645,103,542,30,208,307,511,413,81,332,21,134,173,306
125,DICKENS,125,0004,1250004,3177,437,230,207,7,22,182,196,335,190,145,7,15,127,137
201,HARRIS,201,0880,2010880,5098,4681,2493,2188,630,315,1174,1468,3285,1883,1402,409,204,753,945
209,HAYS,209,0110,2090110,5430,3676,1359,2317,104,168,2002,2134,2778,1146,1632,67,120,1396,1503
215,HIDALGO,215,0210,2150210,5762,1064,14,1050,0,2,1050,1050,685,12,673,0,2,673,673
227,HOWARD,227,207C,227207C,5931,911,556,355,15,19,312,324,640,402,238,5,10,214,222
21,BASTROP,21,4021,214021,166,5065,2413,2652,56,327,2136,2452,3852,2045,1807,42,245,1387,1627
29,BEXAR,29,4019,294019,830,6575,850,5725,48,724,5009,5633,4687,723,3964,38,522,3417,3890
29,BEXAR,29,2085,292085,498,2652,311,2341,28,70,2249,2300,1978,276,1702,19,42,1627,1664
39,BRAZORIA,39,0049,390049,1162,2429,1923,506,22,69,350,415,1810,1486,324,15,52,208,260
61,CAMERON,61,0082,610082,1494,5797,289,5508,14,18,5466,5473,3868,245,3623,6,10,3598,3605
85,COLLIN,85,0197,850197,1826,2446,731,1715,1387,142,159,294,1712,603,1109,895,96,98,191
353,NOLAN,353,0007,3530007,7113,369,306,63,0,11,33,41,295,253,42,0,6,17,22
355,NUECES,355,0120,3550120,7236,3542,1149,2393,84,158,2116,2249,2684,982,1702,60,104,1494,1587
377,PRESIDIO,377,0003,3770003,7445,56,3,53,0,1,51,52,46,3,43,0,1,41,42
397,ROCKWALL,397,002E,397002E,7568,6171,1902,4269,244,833,3096,3892,4349,1509,2840,171,532,2054,2572
423,SMITH,423,0056,4230056,7777,5178,3550,1628,194,716,566,1252,4386,3080,1306,151,603,429,1008
439,TARRANT,439,2228,4392228,8109,2895,2035,860,229,224,358,568,2340,1704,636,178,166,251,412
245,JEFFERSON,245,0089,2450089,6117,1241,238,1003,14,783,196,967,900,216,684,8,532,132,656
257,KAUFMAN,257,0019,2570019,6240,4159,2551,1608,51,451,1036,1460,3233,2145,1088,32,320,664,977
291,LIBERTY,291,0013,2910013,6449,1508,1283,225,4,68,99,162,1120,977,143,1,37,61,94
303,LUBBOCK,303,0062,3030062,6572,3623,2284,1339,171,196,912,1080,2947,1949,998,137,119,669,787
323,MAVERICK,323,003A,323003A,6781,5624,179,5445,24,27,5398,5412,4014,149,3865,14,11,3837,3845
339,MONTGOMERY,339,0011,3390011,6904,3780,2508,1272,75,222,846,1043,2871,2029,842,39,141,560,688
113,DALLAS,113,3053,1133053,2490,5986,228,5758,52,4173,1547,5666,4410,208,4202,43,3117,1043,4127
113,DALLAS,113,1700,1131700,2158,5318,985,4333,155,467,3697,4130,3868,858,3010,107,294,2568,2852
201,HARRIS,201,1026,2011026,5244,5385,1107,4278,72,210,3965,4142,3762,948,2814,45,143,2580,2707
215,HIDALGO,215,0233,2150233,5785,22,0,22,2,0,17,17,9,0,9,2,0,4,4
215,HIDALGO,215,0024,2150024,5576,156,52,104,1,1,102,103,121,46,75,0,1,73,74
227,HOWARD,227,0033,2270033,5908,2810,1442,1368,51,178,1099,1254,2076,1187,889,28,112,710,812
29,BEXAR,29,4165,294165,976,177,103,74,0,5,69,69,147,87,60,0,2,58,58
29,BEXAR,29,1056,291056,306,7039,585,6454,107,257,6142,6346,4766,442,4324,67,155,4094,4235
29,BEXAR,29,1062,291062,312,441,69,372,13,21,344,360,306,54,252,10,9,236,244
85,COLLIN,85,0011,850011,1640,7059,4432,2627,94,374,1935,2306,5089,3409,1680,58,274,1177,1449
113,DALLAS,113,2118,1132118,2304,3025,103,2922,21,890,2028,2891,2286,97,2189,16,705,1469,2166
113,DALLAS,113,4659,1134659,2891,740,102,638,2,30,595,621,528,90,438,1,23,403,422
303,LUBBOCK,303,0035,3030035,6549,1183,842,341,7,25,281,300,968,735,233,7,13,188,197
327,MENARD,327,0003,3270003,6804,500,368,132,5,9,111,117,436,331,105,5,6,88,91
381,RANDALL,381,0222,3810222,7468,6053,4612,1441,139,226,911,1116,4669,3674,995,87,157,606,751
439,TARRANT,439,2309,4392309,8132,5218,770,4448,75,270,4067,4315,3560,686,2874,56,169,2616,2771
453,TRAVIS,453,0215,4530215,8796,1396,775,621,139,81,379,445,1243,720,523,121,69,317,376
469,VICTORIA,469,0014,4690014,9134,2169,1131,1038,4,104,927,1007,1662,925,737,3,67,653,715
143,ERATH,143,0045,1430045,3555,5156,3157,1999,82,794,1008,1798,4655,2811,1844,74,764,906,1668
201,HARRIS,201,1003,2011003,5221,449,159,290,43,129,109,237,419,157,262,41,116,95,210
201,HARRIS,201,0666,2010666,4883,0,0,0,0,0,0,0,0,0,0,0,0,0,0
201,HARRIS,201,0340,2010340,4557,5014,3238,1776,153,301,1220,1491,3746,2558,1188,99,198,802,986
201,HARRIS,201,0003,2010003,4219,4620,3270,1350,317,130,814,932,3564,2585,979,178,85,649,729
225,HOUSTON,225,0009,2250009,5885,573,480,93,3,30,41,67,462,401,61,1,13,26,38
29,BEXAR,29,4182,294182,993,0,0,0,0,0,0,0,0,0,0,0,0,0,0
29,BEXAR,29,1079,291079,329,4942,992,3950,314,665,3071,3612,3603,797,2806,223,462,2131,2551
85,COLLIN,85,0034,850034,1663,6364,1909,4455,3828,270,338,582,4715,1564,3151,2688,206,236,422
113,DALLAS,113,2143,1132143,2327,729,421,308,89,101,101,196,682,404,278,88,88,82,169
113,DALLAS,113,4628,1134628,2868,5574,755,4819,1148,2413,1252,3586,4306,683,3623,960,1729,922,2607
113,DALLAS,113,1746,1131746,2204,3154,787,2367,472,630,1275,1875,2404,670,1734,356,471,889,1354
201,HARRIS,201,0980,2010980,5198,1694,884,810,379,136,276,411,1417,769,648,316,122,195,317
223,HOPKINS,223,0011,2230011,5862,1191,1031,160,6,16,79,95,923,815,108,4,14,47,61
383,REAGAN,383,0003A,3830003A,7491,705,232,473,7,18,442,454,468,190,278,4,11,256,266
439,TARRANT,439,2401,4392401,8155,914,411,503,14,195,294,480,768,400,368,12,141,209,345
453,TRAVIS,453,0245,4530245,8819,5596,2926,2670,1033,403,1139,1502,5339,2841,2498,977,377,1047,1387
491,WILLIAMSON,491,0343,4910343,9483,5135,3406,1729,156,297,1181,1446,4108,2862,1246,130,215,815,1004
121,DENTON,121,2067,1212067,2991,4853,1756,3097,56,200,2750,2934,3442,1480,1962,39,128,1716,1830
141,EL PASO,141,0217,1410217,3532,1167,23,1144,12,16,1132,1136,714,13,701,9,10,694,698
157,FORT BEND,157,2036,1572036,3655,1444,38,1406,19,1185,213,1387,1140,36,1104,18,931,161,1085
167,GALVESTON,167,0224,1670224,3870,5633,3009,2624,366,722,1444,2135,4714,2701,2013,320,529,1073,1596
197,HARDEMAN,197,0003,1970003,4196,873,519,354,4,42,285,319,661,427,234,3,27,181,204
201,HARRIS,201,0317,2010317,4534,4030,666,3364,241,1974,1200,3089,3022,569,2453,185,1427,859,2247
113,DALLAS,113,2226,1132226,2350,3771,3197,574,290,33,149,177,2606,2251,355,172,28,99,124
121,DENTON,121,2090,1212090,3014,7585,3628,3957,964,1165,1721,2823,5827,2946,2881,741,805,1223,1997
127,DIMMIT,127,0004,1270004,3183,101,16,85,1,1,85,85,87,13,74,1,1,74,74
157,FORT BEND,157,2109,1572109,3678,1777,490,1287,168,478,668,1117,1312,399,913,131,376,425,782
167,GALVESTON,167,0159,1670159,3847,9683,4613,5070,278,627,3959,4555,7120,3778,3342,225,393,2540,2917
201,HARRIS,201,0048,2010048,4265,1637,155,1482,29,782,709,1454,1282,126,1156,25,663,494,1134
491,WILLIAMSON,491,0398,4910398,9506,5740,3303,2437,1116,373,860,1192,4188,2542,1646,732,255,572,812
351,NEWTON,351,0013,3510013,7096,1294,1164,130,8,30,47,77,1054,966,88,7,17,25,42
423,SMITH,423,0039,4230039,7760,527,143,384,2,271,102,370,408,106,302,1,228,65,290
439,TARRANT,439,2468,4392468,8178,3434,1899,1535,380,453,620,1061,2698,1562,1136,304,331,423,749
439,TARRANT,439,4047,4394047,8424,5972,4729,1243,60,113,813,910,4654,3829,825,44,54,503,550
453,TRAVIS,453,0274,4530274,8842,6071,3900,2171,742,311,977,1275,4436,2958,1478,499,211,654,861
465,VAL VERDE,465,0012D,4650012D,9088,0,0,0,0,0,0,0,0,0,0,0,0,0,0
201,HARRIS,201,0294,2010294,4511,2437,28,2409,18,1898,512,2388,1906,22,1884,13,1546,337,1867
201,HARRIS,201,0711,2010711,4929,10264,3221,7043,2570,2180,2241,4315,7835,2601,5234,1866,1613,1689,3237
201,HARRIS,201,0957,2010957,5175,1061,71,990,87,458,463,904,794,56,738,75,364,310,664
201,HARRIS,201,0125,2010125,4342,4939,1630,3309,382,1144,1743,2833,3695,1379,2316,287,740,1220,1937
215,HIDALGO,215,0041,2150041,5593,10189,159,10030,19,28,9991,9993,6707,111,6596,14,12,6573,6574
257,KAUFMAN,257,0036,2570036,6257,4069,2150,1919,179,871,759,1609,2757,1587,1170,120,513,437,943
113,DALLAS,113,3059,1133059,2496,1443,37,1406,5,1169,237,1399,1150,31,1119,4,976,146,1115
121,DENTON,121,9301,1219301,3160,0,0,0,0,0,0,0,0,0,0,0,0,0,0
121,DENTON,121,2113,1212113,3037,4462,2425,2037,988,314,671,974,3735,2098,1637,828,222,524,743
147,FANNIN,147,0010,1470010,3578,4097,3179,918,27,97,593,685,3033,2447,586,22,72,356,424
157,FORT BEND,157,3043,1573043,3701,2093,257,1836,512,521,800,1289,1551,208,1343,402,391,551,924
163,FRIO,163,0003,1630003,3824,1260,28,1232,0,15,1210,1223,915,21,894,0,12,876,888
491,WILLIAMSON,491,0433,4910433,9529,7340,4336,3004,1056,456,1351,1762,5051,3123,1928,700,272,822,1082
423,SMITH,423,0066,4230066,7783,1600,470,1130,3,254,862,1108,1164,422,742,1,210,523,727
439,TARRANT,439,4107,4394107,8447,2920,206,2714,54,142,2534,2657,2069,168,1901,51,114,1745,1849
439,TARRANT,439,3384,4393384,8324,2692,1737,955,167,198,532,718,2057,1417,640,128,127,341,459
453,TRAVIS,453,0315,4530315,8865,4827,2229,2598,1365,250,985,1225,4733,2187,2546,1333,246,966,1205
453,TRAVIS,453,0463,4530463,8988,2211,655,1556,99,231,1215,1422,1667,580,1087,78,159,828,977
467,VAN ZANDT,467,002D,467002D,9111,2604,2210,394,19,37,241,275,2071,1799,272,14,18,165,183
201,HARRIS,201,0811,2010811,5029,539,21,518,2,14,504,514,414,15,399,1,12,386,395
201,HARRIS,201,0026,2010026,4242,3563,703,2860,153,224,2484,2671,2894,642,2252,136,181,1919,2078
201,HARRIS,201,0271,2010271,4488,3599,26,3573,11,3187,400,3553,2737,18,2719,7,2480,246,2704
201,HARRIS,201,0148,2010148,4365,3717,2244,1473,824,188,387,558,2877,1786,1091,624,139,274,403
201,HARRIS,201,0688,2010688,4906,6499,4143,2356,611,440,1162,1566,4860,3318,1542,392,294,719,1002
215,HIDALGO,215,0018,2150018,5570,810,29,781,0,1,779,779,555,14,541,0,1,539,539
57,CALHOUN,57,0001,570001,1394,3159,419,2740,94,93,2562,2624,2279,333,1946,56,58,1829,1873
113,DALLAS,113,4065,1134065,2722,2358,140,2218,6,24,2175,2197,1662,123,1539,3,22,1501,1523
113,DALLAS,113,1325,1131325,2141,4492,1821,2671,214,923,1504,2382,3414,1570,1844,182,641,975,1593
113,DALLAS,113,2510,1132510,2390,2672,1437,1235,414,261,511,751,2115,1166,949,342,202,351,540
113,DALLAS,113,3036,1133036,2473,85,7,78,1,22,58,78,68,7,61,1,15,46,61
141,EL PASO,141,0156,1410156,3469,3269,59,3210,7,21,3191,3192,2507,44,2463,0,18,2452,2452
339,MONTGOMERY,339,0068,3390068,6967,7869,4635,3234,342,867,1876,2667,5684,3540,2144,239,513,1223,1715
347,NACOGDOCHES,347,0046,3470046,7050,1455,1092,363,10,109,179,287,1086,837,249,9,77,116,192
363,PALO PINTO,363,0011,3630011,7299,424,337,87,3,6,67,73,329,264,65,3,4,51,55
439,TARRANT,439,1678,4391678,8046,76,13,63,5,11,49,58,50,12,38,2,8,29,35
157,FORT BEND,157,3086,1573086,3718,5214,767,4447,3067,880,524,1371,3879,571,3308,2264,636,400,1019
161,FREESTONE,161,0002,1610002,3801,2502,1516,986,19,548,378,915,1936,1215,721,14,414,250,662
215,HIDALGO,215,0087,2150087,5639,6341,112,6229,7,14,6168,6171,3487,76,3411,5,10,3380,3383
215,HIDALGO,215,0170,2150170,5722,1969,16,1953,1,6,1944,1946,1329,13,1316,1,4,1308,1310
231,HUNT,231,0433,2310433,5971,6510,1419,5091,43,1604,3374,4910,4479,1107,3372,33,1153,2093,3224
309,MCLENNAN,309,0084,3090084,6718,3547,2710,837,36,275,470,730,2663,2075,588,24,212,312,518
29,BEXAR,29,2162,292162,575,1495,470,1025,299,161,565,710,1213,440,773,196,115,452,558
61,CAMERON,61,0042,610042,1454,2535,152,2383,4,34,2340,2357,1857,119,1738,3,20,1701,1716
85,COLLIN,85,0157,850157,1786,6227,2598,3629,2656,436,456,880,4265,1905,2360,1730,291,283,573
113,DALLAS,113,4135,1134135,2782,3936,701,3235,441,606,2180,2725,3186,651,2535,388,505,1627,2086
113,DALLAS,113,1108,1131108,2081,6572,332,6240,23,1246,4985,6164,4548,285,4263,13,958,3272,4200
121,DENTON,121,4189,1214189,3114,1092,614,478,17,24,413,435,817,526,291,10,15,243,256
501,YOAKUM,501,0404,5010404,9612,746,371,375,3,5,354,356,556,295,261,2,1,242,242
285,LAVACA,285,0430,2850430,6409,4079,1843,2236,23,416,1772,2140,3002,1539,1463,20,266,1136,1389
303,LUBBOCK,303,0153,3030153,6612,2534,172,2362,11,1294,1103,2337,1895,133,1762,7,954,834,1744
373,POLK,373,0009,3730009,7405,1058,638,420,3,194,199,389,850,525,325,2,163,139,300
423,SMITH,423,0016,4230016,7737,2427,243,2184,2,1149,1022,2151,1734,217,1517,2,869,638,1497
453,TRAVIS,453,0133,4530133,8733,5445,929,4516,114,656,3765,4350,4041,834,3207,96,542,2572,3066
479,WEBB,479,0363,4790363,9280,1889,45,1844,1,4,1834,1836,1337,32,1305,0,1,1304,1305
121,DENTON,121,3153,1213153,3077,3767,3153,614,93,76,339,404,2955,2524,431,58,55,231,280
141,EL PASO,141,0096,1410096,3409,4348,697,3651,70,128,3485,3575,3436,609,2827,53,97,2689,2764
201,HARRIS,201,0188,2010188,4405,4914,411,4503,26,67,4410,4451,3496,359,3137,24,41,3057,3091
201,HARRIS,201,1066,2011066,5284,39,6,33,11,13,9,19,23,1,22,8,6,7,11
201,HARRIS,201,0734,2010734,4952,4211,2152,2059,415,618,952,1537,3033,1633,1400,292,420,620,1025
261,KENEDY,261,0005,2610005,6280,25,2,23,2,1,22,22,22,1,21,1,1,21,21
1,ANDERSON,1,0022,10022,20,1434,1146,288,30,98,125,219,1150,944,206,24,84,71,155
29,BEXAR,29,4205,294205,1016,205,54,151,6,6,141,144,172,50,122,4,3,112,115
29,BEXAR,29,1016,291016,266,1976,75,1901,12,15,1883,1891,1514,59,1455,9,11,1443,1447
29,BEXAR,29,3161,293161,767,5586,1587,3999,249,700,3064,3672,4480,1438,3042,186,510,2327,2786
37,BOWIE,37,005B,37005B,1099,7,1,6,0,2,4,6,6,1,5,0,1,4,5
41,BRAZOS,41,0071,410071,1262,172,135,37,7,5,12,17,112,85,27,3,2,11,13
215,HIDALGO,215,0124,2150124,5676,2496,463,2033,83,64,1879,1924,2015,407,1608,76,38,1480,1505
341,MOORE,341,0201,3410201,7013,2503,1160,1343,123,90,1093,1174,1782,933,849,69,52,697,743
367,PARKER,367,0135,3670135,7345,2659,2033,626,27,65,389,449,2001,1597,404,17,32,247,278
439,TARRANT,439,3446,4393446,8341,0,0,0,0,0,0,0,0,0,0,0,0,0,0
451,TOM GREEN,451,0108,4510108,8673,1359,963,396,7,21,339,349,1050,776,274,3,12,230,235
51,BURLESON,51,0406,510406,1348,1863,825,1038,11,472,519,955,1394,671,723,7,324,345,653
113,DALLAS,113,1134,1131134,2095,1217,33,1184,11,623,542,1160,792,26,766,11,400,347,746
113,DALLAS,113,2220,1132220,2344,2292,1980,312,128,31,105,136,1578,1397,181,72,17,61,78
181,GRAYSON,181,0401,1810401,4016,2980,1768,1212,40,599,369,949,2308,1453,855,27,434,234,662
201,HARRIS,201,0131,2010131,4348,4297,186,4111,70,446,3606,4025,2793,169,2624,57,335,2232,2559
201,HARRIS,201,1126,2011126,5344,4508,529,3979,549,1758,1723,3415,3400,454,2946,445,1269,1253,2487
9,ARCHER,9,0006,90006,80,1595,1359,236,10,43,120,157,1230,1071,159,7,29,73,98
29,BEXAR,29,4142,294142,953,1560,207,1353,36,750,568,1286,1215,172,1043,34,577,432,986
29,BEXAR,29,3103,293103,707,1447,354,1093,192,235,671,878,1013,265,748,128,167,438,593
29,BEXAR,29,1159,291159,412,611,39,572,2,5,567,568,480,28,452,1,3,448,448
29,BEXAR,29,3017,293017,621,3316,2379,937,115,80,648,725,2450,1817,633,70,59,437,495
59,CALLAHAN,59,0004,590004,1408,1937,1742,195,11,16,127,141,1539,1418,121,5,7,75,81
245,JEFFERSON,245,0003,2450003,6031,3586,137,3449,20,2827,628,3427,2547,116,2431,17,2027,400,2412
273,KLEBERG,273,0014,2730014,6326,2476,481,1995,32,82,1868,1930,1770,387,1383,28,51,1293,1333
277,LAMAR,277,004F,277004F,6363,2607,2037,570,49,226,158,379,1912,1525,387,44,147,96,241
309,MCLENNAN,309,0026,3090026,6658,1851,612,1239,37,319,892,1189,1437,554,883,27,242,613,844
409,SAN PATRICIO,409,0110,4090110,7654,2790,756,2034,16,54,1949,1979,2117,631,1486,12,30,1425,1443
439,TARRANT,439,1445,4391445,7986,92,32,60,1,2,54,56,65,21,44,1,2,38,40
85,COLLIN,85,0074,850074,1703,2881,1862,1019,345,298,321,604,2328,1505,823,289,251,232,477
95,CONCHO,95,0102,950102,1949,107,59,48,2,2,44,44,78,48,30,2,2,26,26
113,DALLAS,113,1054,1131054,2035,3920,813,3107,182,206,2694,2880,2972,729,2243,170,179,1874,2037
121,DENTON,121,2107,1212107,3031,5389,3086,2303,867,368,940,1296,4233,2572,1661,642,263,643,899
201,HARRIS,201,0817,2010817,5035,3411,1527,1884,713,454,659,1092,2565,1199,1366,493,336,486,809
201,HARRIS,201,0486,2010486,4703,6664,3968,2696,798,461,1321,1736,4998,3135,1863,566,321,864,1170
29,BEXAR,29,2148,292148,561,8046,2084,5962,997,1103,3938,4888,6627,1932,4695,727,862,3093,3871
43,BREWSTER,43,0008,430008,1308,1385,381,1004,19,117,870,970,1192,343,849,13,104,731,823
89,COLORADO,89,0202,890202,1889,744,532,212,6,22,166,185,582,461,121,4,9,91,100
113,DALLAS,113,3809,1133809,2636,735,88,647,11,261,372,632,506,72,434,11,201,219,419
121,DENTON,121,1050,1211050,2974,814,392,422,43,178,164,335,553,268,285,32,119,103,218
135,ECTOR,135,0206,1350206,3223,2908,1297,1611,122,246,1182,1396,2373,1109,1264,103,200,904,1084
293,LIMESTONE,293,0202,2930202,6466,1825,352,1473,13,791,700,1454,1294,283,1011,5,601,408,1001
395,ROBERTSON,395,0022,3950022,7551,2365,339,2026,13,1356,664,1987,1686,277,1409,9,980,405,1379
427,STARR,427,0003,4270003,7800,4276,49,4227,3,11,4218,4219,2974,39,2935,3,6,2930,2931
453,TRAVIS,453,0335,4530335,8879,4534,2952,1582,361,152,1030,1161,3294,2239,1055,237,101,663,755
491,WILLIAMSON,491,0311,4910311,9466,225,147,78,2,11,60,70,174,128,46,2,3,36,39
201,HARRIS,201,0334,2010334,4551,2284,190,2094,69,1397,617,1985,1620,158,1462,54,980,410,1375
201,HARRIS,201,0920,2010920,5138,482,148,334,10,152,153,301,341,126,215,5,91,101,189
201,HARRIS,201,0085,2010085,4302,4117,970,3147,972,1611,583,2165,3893,957,2936,960,1445,540,1968
201,HARRIS,201,0672,2010672,4889,7691,3240,4451,498,913,2934,3793,5292,2427,2865,354,592,1823,2390
255,KARNES,255,0011,2550011,6217,1253,557,696,24,37,633,658,946,455,491,20,19,444,457
293,LIMESTONE,293,0302,2930302,6472,1295,647,648,12,305,325,621,1001,535,466,6,234,226,455
29,BEXAR,29,3057,293057,661,910,416,494,42,69,386,438,733,364,369,32,44,286,328
41,BRAZOS,41,0011,410011,1202,6315,2426,3889,996,893,1946,2773,5150,2212,2938,921,577,1362,1913
103,CRANE,103,0003,1030003,1995,1151,258,893,18,59,808,854,816,216,600,14,47,533,571
113,DALLAS,113,3099,1133099,2536,467,13,454,5,246,203,449,356,10,346,3,205,137,342
141,EL PASO,141,0010,1410010,3323,8056,612,7444,113,204,7207,7325,5920,518,5402,86,138,5228,5318
157,FORT BEND,157,2058,1572058,3661,3697,410,3287,198,1899,1233,3074,2512,325,2187,146,1273,786,2033
355,NUECES,355,0038,3550038,7153,355,29,326,9,156,175,318,273,19,254,6,126,130,249
439,TARRANT,439,4239,4394239,8487,345,159,186,14,23,149,165,257,124,133,10,9,112,119
439,TARRANT,439,2535,4392535,8192,4391,2890,1501,311,519,602,1095,3441,2345,1096,213,392,432,808
457,TYLER,457,0003,4570003,9028,1886,1417,469,11,193,193,384,1537,1187,350,10,142,125,267
167,GALVESTON,167,0214,1670214,3864,6218,2211,4007,117,1824,1975,3753,5034,1982,3052,78,1437,1432,2845
199,HARDIN,199,0005,1990005,4202,875,818,57,5,16,25,38,697,653,44,4,11,16,26
201,HARRIS,201,0771,2010771,4989,5568,827,4741,325,1102,3380,4365,3954,680,3274,247,731,2312,2983
213,HENDERSON,213,002E,213002E,5530,3608,3152,456,18,51,282,329,2797,2463,334,16,40,185,222
219,HOCKLEY,219,0011,2190011,5825,660,338,322,8,30,275,301,473,285,188,4,16,159,173
331,MILAM,331,0317,3310317,6864,1542,1241,301,11,75,175,246,1195,1019,176,10,50,86,135
29,BEXAR,29,2102,292102,515,3653,1004,2649,155,372,2173,2484,2808,844,1964,122,279,1570,1824
77,CLAY,77,0006,770006,1600,625,513,112,8,7,55,61,486,415,71,7,3,30,33
113,DALLAS,113,4020,1134020,2682,2152,472,1680,96,314,1243,1534,1875,459,1416,85,284,1007,1278
121,DENTON,121,1004,1211004,2928,5274,3525,1749,64,321,1144,1426,3800,2663,1137,44,197,705,889
141,EL PASO,141,0202,1410202,3515,4859,376,4483,56,160,4300,4424,3110,253,2857,44,103,2718,2806
157,FORT BEND,157,4048,1574048,3764,5115,596,4519,74,1370,3137,4419,3628,517,3111,53,871,2196,3032
453,TRAVIS,453,0383,4530383,8925,4834,3029,1805,1066,120,529,630,3650,2422,1228,734,87,340,417
471,WALKER,471,0404,4710404,9174,5019,3729,1290,37,639,477,1099,3873,2974,899,23,455,299,751
491,WILLIAMSON,491,0202,4910202,9420,990,586,404,176,83,137,213,808,515,293,117,62,103,163
181,GRAYSON,181,0305,1810305,4010,2119,1753,366,27,30,170,198,1674,1422,252,19,13,109,120
201,HARRIS,201,0380,2010380,4597,7351,2598,4753,536,2152,2081,4148,5184,1932,3252,381,1496,1367,2810
201,HARRIS,201,0626,2010626,4843,8653,3365,5288,841,2311,2122,4317,6987,2974,4013,672,1667,1609,3218
201,HARRIS,201,0874,2010874,5092,4561,2806,1755,244,399,1050,1409,3466,2246,1220,170,269,705,956
227,HOWARD,227,031A,227031A,5925,0,0,0,0,0,0,0,0,0,0,0,0,0,0
439,TARRANT,439,2169,4392169,8092,5029,313,4716,182,1519,3013,4499,3348,240,3108,143,1071,1878,2931
29,BEXAR,29,1119,291119,369,318,20,298,1,8,293,297,228,12,216,1,2,214,215
113,DALLAS,113,2101,1132101,2287,1848,1388,460,106,89,238,320,1795,1361,434,96,82,224,300
113,DALLAS,113,4535,1134535,2828,1934,169,1765,97,200,1453,1638,1396,146,1250,75,150,1008,1149
141,EL PASO,141,0056,1410056,3369,3554,736,2818,96,263,2529,2733,2699,660,2039,69,199,1806,1969
157,FORT BEND,157,1008,1571008,3615,1448,866,582,18,125,424,546,1205,736,469,9,97,349,444
167,GALVESTON,167,0432,1670432,3910,3231,1403,1828,74,687,1029,1685,2569,1201,1368,58,522,738,1251
453,TRAVIS,453,0191,4530191,8779,3851,2073,1778,329,435,991,1384,3173,1822,1351,254,331,726,1038
483,WHEELER,483,0401,4830401,9320,1371,1019,352,26,60,232,286,1023,811,212,22,32,132,160
497,WISE,497,0001,4970001,9566,1483,978,505,15,25,424,438,1075,736,339,9,14,278,290
189,HALE,189,0305,1890305,4156,1540,881,659,14,41,576,612,1209,740,469,11,27,409,431
201,HARRIS,201,1020,2011020,5238,3672,376,3296,111,1538,1654,3118,2556,310,2246,79,1069,1093,2125
201,HARRIS,201,0234,2010234,4451,5901,4209,1692,568,328,735,1038,5282,3850,1432,480,285,627,890
201,HARRIS,201,0480,2010480,4697,4505,1971,2534,545,523,1372,1878,3462,1675,1787,421,335,951,1278
215,HIDALGO,215,0227,2150227,5779,10377,150,10227,15,28,10174,10184,6880,71,6809,8,11,6792,6799
439,TARRANT,439,2741,4392741,8238,420,49,371,36,219,110,323,288,34,254,29,147,68,212
29,BEXAR,29,4079,294079,890,2602,1101,1501,175,421,901,1283,2103,962,1141,135,304,674,966
29,BEXAR,29,1141,291141,392,4827,1073,3754,267,820,2752,3464,3289,803,2486,166,528,1804,2285
55,CALDWELL,55,0306,550306,1388,2573,424,2149,27,43,2070,2103,1798,355,1443,21,34,1379,1409
71,CHAMBERS,71,0003,710003,1554,729,271,458,15,138,299,427,557,220,337,15,113,197,310
89,COLORADO,89,0102,890102,1886,422,258,164,1,44,105,148,359,232,127,1,39,72,111
141,EL PASO,141,0162,1410162,3475,7592,140,7452,18,42,7410,7426,5356,100,5256,9,18,5226,5239
459,UPSHUR,459,0006,4590006,9048,2236,1743,493,36,195,165,348,1619,1306,313,17,122,94,213
491,WILLIAMSON,491,0490,4910490,9546,7270,3694,3576,822,1096,1617,2629,5426,2984,2442,520,747,1087,1796
231,HUNT,231,0427,2310427,5965,6594,3364,3230,256,1932,721,2595,5408,2885,2523,220,1512,495,1969
397,ROCKWALL,397,0002,3970002,7554,6224,4421,1803,297,506,837,1308,5054,3776,1278,223,345,566,895
439,TARRANT,439,1104,4391104,7886,4887,368,4519,115,2334,2078,4389,3589,311,3278,82,1863,1317,3179
439,TARRANT,439,1714,4391714,8052,6552,1533,5019,336,2878,1803,4592,4878,1327,3551,259,2022,1196,3189
439,TARRANT,439,4533,4394533,8550,3497,1189,2308,268,208,1781,1968,2486,986,1500,203,123,1130,1243
439,TARRANT,439,3646,4393646,8384,6000,3615,2385,400,685,1121,1758,4346,2695,1651,286,485,735,1192
161,FREESTONE,161,0006A,1610006A,3807,703,587,116,6,50,53,99,555,472,83,3,32,37,68
177,GONZALES,177,0010,1770010,3973,883,403,480,1,15,460,466,687,341,346,0,9,332,337
201,HARRIS,201,0254,2010254,4471,4509,161,4348,21,147,4152,4285,2944,137,2807,17,117,2663,2769
201,HARRIS,201,0751,2010751,4969,6783,2297,4486,802,1227,2453,3561,5162,1879,3283,595,878,1792,2587
209,HAYS,209,0315,2090315,5467,2194,1499,695,72,52,465,511,1834,1296,538,54,41,350,389
215,HIDALGO,215,0081,2150081,5633,3615,362,3253,114,29,3103,3122,2682,297,2385,87,25,2271,2289
27,BELL,27,0415,270415,249,7405,1614,5791,465,3546,1849,5105,5266,1364,3902,362,2298,1192,3359
29,BEXAR,29,4102,294102,913,2217,438,1779,71,544,1171,1696,1754,373,1381,61,438,890,1310
29,BEXAR,29,3141,293141,747,415,118,297,12,70,216,282,411,118,293,12,69,213,278
41,BRAZOS,41,0054,410054,1245,831,598,233,19,31,156,184,651,498,153,15,18,102,119
59,CALLAHAN,59,0007,590007,1411,621,553,68,0,6,45,50,516,462,54,0,3,36,39
85,COLLIN,85,0114,850114,1743,1971,1381,590,46,76,428,485,1501,1115,386,33,40,277,303
491,WILLIAMSON,491,0162,4910162,9403,6170,3640,2530,822,471,1137,1561,4810,2918,1892,635,337,834,1142
497,WISE,497,0004,4970004,9569,1351,1101,250,13,12,184,196,1042,890,152,3,8,111,119
187,GUADALUPE,187,0232,1870232,4116,57,48,9,0,0,6,6,47,42,5,0,0,2,2
201,HARRIS,201,0397,2010397,4614,2233,208,2025,24,143,1864,1986,1580,186,1394,16,113,1260,1361
201,HARRIS,201,0231,2010231,4448,6632,500,6132,94,395,5664,6002,4818,368,4450,69,292,4092,4352
201,HARRIS,201,0894,2010894,5112,7209,499,6710,307,4279,2206,6348,5001,423,4578,229,2898,1495,4313
439,TARRANT,439,3729,4393729,8407,6,3,3,0,2,1,2,5,3,2,0,2,1,2
453,TRAVIS,453,0362,4530362,8905,4583,3478,1105,252,130,601,715,3147,2440,707,160,66,386,449
91,COMAL,91,0203,910203,1909,6446,4637,1809,194,324,1142,1439,5133,3802,1331,140,261,802,1045
113,DALLAS,113,2606,1132606,2407,5634,1434,4200,2521,864,787,1624,4702,1335,3367,1949,734,663,1377
121,DENTON,121,1030,1211030,2954,38,5,33,6,15,10,24,28,5,23,3,8,9,17
141,EL PASO,141,0139,1410139,3452,3344,157,3187,30,44,3140,3162,2605,123,2482,23,27,2447,2466
157,FORT BEND,157,1019,1571019,3618,1357,803,554,38,175,304,461,1057,658,399,27,135,206,332
477,WASHINGTON,477,0109,4770109,9206,1429,1043,386,8,137,219,355,1143,876,267,5,99,141,240
267,KIMBLE,267,0006,2670006,6312,459,408,51,1,3,38,40,425,381,44,1,3,32,34
29,BEXAR,29,2154,292154,567,7349,2179,5170,487,763,4028,4624,4838,1570,3268,296,432,2548,2927
201,HARRIS,201,0180,2010180,4397,4504,116,4388,22,3144,1244,4332,3279,101,3178,16,2346,833,3143
357,OCHILTREE,357,0004,3570004,7248,2593,1082,1511,12,19,1437,1451,1821,850,971,7,11,909,920
113,DALLAS,113,3045,1133045,2482,1032,37,995,59,619,315,924,721,24,697,32,483,184,660
471,WALKER,471,0204A,4710204A,9163,756,526,230,7,156,56,207,613,429,184,7,132,38,167
201,HARRIS,201,0223,2010223,4440,8789,2286,6503,3340,1977,1188,3080,7846,2138,5708,2974,1682,1042,2660
259,KENDALL,259,3040,2593040,6269,1513,1028,485,9,6,436,441,1148,818,330,5,2,302,303
113,DALLAS,113,3002,1133002,2439,2421,109,2312,47,452,1816,2249,1726,102,1624,35,354,1229,1574
467,VAN ZANDT,467,004E,467004E,9120,1785,1432,353,13,41,209,249,1433,1156,277,10,29,168,196
201,HARRIS,201,0137,2010137,4354,5863,2419,3444,338,812,2205,2973,3822,1729,2093,229,515,1260,1759
61,CAMERON,61,0091,610091,1503,2534,84,2450,58,11,2384,2389,1618,73,1545,42,9,1497,1501
201,HARRIS,201,1115,2011115,5333,930,355,575,89,73,390,451,714,307,407,58,46,283,325
29,BEXAR,29,2111,292111,524,2491,390,2101,65,370,1685,2010,1956,367,1589,56,265,1257,1510
141,EL PASO,141,0105,1410105,3418,3775,435,3340,55,147,3185,3276,3000,385,2615,47,104,2489,2561
439,TARRANT,439,2513,4392513,8184,0,0,0,0,0,0,0,0,0,0,0,0,0,0
439,TARRANT,439,2190,4392190,8098,613,211,402,16,59,314,371,480,193,287,16,42,218,258
29,BEXAR,29,2026,292026,438,3691,658,3033,140,281,2643,2871,2813,580,2233,86,176,1964,2118
139,ELLIS,139,1035,1391035,3289,3726,2177,1549,58,246,1138,1367,2699,1661,1038,37,165,744,906
355,NUECES,355,0047,3550047,7162,968,120,848,4,64,775,823,685,103,582,2,35,529,562
201,HARRIS,201,0051,2010051,4268,2676,1595,1081,53,40,924,953,2146,1396,750,46,31,627,649
439,TARRANT,439,1718,4391718,8055,1456,583,873,186,379,293,661,1159,485,674,156,299,205,499
201,HARRIS,201,0009,2010009,4225,4044,931,3113,201,1261,1640,2856,3280,872,2408,171,890,1312,2177
141,EL PASO,141,0019,1410019,3332,6786,1346,5440,225,300,4898,5139,5391,1187,4204,187,207,3767,3950
201,HARRIS,201,1072,2011072,5290,3459,904,2555,384,1009,1179,2124,2742,761,1981,300,756,919,1630
61,CAMERON,61,0048,610048,1460,5426,407,5019,90,47,4892,4923,3830,328,3502,62,28,3412,3430
453,TRAVIS,453,0466,4530466,8991,9547,1146,8401,174,567,7721,8155,6732,1009,5723,146,378,5197,5521
439,TARRANT,439,2675,4392675,8227,18,0,18,0,4,9,13,15,0,15,0,1,9,10
257,KAUFMAN,257,0005,2570005,6226,4127,991,3136,36,1959,1140,3060,3110,856,2254,26,1501,714,2196
439,TARRANT,439,3391,4393391,8330,5875,2404,3471,792,1295,1234,2470,4669,2092,2577,634,916,882,1768
201,HARRIS,201,0283,2010283,4500,6544,245,6299,161,2723,3497,6115,4385,191,4194,119,1863,2247,4057
141,EL PASO,141,0148,1410148,3461,3604,121,3483,23,24,3441,3448,2740,99,2641,3,10,2621,2625
113,DALLAS,113,2517,1132517,2396,5206,1245,3961,1651,1688,572,2226,4013,1084,2929,1210,1229,446,1653
481,WHARTON,481,0202,4810202,9309,1178,346,832,1,576,258,822,932,288,644,1,459,176,635
371,PECOS,371,0007,3710007,7394,2838,574,2264,21,35,2194,2217,2079,459,1620,17,21,1568,1583
85,COLLIN,85,0020,850020,1649,1099,857,242,25,32,150,177,884,703,181,20,29,108,133
439,TARRANT,439,3575,4393575,8373,12,3,9,0,6,2,7,10,3,7,0,5,0,5
291,LIBERTY,291,0026,2910026,6458,5975,2851,3124,45,150,2775,2915,4156,2195,1961,31,97,1712,1805
113,DALLAS,113,3309,1133309,2585,3739,1284,2455,89,1223,1101,2292,2884,1100,1784,65,892,789,1667
141,EL PASO,141,0208,1410208,3521,4387,78,4309,14,32,4283,4295,3130,51,3079,9,20,3064,3070
209,HAYS,209,0121,2090121,5436,4328,1704,2624,240,608,1765,2301,3952,1601,2351,211,557,1565,2064
215,HIDALGO,215,0033,2150033,5585,2759,109,2650,12,12,2623,2627,1959,89,1870,10,6,1852,1853
29,BEXAR,29,3109,293109,713,5647,1371,4276,239,415,3657,4000,4335,1191,3144,182,302,2646,2912
201,HARRIS,201,0369,2010369,4586,1139,262,877,72,509,305,793,1043,257,786,64,464,262,709
363,PALO PINTO,363,0021,3630021,7308,1240,855,385,19,65,280,333,910,681,229,11,37,153,187
277,LAMAR,277,4A6E,2774A6E,6372,2334,1656,678,163,227,191,412,1878,1399,479,118,162,120,279
211,HEMPHILL,211,0402,2110402,5522,129,116,13,0,1,7,8,90,81,9,0,0,4,4
375,POTTER,375,0421,3750421,7437,4660,709,3951,158,518,3276,3730,3233,605,2628,107,339,2148,2465
201,HARRIS,201,0240,2010240,4457,4389,70,4319,37,3345,986,4255,3140,65,3075,21,2466,595,3035
113,DALLAS,113,2302,1132302,2353,4043,748,3295,138,155,2934,3078,3129,664,2465,122,143,2129,2268
201,HARRIS,201,0986,2010986,5204,3128,109,3019,74,1048,1922,2906,1950,85,1865,50,662,1183,1810
463,UVALDE,463,0009,4630009,9077,2174,190,1984,7,20,1958,1960,1622,132,1490,6,5,1473,1475
439,TARRANT,439,2748,4392748,8244,0,0,0,0,0,0,0,0,0,0,0,0,0,0
135,ECTOR,135,0209,1350209,3226,3182,1505,1677,125,365,1145,1473,2532,1257,1275,109,274,851,1105
355,NUECES,355,0090,3550090,7205,1357,378,979,35,50,878,915,1072,326,746,27,37,664,693
61,CAMERON,61,0005,610005,1417,4596,798,3798,76,31,3696,3723,3559,759,2800,61,23,2716,2737
249,JIM WELLS,249,0003,2490003,6140,1512,773,739,9,23,666,680,1148,645,503,2,12,451,461
113,DALLAS,113,2104,1132104,2290,852,392,460,196,154,87,240,703,343,360,130,129,79,208
53,BURNET,53,0005,530005,1354,1230,1025,205,11,15,138,152,1063,919,144,10,10,90,100
489,WILLACY,489,0007,4890007,9372,388,52,336,3,5,320,325,296,43,253,3,5,237,242
473,WALLER,473,0105,4730105,9180,1311,845,466,10,69,350,414,981,680,301,8,35,225,259
439,TARRANT,439,2320,4392320,8141,4327,686,3641,805,1618,1246,2797,3189,571,2618,626,1120,878,1954
29,BEXAR,29,2068,292068,481,5538,1817,3721,202,349,3178,3461,4424,1558,2866,152,273,2398,2642
349,NAVARRO,349,0401,3490401,7076,1355,515,840,15,251,554,786,1035,431,604,12,195,378,567
439,TARRANT,439,4073,4394073,8436,1241,386,855,25,404,425,821,843,357,486,18,208,263,463
69,CASTRO,69,0201,690201,1546,1608,326,1282,19,62,1209,1257,1125,274,851,16,38,793,828
439,TARRANT,439,2275,4392275,8121,1753,385,1368,103,412,829,1214,1280,328,952,82,287,558,833
253,JONES,253,0004,2530004,6206,3629,2740,889,35,98,655,735,2767,2177,590,22,57,425,476
139,ELLIS,139,1058,1391058,3312,2200,1031,1169,42,217,869,1073,1556,798,758,29,135,551,684
201,HARRIS,201,1009,2011009,5227,757,31,726,197,118,416,532,555,31,524,165,87,278,364
439,TARRANT,439,2428,4392428,8164,2316,243,2073,72,565,1474,1997,1601,207,1394,58,358,989,1330
257,KAUFMAN,257,0028,2570028,6249,3180,2027,1153,33,319,747,1050,2497,1664,833,21,249,528,763
113,DALLAS,113,2803,1132803,2419,1564,1192,372,165,33,147,174,1180,951,229,94,20,100,114
201,HARRIS,201,0117,2010117,4334,6701,696,6005,109,338,5589,5873,4696,603,4093,78,252,3778,3993
351,NEWTON,351,0016,3510016,7099,426,315,111,0,79,17,96,327,245,82,0,52,15,67
201,HARRIS,201,0966,2010966,5184,5736,514,5222,131,1642,3495,5027,4134,441,3693,100,1236,2377,3538
29,BEXAR,29,2134,292134,547,4251,721,3530,373,797,2389,3080,3246,653,2593,204,548,1823,2314
113,DALLAS,113,3025,1133025,2462,1402,2,1400,1,131,1271,1396,868,2,866,1,106,765,865
201,HARRIS,201,0160,2010160,4377,1200,46,1154,16,704,460,1128,930,42,888,11,561,328,867
77,CLAY,77,0017,770017,1609,1141,1047,94,10,5,45,49,968,906,62,9,0,26,26
439,TARRANT,439,2033,4392033,8078,4976,2048,2928,103,801,1978,2706,3562,1663,1899,66,465,1296,1748
439,TARRANT,439,3240,4393240,8290,5763,2933,2830,647,709,1348,2002,3976,2148,1828,431,459,835,1271
339,MONTGOMERY,339,0035,3390035,6930,9130,4534,4596,441,1211,2840,3961,6850,3768,3082,310,751,1896,2603
453,TRAVIS,453,0385B,4530385B,8928,47,14,33,18,3,9,12,35,12,23,15,2,4,6
57,CALHOUN,57,0004,570004,1397,2702,575,2127,119,170,1869,2004,2028,489,1539,94,127,1331,1442
279,LAMB,279,0003,2790003,6375,1212,421,791,4,29,765,784,869,347,522,4,16,507,520
201,HARRIS,201,0243,2010243,4460,708,3,705,1,601,110,701,565,3,562,0,491,70,558
65,CARSON,65,0302,650302,1523,556,470,86,0,9,55,63,428,363,65,0,9,37,45
439,TARRANT,439,2775,4392775,8247,0,0,0,0,0,0,0,0,0,0,0,0,0,0
201,HARRIS,201,1135,2011135,5353,7755,1192,6563,566,1893,4128,5894,5414,941,4473,427,1239,2784,3974
201,HARRIS,201,0923,2010923,5141,6634,3753,2881,1070,601,1079,1651,4449,2614,1835,681,392,675,1049
113,DALLAS,113,2800,1132800,2416,0,0,0,0,0,0,0,0,0,0,0,0,0,0
141,EL PASO,141,0168,1410168,3481,982,37,945,11,12,931,935,633,30,603,7,10,591,595
29,BEXAR,29,1124,291124,375,397,21,376,6,9,364,372,310,15,295,6,9,283,291
85,COLLIN,85,0106,850106,1735,2878,1645,1233,331,332,507,814,2169,1316,853,243,222,324,537
379,RAINS,379,0408,3790408,7457,1553,1286,267,13,40,151,187,1183,1003,180,11,27,91,117
453,TRAVIS,453,0438,4530438,8971,3906,1421,2485,138,247,2085,2284,3193,1293,1900,114,179,1572,1726
139,ELLIS,139,1015,1391015,3269,5191,2643,2548,51,620,1799,2396,3771,2148,1623,30,372,1154,1518
439,TARRANT,439,2317,4392317,8138,1687,1043,644,161,148,316,452,1354,898,456,121,104,211,311
355,NUECES,355,0067,3550067,7182,7594,2674,4920,631,541,3731,4182,5787,2254,3533,452,378,2651,2989
41,BRAZOS,41,0037,410037,1228,179,130,49,2,17,24,41,134,103,31,1,13,13,26
113,DALLAS,113,3312,1133312,2588,4946,1398,3548,386,1608,1530,3094,3671,1198,2473,315,1081,1028,2095
201,HARRIS,201,0071,2010071,4288,5026,2618,2408,850,309,1204,1489,4319,2337,1982,695,241,987,1220
113,DALLAS,113,3068,1133068,2505,6302,147,6155,49,4675,1473,6062,4467,132,4335,37,3384,916,4272
61,CAMERON,61,0028,610028,1440,4531,366,4165,21,60,4090,4108,3116,295,2821,16,43,2752,2769
145,FALLS,145,0301,1450301,3564,1168,775,393,8,177,191,355,905,641,264,2,130,108,235
209,HAYS,209,0337,2090337,5479,4166,3330,836,76,47,547,578,3275,2698,577,39,23,363,384
471,WALKER,471,0201A,4710201A,9160,8343,3212,5131,223,2879,1999,4819,7426,3023,4403,199,2340,1829,4122
29,BEXAR,29,2151,292151,564,309,22,287,3,5,278,280,204,22,182,1,4,175,177
113,DALLAS,113,3042,1133042,2479,2699,27,2672,11,1408,1252,2646,1864,13,1851,7,1081,756,1834
201,HARRIS,201,1155,2011155,5373,9,5,4,0,0,4,4,9,5,4,0,0,4,4
479,WEBB,479,0309,4790309,9266,4766,174,4592,24,32,4549,4564,3630,145,3485,13,22,3458,3471
367,PARKER,367,0220,3670220,7351,1100,966,134,3,11,83,93,889,794,95,2,6,58,63
361,ORANGE,361,0033,3610033,7288,2210,1963,247,17,18,144,157,1616,1477,139,8,8,78,83
113,DALLAS,113,2407,1132407,2373,8241,2059,6182,848,614,4648,5220,6235,1856,4379,690,464,3156,3598
157,FORT BEND,157,2087,1572087,3670,2733,1700,1033,334,288,378,656,1902,1183,719,240,220,234,447
479,WEBB,479,0123,4790123,9223,2254,29,2225,4,13,2216,2216,1514,26,1488,4,9,1482,1482
207,HASKELL,207,0001,2070001,5416,578,425,153,10,19,110,125,453,351,102,4,12,71,82
85,COLLIN,85,0063,850063,1692,2488,1800,688,235,108,267,365,1995,1533,462,170,67,161,223
153,FLOYD,153,0004,1530004,3607,1377,354,1023,18,63,948,998,987,294,693,8,32,647,679
485,WICHITA,485,0109,4850109,9329,1901,834,1067,40,558,390,941,1817,794,1023,39,526,381,900
355,NUECES,355,0004,3550004,7119,4327,663,3664,130,359,3204,3487,3263,553,2710,88,257,2349,2568
113,DALLAS,113,29A1,11329A1,2436,435,117,318,17,96,210,296,358,104,254,16,67,171,232
251,JOHNSON,251,0002,2510002,6160,5422,3939,1483,114,171,985,1128,3898,2952,946,64,99,612,700
355,NUECES,355,0109,3550109,7225,705,216,489,25,24,433,451,555,196,359,22,16,310,324
201,HARRIS,201,1092,2011092,5310,2758,232,2526,442,145,1960,2080,1955,187,1768,344,99,1339,1419
457,TYLER,457,0009,4570009,9034,570,488,82,3,18,35,51,446,396,50,1,14,13,27
141,EL PASO,141,0188,1410188,3501,207,38,169,14,26,141,157,159,35,124,9,16,101,113
201,HARRIS,201,0134,2010134,4351,3768,508,3260,73,349,2846,3157,2757,454,2303,57,275,1970,2220
201,HARRIS,201,1029,2011029,5247,5401,2049,3352,1652,607,1056,1626,3933,1549,2384,1171,423,758,1154
141,EL PASO,141,0125,1410125,3438,6502,373,6129,139,241,5821,5991,4992,312,4680,88,162,4435,4567
113,DALLAS,113,2124,1132124,2310,8072,767,7305,519,4967,1866,6728,5966,680,5286,333,3666,1284,4895
141,EL PASO,141,0062,1410062,3375,4190,374,3816,74,317,3474,3691,3086,334,2752,59,231,2471,2643
41,BRAZOS,41,0080,410080,1271,5856,4033,1823,464,342,859,1180,4130,2899,1231,334,224,557,771
71,CHAMBERS,71,0015,710015,1566,4343,1719,2624,122,724,1704,2400,3030,1287,1743,92,523,1071,1583
29,BEXAR,29,2088,292088,501,5949,1431,4518,211,409,3941,4281,4575,1183,3392,171,310,2907,3180
213,HENDERSON,213,03CS,21303CS,5542,2508,2104,404,35,138,166,296,1939,1651,288,30,97,102,195
349,NAVARRO,349,0106,3490106,7056,1116,458,658,17,47,569,609,797,366,431,13,30,364,390
49,BROWN,49,0410,490410,1334,3607,2682,925,30,133,639,758,2839,2200,639,20,96,426,521
465,VAL VERDE,465,0032,4650032,9097,285,155,130,6,6,107,111,246,140,106,6,0,87,87
121,DENTON,121,4217,1214217,3143,2218,1508,710,202,141,299,434,1664,1170,494,130,110,197,301
257,KAUFMAN,257,0002,2570002,6223,2849,1635,1214,21,102,1023,1118,2066,1328,738,12,72,601,671
83,COLEMAN,83,002E,83002E,1629,507,410,97,0,8,79,84,399,332,67,0,2,52,54
29,BEXAR,29,2177,292177,590,1,1,0,0,0,0,0,1,1,0,0,0,0,0
439,TARRANT,439,3209,4393209,8284,5028,3989,1039,215,200,466,655,3877,3161,716,141,143,306,445
113,DALLAS,113,30C4,11330C4,2539,0,0,0,0,0,0,0,0,0,0,0,0,0,0
141,EL PASO,141,0205,1410205,3518,8628,288,8340,32,106,8201,8264,5655,217,5438,19,73,5338,5394
209,HAYS,209,0114,2090114,5433,3022,1012,2010,70,234,1677,1883,2542,938,1604,62,186,1320,1490
479,WEBB,479,0275B,4790275B,9263,102,4,98,0,0,96,96,56,2,54,0,0,53,53
277,LAMAR,277,2C3A,2772C3A,6369,7669,3547,4122,66,2615,1132,3705,5624,2847,2777,45,1819,664,2468
367,PARKER,367,0205,3670205,7348,3263,2270,993,29,83,764,839,2416,1784,632,17,42,471,509
201,HARRIS,201,0237,2010237,4454,3210,37,3173,10,1976,1236,3152,2348,31,2317,7,1565,768,2302
481,WHARTON,481,0102,4810102,9306,5073,2520,2553,39,792,1678,2426,4038,2171,1867,26,591,1192,1762
85,COLLIN,85,0017,850017,1646,6552,3707,2845,204,942,1520,2422,4425,2656,1769,132,622,886,1499
145,FALLS,145,0201,1450201,3561,1024,796,228,4,78,135,207,816,653,163,1,68,80,146
371,PECOS,371,0004,3710004,7391,1123,401,722,15,13,687,690,795,321,474,10,5,449,450
77,CLAY,77,0010,770010,1603,354,316,38,2,3,31,31,306,275,31,0,0,24,24
209,HAYS,209,0333,2090333,5476,2903,2420,483,42,46,303,343,2461,2113,348,24,25,209,229
485,WICHITA,485,0309,4850309,9349,2825,2359,466,47,65,232,287,2180,1876,304,21,44,137,174
291,LIBERTY,291,0023,2910023,6455,6921,428,6493,19,84,6391,6442,4075,303,3772,17,50,3707,3735
375,POTTER,375,0325,3750325,7434,4499,2848,1651,149,310,1102,1368,3604,2458,1146,108,193,740,920
85,COLLIN,85,0060,850060,1689,3723,2246,1477,632,243,515,749,2755,1761,994,431,171,316,481
201,HARRIS,201,0323,2010323,4540,5596,1154,4442,100,670,3686,4306,4108,999,3109,86,513,2511,3002
211,HEMPHILL,211,0302,2110302,5519,40,36,4,0,0,4,4,30,29,1,0,0,1,1
29,BEXAR,29,3106,293106,710,2121,1201,920,106,51,696,742,1695,1015,680,70,36,516,550
113,DALLAS,113,3621,1133621,2625,1089,102,987,3,819,174,980,843,98,745,2,633,117,741
153,FLOYD,153,0001,1530001,3604,1345,761,584,1,37,535,570,988,662,326,0,23,296,317
363,PALO PINTO,363,0017,3630017,7305,1729,817,912,10,110,764,862,1268,663,605,7,69,494,561
203,HARRISON,203,0007,2030007,5390,1192,857,335,8,218,75,289,969,703,266,7,182,50,230
477,WASHINGTON,477,0413,4770413,9220,2054,1660,394,7,69,261,327,1686,1410,276,6,44,172,216
439,TARRANT,439,3567,4393567,8370,4531,2826,1705,279,584,724,1265,2943,1926,1017,179,325,417,730
215,HIDALGO,215,0053,2150053,5605,5475,167,5308,47,22,5242,5252,3917,121,3796,35,9,3753,3759
99,CORYELL,99,0412,990412,1984,6032,3176,2856,344,1175,1168,2252,4344,2441,1903,225,786,735,1470
113,DALLAS,113,4053,1134053,2711,973,111,862,105,228,534,751,695,97,598,76,164,359,512
85,COLLIN,85,0146,850146,1775,7616,3707,3909,1719,1023,1042,2028,5469,2820,2649,1172,674,678,1343
113,DALLAS,113,4098,1134098,2754,51,36,15,5,2,4,6,37,26,11,4,0,4,4
201,HARRIS,201,0618,2010618,4835,8845,1989,6856,670,1874,4275,6030,6528,1632,4896,523,1294,3034,4262
215,HIDALGO,215,0219,2150219,5771,3942,88,3854,21,28,3811,3816,2539,58,2481,18,16,2446,2451
85,COLLIN,85,0189,850189,1818,1372,863,509,29,28,374,401,1042,719,323,22,19,222,240
201,HARRIS,201,0366,2010366,4583,10509,461,10048,1144,2013,6965,8877,7254,369,6885,910,1408,4582,5948
499,WOOD,499,03-1,49903-1,9601,1689,1404,285,11,42,174,214,1360,1168,192,8,32,104,136
303,LUBBOCK,303,0027,3030027,6541,7226,2719,4507,294,1086,3123,4107,5526,2353,3173,246,728,2154,2845
29,BEXAR,29,3147,293147,753,119,74,45,7,6,30,36,116,74,42,7,6,27,33
33,BORDEN,33,001A,33001A,1048,79,71,8,1,1,6,7,53,51,2,0,0,2,2
407,SAN JACINTO,407,0010,4070010,7643,1250,682,568,8,19,524,539,955,564,391,6,14,354,364
439,TARRANT,439,3822,4393822,8413,0,0,0,0,0,0,0,0,0,0,0,0,0,0
287,LEE,287,0103,2870103,6412,350,287,63,2,17,41,53,288,257,31,0,6,18,24
381,RANDALL,381,0309,3810309,7477,6780,4870,1910,40,193,1412,1598,5107,3825,1282,16,115,950,1063
309,MCLENNAN,309,0074,3090074,6707,1130,839,291,11,54,213,258,864,660,204,9,38,143,179
113,DALLAS,113,3306,1133306,2582,4580,1099,3481,85,1075,2312,3335,3161,953,2208,78,627,1471,2073
157,FORT BEND,157,2018,1572018,3647,3884,2114,1770,74,111,1525,1623,2852,1666,1186,52,67,1010,1072
61,CAMERON,61,0045,610045,1457,4245,63,4182,1,7,4174,4174,2879,29,2850,1,6,2844,2844
439,TARRANT,439,4182,4394182,8473,4618,3299,1319,504,273,424,681,3537,2637,900,314,179,316,485
491,WILLIAMSON,491,0175,4910175,9409,5471,2535,2936,1172,441,1241,1648,4243,2192,2051,784,315,859,1160
439,TARRANT,439,4666,4394666,8579,0,0,0,0,0,0,0,0,0,0,0,0,0,0
491,WILLIAMSON,491,0413,4910413,9515,4294,3061,1233,59,114,955,1057,3330,2505,825,30,75,629,700
449,TITUS,449,0015,4490015,8665,1728,856,872,16,88,738,816,1257,692,565,12,68,461,525
29,BEXAR,29,4028,294028,839,3682,462,3220,48,139,3065,3156,2926,412,2514,42,104,2386,2461
29,BEXAR,29,2108,292108,521,1549,729,820,49,62,711,757,1251,642,609,34,38,525,558
491,WILLIAMSON,491,0251,4910251,9435,135,117,18,0,1,12,13,110,98,12,0,1,9,10
201,HARRIS,201,0512,2010512,4729,10464,1959,8505,1095,2122,5292,7294,8009,1660,6349,876,1569,3867,5370
157,FORT BEND,157,2153,1572153,3690,3437,107,3330,62,2852,465,3266,2425,85,2340,52,2014,304,2289
215,HIDALGO,215,0113,2150113,5665,7840,507,7333,130,55,7151,7174,5617,434,5183,101,44,5034,5056
119,DELTA,119,0005,1190005,2920,1338,1004,334,15,110,144,246,1035,803,232,9,71,97,165
491,WILLIAMSON,491,0473,4910473,9538,2328,890,1438,39,62,1303,1350,1713,748,965,28,45,855,892
167,GALVESTON,167,0193,1670193,3856,4436,2874,1562,313,377,772,1134,3247,2193,1054,210,265,501,762
441,TAYLOR,441,0103,4410103,8602,4665,2626,2039,86,541,1328,1805,3474,2133,1341,54,328,841,1151
29,BEXAR,29,4131,294131,942,869,188,681,38,194,465,640,638,157,481,28,140,316,449
393,ROBERTS,393,0003,3930003,7537,225,191,34,4,5,17,21,166,140,26,1,2,15,17
201,HARRIS,201,0409,2010409,4626,5840,430,5410,37,245,5137,5350,4030,366,3664,32,180,3458,3610
113,DALLAS,113,4522,1134522,2817,5935,1245,4690,727,1767,2172,3889,4333,1080,3253,517,1246,1448,2674
157,FORT BEND,157,4001,1574001,3753,4352,1637,2715,155,827,1738,2510,3599,1507,2092,109,665,1292,1933
297,LIVE OAK,297,0009,2970009,6498,1691,706,985,9,26,909,924,1288,577,711,5,10,655,664
1,ANDERSON,1,0006,10006,6,2173,750,1423,13,828,569,1379,1588,656,932,7,580,333,901
201,HARRIS,201,0472,2010472,4689,1804,988,816,498,81,190,267,1398,791,607,371,62,145,203
303,LUBBOCK,303,0127,3030127,6601,3927,2602,1325,137,202,914,1088,3200,2219,981,112,138,671,797
215,HIDALGO,215,0010,2150010,5562,4712,236,4476,13,24,4446,4455,3467,197,3270,7,20,3248,3256
201,HARRIS,201,0280,2010280,4497,4460,325,4135,90,947,3142,4022,3173,290,2883,71,637,2198,2796
409,SAN PATRICIO,409,0122,4090122,7666,92,26,66,1,2,58,58,66,13,53,1,1,48,48
385,REAL,385,0004,3850004,7497,121,89,32,2,4,24,26,99,80,19,2,4,11,13
379,RAINS,379,0305,3790305,7454,1226,952,274,14,59,142,196,1011,811,200,14,40,96,133
213,HENDERSON,213,01CR,21301CR,5539,2894,2397,497,13,44,339,381,2231,1889,342,9,26,215,240
471,WALKER,471,0102,4710102,9157,11372,5599,5773,428,2795,2416,5160,10116,5074,5042,373,2434,2100,4498
201,HARRIS,201,0343,2010343,4560,5277,320,4957,103,320,4554,4837,4044,294,3750,76,251,3422,3648
215,HIDALGO,215,0073,2150073,5625,4570,755,3815,400,95,3329,3388,3361,623,2738,274,65,2384,2429
97,COOKE,97,0011,970011,1964,4188,2746,1442,32,77,1144,1214,3079,2196,883,22,41,681,722
215,HIDALGO,215,0030,2150030,5582,10018,478,9540,142,192,9248,9376,6966,385,6581,108,148,6340,6452
5,ANGELINA,5,0022,50022,49,1665,1412,253,9,52,161,209,1252,1092,160,7,37,94,127
85,COLLIN,85,0123,850123,1752,3273,1716,1557,682,432,382,797,2477,1407,1070,467,314,247,551
157,FORT BEND,157,2077,1572077,3667,3073,197,2876,327,2011,550,2522,2325,163,2162,279,1517,354,1860
289,LEON,289,0008,2890008,6432,1665,1069,596,36,67,451,513,1227,835,392,22,52,289,338
113,DALLAS,113,3082,1133082,2519,7704,260,7444,27,3899,3555,7401,5067,213,4854,16,2611,2241,4829
157,FORT BEND,157,3064,1573064,3710,4352,1846,2506,1306,392,774,1149,3352,1544,1808,985,254,539,789
85,COLLIN,85,0166,850166,1795,6546,2752,3794,2247,907,566,1451,4393,1912,2481,1519,568,337,898
113,DALLAS,113,3960,1133960,2645,5113,2452,2661,510,1143,946,2043,3708,1881,1827,374,788,596,1365
439,TARRANT,439,4201,4394201,8476,2645,68,2577,19,46,2525,2558,1882,55,1827,9,35,1790,1815
29,BEXAR,29,3126,293126,730,2863,1339,1524,188,77,1246,1312,2035,1021,1014,116,42,831,868
205,HARTLEY,205,0202,2050202,5413,1490,833,657,4,186,464,648,1316,695,621,4,182,434,614
215,HIDALGO,215,0156,2150156,5708,3462,89,3373,2,17,3351,3358,2458,73,2385,1,4,2379,2382
141,EL PASO,141,0185,1410185,3498,905,246,659,27,81,577,625,725,221,504,19,45,434,472
485,WICHITA,485,0106,4850106,9326,34,29,5,0,3,0,3,26,25,1,0,1,0,1
159,FRANKLIN,159,0102,1590102,3793,720,583,137,4,23,80,99,556,463,93,2,9,57,66
373,POLK,373,0015,3730015,7411,3283,2721,562,28,98,335,429,2533,2174,359,17,54,208,261
397,ROCKWALL,397,004D,397004D,7580,2461,1690,771,100,200,429,614,1565,1123,442,69,114,224,332
83,COLEMAN,83,0002,830002,1626,1465,1126,339,8,59,236,292,1140,893,247,2,34,179,212
113,DALLAS,113,4519,1134519,2814,4487,1239,3248,700,1230,1284,2480,3401,1051,2350,532,897,874,1755
405,SAN AUGUSTINE,405,0001,4050001,7623,1844,981,863,10,636,234,845,1454,832,622,5,479,147,613
365,PANOLA,365,0014,3650014,7328,680,549,131,6,33,50,83,494,410,84,4,23,32,55
491,WILLIAMSON,491,0278,4910278,9452,6222,3904,2318,439,365,1384,1690,4835,3186,1649,334,245,944,1171
439,TARRANT,439,3507,4393507,8350,4311,2596,1715,153,398,1028,1390,3181,2049,1132,112,232,688,906
303,LUBBOCK,303,0135,3030135,6604,662,447,215,16,21,161,177,507,366,141,10,11,107,118
361,ORANGE,361,0030,3610030,7285,1540,1173,367,87,39,192,225,1207,948,259,72,19,127,143
113,DALLAS,113,3503,1133503,2602,1855,929,926,287,380,230,605,1372,732,640,205,246,161,405
91,COMAL,91,0304,910304,1921,5889,2887,3002,183,280,2459,2684,4417,2335,2082,125,196,1677,1846
439,TARRANT,439,3324,4393324,8304,4070,2519,1551,145,468,872,1289,3160,2096,1064,113,291,569,841
489,WILLACY,489,0004,4890004,9369,2446,182,2264,12,19,2231,2237,1866,147,1719,11,11,1687,1693
201,HARRIS,201,0469,2010469,4686,4407,3062,1345,206,293,781,1040,3425,2506,919,142,179,517,686
215,HIDALGO,215,0199,2150199,5751,4323,379,3944,289,88,3586,3637,3080,290,2790,236,54,2501,2544
85,COLLIN,85,0209,850209,1838,2280,1006,1274,751,236,261,477,1442,663,779,459,150,148,289
113,DALLAS,113,4029,1134029,2691,104,7,97,7,20,71,85,61,6,55,1,6,44,48
29,BEXAR,29,3167,293167,773,50,16,34,1,8,28,34,50,16,34,1,8,28,34
209,HAYS,209,0220,2090220,5456,4658,2924,1734,150,200,1287,1442,3268,2146,1122,105,119,817,914
29,BEXAR,29,4008,294008,819,1236,546,690,41,151,494,621,1170,528,642,40,145,455,579
77,CLAY,77,0013,770013,1606,174,149,25,2,2,2,4,144,128,16,2,0,1,1
439,TARRANT,439,4060,4394060,8430,3210,1766,1444,221,147,1022,1155,2637,1516,1121,182,114,762,868
71,CHAMBERS,71,0012,710012,1563,2400,1235,1165,15,362,731,1087,1709,973,736,6,273,414,683
141,EL PASO,141,0165,1410165,3478,7796,154,7642,25,62,7429,7449,5480,108,5372,18,22,5235,5247
303,LUBBOCK,303,0045,3030045,6558,730,362,368,3,21,346,361,522,288,234,1,12,222,231
293,LIMESTONE,293,0403,2930403,6478,541,373,168,6,69,77,145,433,324,109,6,42,49,91
439,TARRANT,439,3560,4393560,8367,0,0,0,0,0,0,0,0,0,0,0,0,0,0
291,LIBERTY,291,0020,2910020,6452,6063,2563,3500,78,1364,1961,3284,4674,2122,2552,62,1066,1341,2382
355,NUECES,355,0106,3550106,7222,3782,1013,2769,61,299,2390,2644,2912,883,2029,48,197,1731,1919
201,HARRIS,201,0363,2010363,4580,8801,2169,6632,135,3042,3453,6379,6818,1920,4898,105,2296,2457,4690
29,BEXAR,29,4088,294088,899,6702,1408,5294,317,2046,3092,4945,4980,1180,3800,263,1495,2099,3505
143,ERATH,143,0019,1430019,3541,2342,1781,561,17,41,447,486,1838,1435,403,10,29,315,343
439,TARRANT,439,4124,4394124,8456,1389,924,465,58,42,330,367,1179,834,345,44,26,234,258
167,GALVESTON,167,0392,1670392,3899,2282,732,1550,35,199,1277,1453,1616,597,1019,26,132,825,944
201,HARRIS,201,0452,2010452,4669,5483,2482,3001,407,724,1738,2414,4163,2021,2142,324,476,1208,1669
281,LAMPASAS,281,0006,2810006,6389,607,484,123,8,8,89,93,507,431,76,7,4,47,49
113,DALLAS,113,4050,1134050,2708,7133,1005,6128,344,3628,2160,5706,5096,808,4288,273,2537,1444,3933
85,COLLIN,85,0040,850040,1669,4481,3016,1465,268,341,701,1019,3540,2521,1019,200,216,456,668
29,BEXAR,29,2182C,292182C,604,797,189,608,58,129,431,544,500,127,373,34,72,265,332
491,WILLIAMSON,491,0380,4910380,9495,134,112,22,2,4,12,14,107,93,14,1,2,6,7
415,SCURRY,415,0010,4150010,7686,1699,1016,683,11,99,544,630,1348,832,516,7,82,392,470
475,WARD,475,003S,475003S,9200,482,200,282,5,19,258,273,353,164,189,3,13,175,186
201,HARRIS,201,0300,2010300,4517,4221,2854,1367,610,129,553,667,2894,1980,914,408,85,361,444
439,TARRANT,439,4395,4394395,8519,1240,997,243,18,27,147,170,977,806,171,14,19,104,119
165,GAINES,165,0008,1650008,3836,3049,1169,1880,11,136,1745,1859,2056,790,1266,6,89,1171,1258
215,HIDALGO,215,0093,2150093,5645,386,103,283,4,4,277,278,298,100,198,2,1,193,194
493,WILSON,493,0414,4930414,9558,4325,2655,1670,30,59,1476,1520,3281,2132,1149,17,50,1001,1041
201,HARRIS,201,1132,2011132,5350,0,0,0,0,0,0,0,0,0,0,0,0,0,0
113,DALLAS,113,4118,1134118,2771,0,0,0,0,0,0,0,0,0,0,0,0,0,0
29,BEXAR,29,3063,293063,667,2662,1067,1595,77,146,1396,1495,2131,975,1156,52,80,1030,1090
85,COLLIN,85,0103,850103,1732,2933,836,2097,152,425,1478,1885,2098,696,1402,108,251,985,1230
309,MCLENNAN,309,0035,3090035,6667,2539,553,1986,27,656,1308,1937,1744,472,1272,17,450,789,1232
29,BEXAR,29,4111,294111,922,1227,82,1145,11,777,399,1121,682,62,620,11,415,208,604
113,DALLAS,113,4557,1134557,2837,0,0,0,0,0,0,0,0,0,0,0,0,0,0
201,HARRIS,201,0535,2010535,4752,927,105,822,2,13,806,812,676,87,589,2,10,580,586
491,WILLIAMSON,491,0419,4910419,9518,1240,528,712,72,151,479,610,902,411,491,52,103,327,422
215,HIDALGO,215,0136,2150136,5688,2567,306,2261,28,34,2192,2216,2002,263,1739,28,15,1691,1702
401,RUSK,401,0314A,4010314A,7603,1307,1025,282,9,109,135,242,1013,805,208,4,92,86,177
91,COMAL,91,0106,910106,1901,4431,3269,1162,78,97,870,939,3500,2696,804,51,62,599,649
307,MCCULLOCH,307,0101,3070101,6624,1744,1292,452,14,37,388,417,1379,1110,269,9,19,229,246
439,TARRANT,439,4495,4394495,8539,239,84,155,1,80,72,152,228,84,144,1,80,62,142
29,BEXAR,29,4154,294154,965,1185,256,929,89,118,732,825,915,225,690,67,75,539,608
85,COLLIN,85,0229,850229,1858,2415,1188,1227,371,389,410,789,1746,883,863,232,289,282,564
157,FORT BEND,157,4082,1574082,3773,11790,5284,6506,2019,2324,2089,4347,8444,3946,4498,1421,1619,1360,2946
161,FREESTONE,161,0010,1610010,3816,518,404,114,2,38,62,97,401,314,87,1,31,46,75
303,LUBBOCK,303,0092,3030092,6581,755,418,337,21,50,253,290,566,354,212,13,32,150,175
29,BEXAR,29,4025,294025,836,2624,381,2243,18,103,2116,2194,1909,319,1590,11,63,1496,1548
113,DALLAS,113,4095,1134095,2751,99,24,75,2,7,67,73,77,22,55,1,5,49,53
201,HARRIS,201,0449,2010449,4666,11,0,11,1,8,3,10,7,0,7,0,7,0,7
491,WILLIAMSON,491,0231,4910231,9432,3166,1971,1195,158,225,756,952,2251,1473,778,104,130,490,608
215,HIDALGO,215,0050,2150050,5602,4774,79,4695,8,19,4671,4679,3317,73,3244,8,14,3224,3232
389,REEVES,389,0003,3890003,7517,4550,439,4111,68,134,3951,4033,4122,378,3744,64,125,3598,3674
85,COLLIN,85,0143,850143,1772,2902,1805,1097,436,253,340,591,2487,1576,911,379,220,253,471
157,FORT BEND,157,2136,1572136,3687,481,109,372,15,239,119,354,372,95,277,9,181,80,260
469,VICTORIA,469,0017,4690017,9137,1003,313,690,14,115,560,652,685,254,431,9,57,353,405
297,LIVE OAK,297,0006,2970006,6495,269,203,66,1,0,56,56,219,165,54,1,0,45,45
113,DALLAS,113,4003,1134003,2665,4659,272,4387,79,149,4146,4280,3057,215,2842,65,101,2660,2753
201,HARRIS,201,1089,2011089,5307,44,0,44,4,8,40,40,25,0,25,4,8,21,21
491,WILLIAMSON,491,0123,4910123,9389,8219,2876,5343,217,966,4111,4959,5973,2373,3600,161,638,2715,3307
439,TARRANT,439,2405,4392405,8158,7295,1733,5562,1203,2726,1626,4243,5211,1322,3889,892,1879,1057,2876
215,HIDALGO,215,0007,2150007,5559,6407,672,5735,117,46,5588,5607,4929,611,4318,109,31,4186,4202
151,FISHER,151,0010A,1510010A,3601,951,550,401,12,76,323,380,729,444,285,8,45,225,264
439,TARRANT,439,4121,4394121,8453,4742,2067,2675,63,115,2434,2520,3595,1788,1807,52,68,1624,1680
29,BEXAR,29,3187,293187,793,0,0,0,0,0,0,0,0,0,0,0,0,0,0
201,HARRIS,201,0406,2010406,4623,958,15,943,6,634,320,934,719,10,709,1,494,218,703
439,TARRANT,439,2561,4392561,8201,0,0,0,0,0,0,0,0,0,0,0,0,0,0
375,POTTER,375,0322,3750322,7431,279,203,76,2,16,41,56,215,162,53,0,9,29,37
201,HARRIS,201,0154,2010154,4371,4912,203,4709,43,62,4613,4649,3658,174,3484,22,37,3416,3446
439,TARRANT,439,4259,4394259,8496,1416,1165,251,33,30,131,155,1181,1003,178,24,22,77,94
273,KLEBERG,273,0023,2730023,6329,734,132,602,6,32,562,588,555,124,431,4,21,401,419
113,DALLAS,113,3062,1133062,2499,5935,90,5845,42,4692,1154,5773,3818,69,3749,29,3041,687,3696
157,FORT BEND,157,3121,1573121,3730,1491,590,901,439,175,266,441,1289,527,762,379,148,215,363
361,ORANGE,361,0010,3610010,7265,1360,886,474,25,138,291,427,1041,726,315,15,66,213,279
113,DALLAS,113,4300,1134300,2794,3815,194,3621,29,84,3513,3575,2727,178,2549,18,56,2469,2512
141,EL PASO,141,0122,1410122,3435,5404,303,5101,69,116,4946,5024,4185,251,3934,52,80,3806,3868
397,ROCKWALL,397,001BB,397001BB,7560,0,0,0,0,0,0,0,0,0,0,0,0,0,0
85,COLLIN,85,0100,850100,1729,94,16,78,12,17,51,62,69,13,56,8,8,39,42
85,COLLIN,85,0083,850083,1712,6169,4009,2160,313,662,1029,1651,4474,3071,1403,211,389,680,1051
203,HARRISON,203,0010,2030010,5393,1442,934,508,22,298,152,449,1140,783,357,21,222,81,302
113,DALLAS,113,3963,1133963,2648,3722,1829,1893,339,816,701,1485,2741,1425,1316,237,546,483,1013
201,HARRIS,201,0346,2010346,4563,0,0,0,0,0,0,0,0,0,0,0,0,0,0
147,FANNIN,147,0017,1470017,3584,1128,953,175,14,23,79,102,904,789,115,7,9,50,59
201,HARRIS,201,0320,2010320,4537,4436,478,3958,40,135,3793,3903,3200,438,2762,36,102,2629,2718
209,HAYS,209,0432,2090432,5499,2305,1564,741,48,105,533,626,1758,1237,521,31,71,368,435
439,TARRANT,439,3750,4393750,8410,0,0,0,0,0,0,0,0,0,0,0,0,0,0
29,BEXAR,29,3144,293144,750,559,243,316,51,97,176,265,447,208,239,36,79,126,200
367,PARKER,367,0350,3670350,7371,3571,2872,699,31,37,461,493,2803,2313,490,18,22,324,344
381,RANDALL,381,0305,3810305,7474,4778,3413,1365,51,148,984,1114,3668,2708,960,29,101,693,785
85,COLLIN,85,0057,850057,1686,7729,4090,3639,526,1343,1621,2905,5760,3329,2431,366,882,1056,1912
439,TARRANT,439,3327,4393327,8307,2059,1427,632,86,116,359,453,1698,1233,465,73,82,259,328
303,LUBBOCK,303,0024,3030024,6538,3996,1602,2394,81,507,1774,2221,3041,1397,1644,54,313,1230,1511
479,WEBB,479,0221,4790221,9243,1633,96,1537,5,8,1520,1525,1229,76,1153,4,6,1142,1147
485,WICHITA,485,0306,4850306,9346,562,402,160,9,28,96,124,487,376,111,3,26,61,87
113,DALLAS,113,3019,1133019,2456,1487,64,1423,12,1236,185,1401,1157,57,1100,11,944,144,1078
289,LEON,289,0011,2890011,6435,1849,1038,811,31,180,554,728,1358,815,543,20,134,347,480
29,BEXAR,29,3043,293043,647,4096,2376,1720,188,263,1198,1431,3055,1857,1198,110,174,818,979
29,BEXAR,29,3083,293083,687,2573,1235,1338,74,139,1099,1211,2071,1091,980,55,96,784,870
201,HARRIS,201,1152,2011152,5370,455,330,125,7,24,75,97,342,263,79,7,17,42,59
29,BEXAR,29,2171,292171,584,2490,786,1704,116,193,1395,1565,1995,697,1298,90,135,1059,1183
85,COLLIN,85,0186,850186,1815,183,147,36,4,7,18,25,139,122,17,1,1,12,13
479,WEBB,479,0401,4790401,9283,3136,185,2951,8,40,2883,2920,2457,156,2301,5,36,2245,2278
29,BEXAR,29,4068,294068,879,1246,265,981,53,363,596,917,957,217,740,42,284,431,689
65,CARSON,65,0103,650103,1520,661,490,171,4,19,107,125,505,376,129,4,16,81,96
29,BEXAR,29,3170,293170,776,1,0,1,0,1,0,1,1,0,1,0,1,0,1
491,WILLIAMSON,491,0323,4910323,9475,112,77,35,7,8,22,28,85,67,18,7,4,7,11
265,KERR,265,0416,2650416,6306,2639,1731,908,18,29,775,800,2223,1549,674,11,11,564,573
303,LUBBOCK,303,0002,3030002,6518,3315,971,2344,41,247,2051,2249,2454,812,1642,34,150,1426,1560
113,DALLAS,113,4026,1134026,2688,402,22,380,8,65,313,374,293,20,273,6,48,222,269
201,HARRIS,201,0386,2010386,4603,2455,1452,1003,19,232,734,947,1944,1228,716,13,178,496,669
491,WILLIAMSON,491,0182,4910182,9412,1640,889,751,426,73,195,266,1017,580,437,238,50,116,165
157,FORT BEND,157,1103,1571103,3624,9001,4386,4615,511,1684,2278,3912,6550,3371,3179,394,1140,1531,2641
439,TARRANT,439,4068,4394068,8433,3900,199,3701,37,126,3567,3667,2807,171,2636,24,84,2548,2616
439,TARRANT,439,3663,4393663,8390,18,2,16,4,2,4,5,10,2,8,0,0,1,1
293,LIMESTONE,293,0305,2930305,6475,555,382,173,4,76,83,154,465,333,132,1,63,55,116
85,COLLIN,85,0080,850080,1709,5124,2824,2300,730,659,758,1389,3849,2233,1616,529,447,507,946
395,ROBERTSON,395,0001,3950001,7540,1548,762,786,16,546,189,728,1182,613,569,16,397,125,520
491,WILLIAMSON,491,0284,4910284,9455,6100,3934,2166,348,340,1337,1641,4674,3163,1511,237,229,920,1128
439,TARRANT,439,3486,4393486,8347,6496,4125,2371,566,648,1018,1618,4323,2846,1477,345,377,621,983
147,FANNIN,147,0013,1470013,3581,696,557,139,13,10,76,83,580,483,97,10,5,48,53
277,LAMAR,277,001H,277001H,6349,764,663,101,0,15,55,69,599,532,67,0,10,31,41
81,COKE,81,0002,810002,1621,799,648,151,5,2,110,110,656,537,119,1,0,85,85
113,DALLAS,113,1172,1131172,2119,3560,1611,1949,711,389,811,1162,2628,1359,1269,399,282,537,800
113,DALLAS,113,3983,1133983,2660,3255,1877,1378,419,400,456,845,2360,1432,928,303,244,308,548
113,DALLAS,113,1704,1131704,2162,2986,578,2408,817,469,1091,1547,2238,513,1725,577,348,767,1113
157,FORT BEND,157,4154,1574154,3785,6061,1490,4571,477,1539,2521,3982,4356,1204,3152,340,1029,1696,2701
339,MONTGOMERY,339,0088,3390088,6988,7273,3841,3432,881,983,1410,2354,4839,2635,2204,554,647,886,1514
439,TARRANT,439,2258,4392258,8113,1328,700,628,16,119,478,594,999,580,419,11,80,316,396
441,TAYLOR,441,0202,4410202,8611,7302,2210,5092,61,723,4315,4907,5286,1813,3473,35,471,2913,3342
449,TITUS,449,0003,4490003,8654,1096,657,439,6,102,303,401,857,566,291,4,66,196,262
469,VICTORIA,469,0032,4690032,9152,2891,528,2363,64,356,1987,2279,2138,446,1692,56,247,1395,1617
201,HARRIS,201,0066,2010066,4283,2823,102,2721,12,176,2524,2692,2117,94,2023,5,153,1850,2003
201,HARRIS,201,0607,2010607,4824,3163,62,3101,28,2148,985,3049,1931,57,1874,26,1245,629,1838
201,HARRIS,201,0109,2010109,4326,4694,88,4606,54,3489,1104,4531,3186,60,3126,34,2415,686,3076
231,HUNT,231,0109,2310109,5949,2162,1566,596,24,38,462,496,1626,1230,396,16,21,296,315
291,LIBERTY,291,0010,2910010,6447,10418,5845,4573,107,1681,2559,4226,8762,5029,3733,88,1421,2044,3456
297,LIVE OAK,297,0001,2970001,6490,721,456,265,10,6,226,228,624,421,203,9,2,167,169
21,BASTROP,21,1002,211002,147,807,567,240,22,37,152,185,647,481,166,22,20,104,122
29,BEXAR,29,1145,291145,396,992,397,595,48,106,455,545,727,330,397,30,74,302,364
41,BRAZOS,41,0038,410038,1229,750,49,701,4,340,358,686,533,37,496,2,256,237,486
61,CAMERON,61,0066,610066,1478,5685,657,5028,39,31,4953,4957,3956,528,3428,31,16,3372,3374
113,DALLAS,113,2125,1132125,2311,6693,844,5849,291,4224,1379,5495,5297,771,4526,248,3291,1014,4241
113,DALLAS,113,3119,1133119,2560,0,0,0,0,0,0,0,0,0,0,0,0,0,0
309,MCLENNAN,309,0007,3090007,6639,3456,841,2615,49,839,1709,2512,2539,715,1824,34,603,1171,1752
337,MONTAGUE,337,0011,3370011,6888,1704,1258,446,22,25,323,341,1308,1028,280,21,8,194,198
421,SHERMAN,421,0401,4210401,7721,700,420,280,4,11,260,267,482,306,176,4,5,163,167
439,TARRANT,439,1415,4391415,7970,5020,545,4475,116,1609,2735,4283,3461,482,2979,85,1127,1713,2823
453,TRAVIS,453,0226,4530226,8803,3790,2488,1302,223,241,781,997,3331,2250,1081,188,193,640,818
459,UPSHUR,459,0010,4590010,9052,3563,3021,542,17,117,253,361,2708,2368,340,16,78,132,204
141,EL PASO,141,0080,1410080,3393,2731,51,2680,8,30,2657,2667,2030,29,2001,5,18,1988,1992
157,FORT BEND,157,2003,1572003,3642,7839,312,7527,114,1738,5797,7423,5322,251,5071,79,1234,3806,4989
201,HARRIS,201,0507,2010507,4724,17067,318,16749,4093,1883,10802,12512,12391,239,12152,3024,1388,7777,9033
201,HARRIS,201,0258,2010258,4475,4877,3553,1324,708,66,477,530,3390,2555,835,457,45,287,324
215,HIDALGO,215,0005,2150005,5557,3705,54,3651,4,6,3647,3648,2542,33,2509,4,4,2505,2506
215,HIDALGO,215,0254,2150254,5806,8818,193,8625,15,34,8593,8597,5689,108,5581,7,22,5562,5566
27,BELL,27,0413,270413,247,8862,1827,7035,681,4056,2477,6110,5646,1354,4292,433,2456,1360,3653
29,BEXAR,29,3182,293182,788,951,403,548,38,30,472,490,796,374,422,26,17,368,377
49,BROWN,49,0306,490306,1329,2769,2211,558,57,57,364,413,2144,1756,388,45,27,240,265
85,COLLIN,85,0241,850241,1870,2757,1449,1308,822,227,227,450,1956,1059,897,543,170,163,330
113,DALLAS,113,2610,1132610,2411,0,0,0,0,0,0,0,0,0,0,0,0,0,0
121,DENTON,121,1028,1211028,2952,543,201,342,30,37,265,300,394,156,238,20,29,180,208
315,MARION,315,0006,3150006,6739,1257,798,459,11,385,36,413,1012,656,356,6,305,22,326
361,ORANGE,361,0025,3610025,7280,2904,2298,606,90,54,362,414,2164,1784,380,56,23,229,252
431,STERLING,431,0002C,4310002C,7821,11,6,5,1,2,3,5,10,6,4,1,1,3,4
439,TARRANT,439,3542,4393542,8362,3533,2360,1173,302,182,608,773,2703,1911,792,208,116,400,505
453,TRAVIS,453,0360,4530360,8903,4333,2978,1355,426,97,711,792,3266,2351,915,268,64,489,546
491,WILLIAMSON,491,0261,4910261,9444,4857,2701,2156,279,478,1315,1747,3429,1985,1444,174,320,864,1166
141,EL PASO,141,0180,1410180,3493,4562,243,4319,19,111,4208,4298,3427,226,3201,16,90,3101,3187
183,GREGG,183,0007,1830007,4034,5558,3781,1777,106,807,695,1488,3901,2789,1112,72,502,403,903
201,HARRIS,201,0358,2010358,4575,6420,191,6229,99,2813,3366,6103,4315,143,4172,87,1903,2206,4070
201,HARRIS,201,0898,2010898,5116,4393,794,3599,307,1086,2244,3240,3135,656,2479,238,734,1521,2204
215,HIDALGO,215,0105,2150105,5657,6659,362,6297,178,86,6036,6097,4669,291,4378,120,56,4206,4243
251,JOHNSON,251,0039,2510039,6198,4167,2840,1327,118,325,769,1076,2910,2050,860,86,191,483,671
15,AUSTIN,15,0104,150104,119,1168,751,417,12,59,314,370,938,631,307,9,42,227,267
29,BEXAR,29,3177,293177,783,0,0,0,0,0,0,0,0,0,0,0,0,0,0
29,BEXAR,29,2039,292039,451,2193,269,1924,23,74,1826,1887,1755,233,1522,16,53,1448,1492
39,BRAZORIA,39,0002,390002,1115,6044,3741,2303,66,815,1296,2072,4663,3024,1639,49,580,888,1464
61,CAMERON,61,0035,610035,1447,2268,440,1828,8,28,1789,1801,1711,367,1344,8,26,1316,1328
141,EL PASO,141,0055,1410055,3368,3993,634,3359,192,452,2785,3146,3105,576,2529,159,334,2048,2345
453,TRAVIS,453,0401,4530401,8941,4578,2500,2078,309,293,1431,1698,4212,2410,1802,284,244,1228,1450
479,WEBB,479,0343,4790343,9273,3473,177,3296,17,15,3242,3251,2753,155,2598,15,12,2549,2558
499,WOOD,499,04-2,49904-2,9605,3709,3080,629,56,52,397,435,2993,2568,425,42,33,254,278
215,HIDALGO,215,0140,2150140,5692,89,15,74,11,0,60,60,64,13,51,9,0,39,39
361,ORANGE,361,0026,3610026,7281,3822,3193,629,123,69,349,413,2826,2403,423,104,39,220,257
401,RUSK,401,0417,4010417,7613,2726,1488,1238,12,332,817,1147,2006,1179,827,8,235,519,754
439,TARRANT,439,1298,4391298,7945,4990,3691,1299,216,253,693,928,4434,3356,1078,202,205,537,733
439,TARRANT,439,3185,4393185,8277,0,0,0,0,0,0,0,0,0,0,0,0,0,0
441,TAYLOR,441,0110,4410110,8609,129,119,10,0,0,3,3,106,98,8,0,0,2,2
157,FORT BEND,157,3042,1573042,3700,1426,927,499,224,95,149,237,1263,853,410,183,75,122,193
183,GREGG,183,0005,1830005,4032,6607,4261,2346,208,1074,884,1924,5233,3599,1634,149,761,550,1301
201,HARRIS,201,0810,2010810,5028,604,28,576,5,39,538,571,438,27,411,1,25,388,409
201,HARRIS,201,0147,2010147,4364,5910,390,5520,84,3147,2322,5403,4279,322,3957,61,2352,1536,3866
201,HARRIS,201,0479,2010479,4696,6236,3552,2684,421,896,1255,2101,4677,2874,1803,297,586,824,1393
201,HARRIS,201,1142,2011142,5360,603,419,184,33,28,97,122,429,295,134,26,17,67,81
13,ATASCOSA,13,0001,130001,96,1305,551,754,20,15,696,710,1041,466,575,14,15,526,540
29,BEXAR,29,3154,293154,760,2056,1279,777,60,74,638,688,1689,1109,580,41,54,476,519
29,BEXAR,29,2016,292016,428,2526,66,2460,9,29,2429,2448,1889,55,1834,9,22,1807,1822
185,GRIMES,185,0007,1850007,4055,2127,1468,659,25,194,357,535,1648,1184,464,21,129,239,356
201,HARRIS,201,0833,2010833,5051,22,3,19,5,4,11,13,18,3,15,5,4,7,9
201,HARRIS,201,0502,2010502,4719,6379,3154,3225,64,620,2410,3000,4497,2471,2026,44,372,1497,1858
453,TRAVIS,453,0376,4530376,8918,4171,3481,690,196,82,289,365,3420,2929,491,128,65,200,260
339,MONTGOMERY,339,0031,3390031,6926,6151,4275,1876,580,253,928,1148,4942,3619,1323,407,175,643,798
361,ORANGE,361,0003,3610003,7258,2257,471,1786,30,1509,228,1728,1725,403,1322,23,1124,154,1273
399,RUNNELS,399,0009,3990009,7590,1163,691,472,6,16,447,458,872,537,335,5,11,312,322
439,TARRANT,439,1236,4391236,7922,1075,563,512,28,125,343,456,860,489,371,20,108,226,325
439,TARRANT,439,3038,4393038,8254,8104,3401,4703,395,768,3455,4164,6035,2881,3154,293,508,2262,2755
439,TARRANT,439,4694,4394694,8586,3817,1829,1988,287,745,954,1660,2564,1306,1258,190,436,618,1033
201,HARRIS,201,0170,2010170,4387,5904,1247,4657,36,474,4135,4560,4176,1050,3126,31,297,2767,3050
201,HARRIS,201,1165,2011165,5383,0,0,0,0,0,0,0,0,0,0,0,0,0,0
215,HIDALGO,215,0163,2150163,5715,13599,265,13334,19,43,13286,13288,8244,191,8053,13,13,8021,8023
245,JEFFERSON,245,0019,2450019,6047,2946,147,2799,43,1845,917,2742,2124,131,1993,38,1376,580,1945
279,LAMB,279,0008,2790008,6379,3257,1525,1732,10,149,1557,1680,2398,1258,1140,7,96,1016,1097
303,LUBBOCK,303,0120,3030120,6594,5712,3425,2287,63,128,1952,2056,4173,2640,1533,42,67,1281,1341
29,BEXAR,29,4018,294018,829,1233,657,576,28,30,511,538,1082,605,477,23,24,422,444
39,BRAZORIA,39,0048,390048,1161,6159,2378,3781,115,778,2796,3511,4431,1897,2534,74,517,1838,2336
61,CAMERON,61,0081,610081,1493,3495,438,3057,10,26,3028,3038,2572,400,2172,7,17,2149,2158
85,COLLIN,85,0196,850196,1825,3162,1693,1469,522,475,422,877,2187,1227,960,357,310,263,567
113,DALLAS,113,3052,1133052,2489,4552,88,4464,17,3396,1066,4426,3287,84,3203,12,2522,679,3178
113,DALLAS,113,1412,1131412,2157,930,249,681,8,55,613,666,661,194,467,6,45,412,455
339,MONTGOMERY,339,0010,3390010,6903,7269,822,6447,57,1433,4928,6304,4991,658,4333,37,1049,3221,4241
349,NAVARRO,349,0206,3490206,7066,1077,729,348,9,52,232,280,799,573,226,7,39,136,174
355,NUECES,355,0119,3550119,7235,5399,1878,3521,136,336,2962,3245,4338,1625,2713,117,265,2238,2478
397,ROCKWALL,397,002D,397002D,7567,4117,1906,2211,264,934,961,1850,2942,1472,1470,188,628,594,1202
439,TARRANT,439,1142,4391142,7899,2018,1072,946,51,225,602,821,1534,890,644,32,155,401,553
439,TARRANT,439,2699,4392699,8231,6264,1765,4499,1084,2494,955,3357,4337,1289,3048,701,1716,599,2280
227,HOWARD,227,0032,2270032,5907,308,149,159,2,12,144,155,226,130,96,1,5,88,93
245,JEFFERSON,245,0042,2450042,6070,3514,2626,888,98,93,629,709,2682,2101,581,67,55,412,458
257,KAUFMAN,257,0018,2570018,6239,3873,2901,972,36,206,641,830,2785,2182,603,21,142,368,504
285,LAVACA,285,0208,2850208,6402,913,811,102,1,29,56,80,737,665,72,0,20,39,55
303,LUBBOCK,303,0060,3030060,6571,1540,1164,376,26,37,288,322,1173,914,259,12,25,197,222
315,MARION,315,0001,3150001,6734,851,615,236,2,159,35,191,732,532,200,0,140,22,161
113,DALLAS,113,4528,1134528,2821,0,0,0,0,0,0,0,0,0,0,0,0,0,0
121,DENTON,121,9102,1219102,3153,6,0,6,0,2,3,5,4,0,4,0,0,3,3
201,HARRIS,201,0856,2010856,5074,0,0,0,0,0,0,0,0,0,0,0,0,0,0
201,HARRIS,201,0525,2010525,4742,5414,1047,4367,310,2917,1115,3972,4210,787,3423,285,2348,767,3079
203,HARRISON,203,0023,2030023,5406,768,673,95,6,25,39,62,586,525,61,2,16,23,39
215,HIDALGO,215,0186,2150186,5738,371,29,342,1,4,342,342,320,28,292,0,2,292,292
19,BANDERA,19,0407,190407,142,2922,2140,782,28,29,603,632,2484,1877,607,17,22,451,473
29,BEXAR,29,2062,292062,474,1714,317,1397,29,30,1331,1355,1374,289,1085,20,20,1031,1048
29,BEXAR,29,3200,293200,806,0,0,0,0,0,0,0,0,0,0,0,0,0,0
39,BRAZORIA,39,0025,390025,1138,2839,1430,1409,33,47,1302,1336,2165,1190,975,17,26,900,917
61,CAMERON,61,0058,610058,1470,4916,553,4363,21,35,4276,4293,3519,467,3052,16,16,2989,2997
85,COLLIN,85,0173,850173,1802,709,586,123,36,36,37,68,523,450,73,22,21,17,37
355,NUECES,355,0096,3550096,7212,1521,170,1351,5,42,1309,1343,1200,152,1048,1,32,1010,1040
375,POTTER,375,0123,3750123,7421,5878,3711,2167,250,447,1212,1620,4650,3120,1530,151,303,863,1150
395,ROBERTSON,395,0005,3950005,7544,1924,1395,529,32,305,136,437,1492,1124,368,28,220,90,307
423,SMITH,423,0032,4230032,7753,1851,829,1022,53,396,542,919,1305,658,647,42,257,315,566
439,TARRANT,439,2143,4392143,8085,2311,549,1762,62,128,1545,1650,1660,479,1181,45,97,1007,1096
255,KARNES,255,0010,2550010,6216,412,320,92,2,5,76,80,333,273,60,0,4,49,53
289,LEON,289,0001,2890001,6425,2406,1916,490,21,229,179,407,1954,1551,403,14,192,137,328
303,LUBBOCK,303,0034,3030034,6548,1942,879,1063,6,275,777,1046,1650,772,878,5,260,609,863
321,MATAGORDA,321,0006,3210006,6757,1674,1256,418,18,214,130,340,1479,1139,340,10,178,94,272
337,MONTAGUE,337,0003,3370003,6880,1924,1664,260,16,18,161,178,1481,1328,153,9,7,86,92
351,NEWTON,351,0008A,3510008A,7089,573,476,97,1,71,17,87,438,375,63,1,48,10,58
113,DALLAS,113,1312,1131312,2134,2157,512,1645,15,268,1355,1610,1523,448,1075,11,179,870,1047
201,HARRIS,201,1002,2011002,5220,7374,201,7173,212,1351,5621,6828,4749,142,4607,177,893,3557,4364
213,HENDERSON,213,4NLP,2134NLP,5552,2250,1873,377,7,99,189,283,1750,1481,269,5,72,122,191
215,HIDALGO,215,0209,2150209,5761,7920,149,7771,24,19,7751,7754,4722,82,4640,12,10,4630,4631
225,HOUSTON,225,0008,2250008,5884,461,398,63,3,22,23,45,390,347,43,3,15,12,27
245,JEFFERSON,245,0065,2450065,6093,2345,1723,622,96,253,231,474,1842,1425,417,69,177,143,314
29,BEXAR,29,4141,294141,952,1156,57,1099,5,365,769,1088,688,41,647,3,216,437,638
29,BEXAR,29,1032,291032,282,4117,124,3993,17,38,3950,3968,3157,107,3050,8,14,3029,3036
29,BEXAR,29,1038,291038,288,6295,612,5683,107,327,5293,5534,4499,537,3962,86,218,3649,3833
79,COCHRAN,79,0202,790202,1616,638,304,334,2,24,304,319,443,228,215,2,15,190,202
113,DALLAS,113,4627,1134627,2867,7548,3345,4203,1318,1462,1343,2731,6991,3167,3824,1188,1334,1198,2475
113,DALLAS,113,1745,1131745,2203,4503,1580,2923,589,703,1553,2221,3511,1329,2182,464,516,1117,1618
467,VAN ZANDT,467,002C,467002C,9110,3816,3282,534,32,49,317,364,2975,2608,367,22,38,207,244
303,LUBBOCK,303,0009,3030009,6525,3432,2474,958,164,122,613,704,2799,2128,671,116,72,411,476
323,MAVERICK,323,002E,323002E,6780,1494,175,1319,39,86,1190,1271,1200,163,1037,34,80,926,1002
377,PRESIDIO,377,0002,3770002,7444,877,43,834,17,1,811,812,619,41,578,11,1,561,562
439,TARRANT,439,4102,4394102,8446,3520,902,2618,215,105,2254,2338,2432,746,1686,151,56,1418,1471
439,TARRANT,439,2226,4392226,8108,5156,869,4287,690,1420,2185,3545,3654,727,2927,562,928,1412,2310
453,TRAVIS,453,0181,4530181,8772,5335,1558,3777,973,1102,1721,2748,4442,1393,3049,788,895,1362,2205
113,DALLAS,113,2095,1132095,2280,5,0,5,2,2,1,3,3,0,3,1,2,1,3
141,EL PASO,141,0216,1410216,3531,60,5,55,1,2,55,55,41,4,37,1,1,37,37
197,HARDEMAN,197,0002,1970002,4195,882,637,245,7,61,160,215,671,505,166,5,42,106,144
201,HARRIS,201,0979,2010979,5197,0,0,0,0,0,0,0,0,0,0,0,0,0,0
201,HARRIS,201,0316,2010316,4533,2038,1224,814,495,69,201,261,1587,1001,586,357,44,153,191
223,HOPKINS,223,0008,2230008,5861,364,313,51,2,9,38,47,275,237,38,2,8,26,34
29,BEXAR,29,4164,294164,975,3394,1573,1821,151,299,1330,1568,2657,1365,1292,111,214,896,1088
29,BEXAR,29,4158,294158,969,990,410,580,28,211,330,522,874,375,499,28,185,270,444
29,BEXAR,29,1055,291055,305,3105,666,2439,171,304,1956,2222,2289,526,1763,124,209,1392,1587
63,CAMP,63,3003,633003,1516,3081,1306,1775,51,850,812,1652,2252,1036,1216,40,619,512,1127
85,COLLIN,85,0010,850010,1639,1061,736,325,22,11,243,254,781,583,198,13,8,142,150
113,DALLAS,113,2117,1132117,2303,3796,1177,2619,169,1833,586,2375,3123,1135,1988,166,1296,490,1755
491,WILLIAMSON,491,0303,4910303,9459,4125,1721,2404,1784,103,469,560,2694,1218,1476,1116,54,275,326
201,HARRIS,201,0293,2010293,4510,2003,941,1062,165,223,645,844,1640,821,819,150,170,469,625
219,HOCKLEY,219,0046,2190046,5838,1029,600,429,0,21,374,394,764,472,292,0,17,245,261
381,RANDALL,381,0216,3810216,7467,2959,1947,1012,142,203,623,812,2275,1551,724,106,135,444,575
439,TARRANT,439,2308,4392308,8131,6298,2996,3302,194,1238,1757,2921,4644,2365,2279,129,868,1156,1994
453,TRAVIS,453,0214,4530214,8795,2524,1584,940,210,127,502,616,2232,1417,815,180,107,429,532
469,VICTORIA,469,0013,4690013,9133,2384,462,1922,9,119,1789,1886,1676,376,1300,6,90,1183,1269
113,DALLAS,113,4604,1134604,2844,6762,1370,5392,367,410,4559,4937,4997,1208,3789,306,283,3132,3410
113,DALLAS,113,1722,1131722,2180,6614,1376,5238,402,1965,2871,4734,4758,1181,3577,295,1329,1913,3209
121,DENTON,121,1043,1211043,2967,3214,1296,1918,270,1045,569,1573,2427,1052,1375,223,708,396,1087
141,EL PASO,141,0195,1410195,3508,8988,1659,7329,324,1220,5943,6897,6092,1322,4770,201,751,3765,4429
167,GALVESTON,167,0152,1670152,3846,2035,1563,472,110,90,235,320,1629,1279,350,91,63,165,228
201,HARRIS,201,0956,2010956,5174,6501,309,6192,298,2165,3749,5832,4337,217,4120,234,1425,2459,3848
85,COLLIN,85,0033,850033,1662,6821,4025,2796,273,703,1608,2278,4839,3115,1724,184,425,950,1369
113,DALLAS,113,2142,1132142,2326,5080,572,4508,1811,1174,1516,2660,3499,489,3010,1077,895,1026,1897
121,DENTON,121,1066,1211066,2990,418,217,201,21,61,101,155,291,169,122,14,38,52,84
121,DENTON,121,9300,1219300,3159,0,0,0,0,0,0,0,0,0,0,0,0,0,0
157,FORT BEND,157,2034,1572034,3654,7699,269,7430,210,5916,1411,7194,5267,208,5059,165,4007,919,4864
163,FRIO,163,0002,1630002,3823,2986,156,2830,147,143,2520,2658,2612,136,2476,146,139,2174,2310
461,UPTON,461,0002,4610002,9064,274,134,140,5,9,109,117,224,106,118,3,9,93,101
491,WILLIAMSON,491,0342,4910342,9482,2732,1358,1374,444,302,621,888,1984,1069,915,295,211,386,576
349,NAVARRO,349,0306,3490306,7072,513,300,213,7,26,133,159,381,241,140,1,17,81,98
423,SMITH,423,0015,4230015,7736,4018,3583,435,33,71,213,279,3381,3077,304,24,44,133,176
439,TARRANT,439,2393,4392393,8154,1019,175,844,78,124,635,755,742,154,588,66,88,428,513
439,TARRANT,439,3700,4393700,8400,4655,2743,1912,129,808,915,1665,2934,1863,1071,61,411,524,913
453,TRAVIS,453,0462,4530462,8987,10325,1403,8922,205,926,7861,8634,7662,1256,6406,161,668,5593,6168
453,TRAVIS,453,0244,4530244,8818,4120,1826,2294,748,404,1109,1455,3769,1743,2026,693,343,944,1248
201,HARRIS,201,0025,2010025,4241,1992,140,1852,47,1479,343,1784,1620,133,1487,45,1199,249,1429
201,HARRIS,201,0933,2010933,5151,1260,310,950,265,526,165,673,1053,283,770,216,414,140,546
201,HARRIS,201,0270,2010270,4487,7966,2392,5574,182,1048,4332,5309,6009,2112,3897,162,744,2955,3664
201,HARRIS,201,0687,2010687,4905,3724,1661,2063,1093,276,651,910,2988,1369,1619,871,218,488,693
215,HIDALGO,215,0017,2150017,5569,2804,702,2102,3,10,2089,2093,2263,692,1571,3,3,1563,1564
257,KAUFMAN,257,0012,2570012,6233,3430,2513,917,16,106,669,763,2562,1971,591,13,74,413,482
113,DALLAS,113,4658,1134658,2890,199,48,151,5,9,139,145,140,38,102,5,8,90,96
113,DALLAS,113,3035,1133035,2472,3232,64,3168,10,1768,1412,3134,2297,55,2242,7,1357,872,2221
121,DENTON,121,4210,1214210,3136,7645,5593,2052,821,300,724,1001,5213,3933,1280,510,190,424,606
121,DENTON,121,2089,1212089,3013,4218,2726,1492,630,375,415,759,3456,2318,1138,496,274,312,568
143,ERATH,143,0044,1430044,3554,2918,2371,547,24,64,358,410,2210,1876,334,11,19,220,235
157,FORT BEND,157,2108,1572108,3677,9605,1318,8287,2644,4532,1188,5624,7559,1117,6442,2183,3442,834,4210
491,WILLIAMSON,491,0397,4910397,9505,2047,1881,166,30,20,79,97,2022,1871,151,25,18,67,85
505,ZAPATA,505,002A,505002A,9628,594,44,550,0,2,550,550,436,27,409,0,2,409,409
423,SMITH,423,0038,4230038,7759,4001,2609,1392,200,704,411,1082,3417,2336,1081,153,534,319,838
439,TARRANT,439,3289,4393289,8300,5269,2744,2525,329,351,1694,2014,3960,2248,1712,223,229,1137,1350
439,TARRANT,439,4046,4394046,8423,4120,3264,856,46,138,500,628,3119,2589,530,34,81,288,363
453,TRAVIS,453,0431,4530431,8964,3634,2229,1405,129,113,1085,1165,3118,2017,1101,95,89,837,900
453,TRAVIS,453,0273,4530273,8841,5008,3386,1622,815,101,570,656,3202,2236,966,501,57,311,363
465,VAL VERDE,465,0012C,4650012C,9087,18,0,18,0,0,18,18,11,0,11,0,0,11,11
161,FREESTONE,161,0001,1610001,3800,4444,3005,1439,56,510,803,1290,3320,2385,935,41,356,460,809
201,HARRIS,201,0787,2010787,5005,1368,90,1278,7,55,1220,1265,982,87,895,7,26,861,886
201,HARRIS,201,0247,2010247,4464,3591,371,3220,370,2501,366,2841,2723,364,2359,359,1702,298,1989
201,HARRIS,201,0665,2010665,4882,4408,2556,1852,90,124,1509,1620,3260,2015,1245,57,81,994,1065
201,HARRIS,201,0002,2010002,4218,4770,2565,2205,472,399,1280,1635,4232,2391,1841,419,329,1045,1345
201,HARRIS,201,0124,2010124,4341,4485,2995,1490,239,402,734,1108,3373,2311,1062,183,283,491,762
61,CAMERON,61,0041,610041,1453,8522,348,8174,37,99,8064,8121,6083,259,5824,34,68,5737,5785
85,COLLIN,85,0156,850156,1785,5225,2970,2255,436,766,941,1671,3904,2359,1545,322,486,630,1103
85,COLLIN,85,0073,850073,1702,3125,1451,1674,539,650,434,1066,2711,1287,1424,453,553,355,897
113,DALLAS,113,4131,1134131,2781,2873,1017,1856,229,852,737,1569,2531,999,1532,225,654,615,1256
113,DALLAS,113,1052,1131052,2034,5335,2968,2367,172,655,1447,2076,4315,2590,1725,128,480,1030,1492
121,DENTON,121,4188,1214188,3113,10,0,10,2,0,7,7,2,0,2,2,0,0,0
303,LUBBOCK,303,0152,3030152,6611,2856,1672,1184,196,237,687,923,2615,1580,1035,178,194,606,800
367,PARKER,367,0255,3670255,7358,3508,2593,915,62,186,520,697,2498,1934,564,47,91,312,399
401,RUSK,401,0317,4010317,7607,921,491,430,17,356,37,388,731,379,352,13,290,30,317
415,SCURRY,415,0014,4150014,7690,1139,550,589,0,192,396,584,1086,518,568,0,190,377,564
491,WILLIAMSON,491,0432,4910432,9528,550,260,290,44,103,147,241,432,220,212,36,69,114,178
501,YOAKUM,501,0305,5010305,9611,987,234,753,13,19,718,731,705,189,516,6,11,490,501
121,DENTON,121,2106,1212106,3030,6686,3067,3619,1286,942,1283,2183,5275,2576,2699,995,696,891,1572
141,EL PASO,141,0049,1410049,3362,3588,710,2878,142,486,2289,2689,2620,601,2019,104,356,1565,1879
201,HARRIS,201,1065,2011065,5283,3899,2282,1617,506,379,669,1023,2716,1658,1058,306,253,455,696
245,JEFFERSON,245,0002,2450002,6030,1659,261,1398,25,749,621,1353,1252,222,1030,17,594,414,994
261,KENEDY,261,0004,2610004,6279,62,24,38,2,3,35,36,52,21,31,1,2,31,31
277,LAMAR,277,004E,277004E,6362,1548,1343,205,6,48,71,116,1199,1050,149,6,34,47,81
27,BELL,27,0215,270215,219,7458,2073,5385,750,3090,1587,4424,5152,1519,3633,500,2099,988,2973
29,BEXAR,29,3160,293160,766,2208,1047,1161,114,89,932,1013,1751,872,879,91,75,689,757
37,BOWIE,37,005A,37005A,1098,409,210,199,0,150,46,188,308,173,135,0,111,19,126
113,DALLAS,113,4063,1134063,2721,5642,815,4827,36,212,4541,4735,4261,742,3519,25,169,3281,3443
113,DALLAS,113,1133,1131133,2094,450,295,155,22,32,99,127,353,247,106,19,20,61,80
113,DALLAS,113,2810,1132810,2426,75,38,37,8,8,23,28,56,30,26,6,4,15,19
453,TRAVIS,453,0382,4530382,8924,5119,3121,1998,520,397,1015,1381,4336,2753,1583,405,300,789,1079
309,MCLENNAN,309,0083,3090083,6717,845,636,209,4,37,144,178,639,504,135,0,27,91,115
339,MONTGOMERY,339,0027,3390027,6920,4572,2519,2053,218,553,1159,1683,3503,2128,1375,152,385,729,1098
347,NACOGDOCHES,347,0045,3470045,7049,1168,924,244,9,71,132,202,906,743,163,6,41,94,134
439,TARRANT,439,4713,4394713,8592,5489,2590,2899,195,973,1659,2574,3892,1999,1893,144,615,1059,1645
439,TARRANT,439,3583,4393583,8377,0,0,0,0,0,0,0,0,0,0,0,0,0,0
439,TARRANT,439,1677,4391677,8045,347,239,108,16,24,67,89,335,231,104,14,22,63,85
113,DALLAS,113,2509,1132509,2389,3720,2583,1137,415,255,410,646,2999,2150,849,325,175,280,448
157,FORT BEND,157,3084,1573084,3717,2214,773,1441,1025,114,282,387,1696,649,1047,753,71,197,266
185,GRIMES,185,0001,1850001,4049,2343,1888,455,5,165,239,397,1830,1502,328,2,135,149,283
201,HARRIS,201,0379,2010379,4596,3190,82,3108,19,1395,1726,3081,2458,78,2380,16,1182,1206,2354
215,HIDALGO,215,0040,2150040,5592,6100,52,6048,9,17,6019,6024,4083,28,4055,4,11,4041,4046
227,HOWARD,227,0304,2270304,5924,1047,638,409,19,26,339,359,748,484,264,12,13,216,228
9,ARCHER,9,0005,90005,79,211,199,12,1,3,4,7,156,147,9,0,2,3,5
29,BEXAR,29,4095,294095,906,2606,873,1733,44,227,1488,1648,2030,768,1262,36,153,1059,1182
29,BEXAR,29,1078,291078,328,924,23,901,5,18,883,893,657,18,639,4,9,627,632
29,BEXAR,29,1158,291158,411,2169,303,1866,120,276,1499,1728,1489,226,1263,76,191,1001,1163
29,BEXAR,29,2161,292161,574,248,133,115,2,4,110,110,195,107,88,2,4,83,83
29,BEXAR,29,3056,293056,660,3724,1004,2720,349,488,1859,2309,2915,862,2053,265,370,1386,1735
201,HARRIS,201,0439,2010439,4656,7594,3956,3638,2253,345,889,1212,5789,3089,2700,1643,291,660,936
233,HUTCHINSON,233,0042,2330042,5984,5085,2433,2652,57,323,2103,2381,3779,1954,1825,39,215,1413,1621
409,SAN PATRICIO,409,0109,4090109,7653,5277,2303,2974,115,158,2632,2740,3818,1810,2008,73,87,1762,1834
439,TARRANT,439,1444,4391444,7985,211,35,176,14,85,84,162,137,24,113,0,58,58,113
453,TRAVIS,453,0453,4530453,8981,3730,1630,2100,231,272,1576,1807,2922,1339,1583,187,204,1165,1353
481,WHARTON,481,0303,4810303,9313,2942,1920,1022,13,133,831,956,2265,1579,686,10,101,533,630
59,CALLAHAN,59,0003,590003,1407,3301,2775,526,26,33,361,391,2523,2138,385,26,17,252,267
85,COLLIN,85,0027,850027,1656,4480,2452,2028,394,748,774,1502,3071,1767,1304,267,439,511,946
85,COLLIN,85,0110,850110,1739,3595,2032,1563,701,413,397,795,3098,1818,1280,599,321,302,613
99,CORYELL,99,0416,990416,1988,7934,3623,4311,427,2004,1733,3491,5655,2795,2860,317,1291,1097,2275
157,FORT BEND,157,2056,1572056,3660,1831,140,1691,18,353,1332,1663,1394,122,1272,16,275,985,1250
201,HARRIS,201,0770,2010770,4988,1997,211,1786,31,550,1232,1748,1259,173,1086,23,273,797,1058
29,BEXAR,29,3116,293116,720,2984,1302,1682,307,317,1083,1351,2064,946,1118,204,200,703,884
29,BEXAR,29,4204,294204,1015,41,0,41,0,2,38,40,28,0,28,0,2,26,28
29,BEXAR,29,1015,291015,265,2640,81,2559,12,24,2515,2530,1977,59,1918,8,16,1888,1897
33,BORDEN,33,003A,33003A,1052,100,80,20,0,2,20,20,75,64,11,0,1,11,11
41,BRAZOS,41,0070,410070,1261,1947,1065,882,77,277,514,770,1492,892,600,67,188,328,503
51,BURLESON,51,0309,510309,1347,923,739,184,2,50,101,150,756,615,141,1,44,68,111
309,MCLENNAN,309,0039,3090039,6671,2915,342,2573,21,645,1931,2534,2033,283,1750,18,448,1277,1716
339,MONTGOMERY,339,0067,3390067,6966,4069,2689,1380,338,191,739,902,3298,2292,1006,237,132,525,648
339,MONTGOMERY,339,0103,3390103,7003,6986,3629,3357,452,1002,1787,2727,4817,2660,2157,298,613,1139,1723
363,PALO PINTO,363,0009,3630009,7298,394,370,24,4,1,15,16,360,343,17,2,1,12,13
439,TARRANT,439,3254,4393254,8294,4203,2183,2020,216,733,899,1606,3257,1863,1394,167,468,619,1075
441,TAYLOR,441,0402,4410402,8626,5985,4082,1903,154,669,971,1607,5139,3662,1477,121,502,749,1229
73,CHEROKEE,73,0047,730047,1593,383,278,105,5,25,71,95,278,214,64,4,24,33,56
113,DALLAS,113,4013,1134013,2675,416,323,93,27,6,50,55,334,259,75,25,4,36,40
113,DALLAS,113,2203,1132203,2343,1978,1652,326,128,23,116,132,1535,1311,224,84,15,80,93
201,HARRIS,201,1125,2011125,5343,0,0,0,0,0,0,0,0,0,0,0,0,0,0
215,HIDALGO,215,0123,2150123,5675,1677,151,1526,3,18,1502,1511,1215,142,1073,3,7,1062,1063
231,HUNT,231,0432,2310432,5970,2525,1957,568,23,176,289,461,1900,1514,386,16,134,185,317
29,BEXAR,29,1115,291115,365,2083,140,1943,10,22,1923,1932,1590,114,1476,5,15,1460,1467
29,BEXAR,29,3010,293010,614,1734,424,1310,212,213,891,1091,1414,380,1034,163,159,713,863
29,BEXAR,29,3016,293016,620,0,0,0,0,0,0,0,0,0,0,0,0,0,0
41,BRAZOS,41,0010,410010,1201,6483,3871,2612,783,635,1064,1647,4572,2859,1713,546,367,657,1016
95,CONCHO,95,0101,950101,1948,476,385,91,10,8,74,80,377,330,47,1,6,38,43
113,DALLAS,113,2100,1132100,2286,5217,3034,2183,467,608,1038,1608,5009,2982,2027,443,551,951,1480
453,TRAVIS,453,0190,4530190,8778,5243,1499,3744,466,1547,1768,3218,4338,1377,2961,366,1199,1389,2528
457,TYLER,457,0002,4570002,9027,1792,1007,785,29,593,140,733,1412,868,544,26,409,91,500
213,HENDERSON,213,001T,213001T,5529,2774,2246,528,31,178,240,405,2280,1926,354,21,107,147,252
215,HIDALGO,215,0226,2150226,5778,4111,58,4053,15,8,4037,4043,2909,48,2861,5,1,2852,2853
331,MILAM,331,0316,3310316,6863,1020,741,279,19,113,119,221,806,609,197,14,86,77,158
353,NOLAN,353,0006,3530006,7112,1729,964,765,11,37,680,710,1221,745,476,7,16,422,436
439,TARRANT,439,4091,4394091,8440,4605,2604,2001,66,92,1699,1767,3540,2188,1352,51,55,1120,1162
439,TARRANT,439,2525,4392525,8191,6097,1257,4840,596,2206,2059,4206,4265,938,3327,445,1506,1378,2860
113,DALLAS,113,3098,1133098,2535,428,4,424,1,246,181,422,312,3,309,1,197,112,308
113,DALLAS,113,3092,1133092,2529,3571,122,3449,14,2497,948,3417,2555,96,2459,10,1851,596,2434
157,FORT BEND,157,1006,1571006,3614,18190,9515,8675,2949,1778,3720,5402,11773,6369,5404,1798,1106,2302,3363
167,GALVESTON,167,0211,1670211,3863,5420,2119,3301,99,1987,1215,3145,4547,2007,2540,83,1571,880,2411
199,HARDIN,199,0004,1990004,4201,1168,1081,87,9,7,34,40,885,822,63,8,6,19,25
201,HARRIS,201,0233,2010233,4450,5416,3036,2380,840,541,972,1479,4974,2880,2094,746,455,844,1274
29,BEXAR,29,2101,292101,514,140,55,85,10,2,76,78,102,49,53,6,2,48,50
43,BREWSTER,43,0001,430001,1301,2501,1487,1014,64,43,848,874,1979,1265,714,46,32,569,593
43,BREWSTER,43,0007,430007,1307,268,178,90,0,1,82,83,230,175,55,0,1,51,52
85,COLLIN,85,0213,850213,1842,7079,2758,4321,2385,932,850,1743,4330,1736,2594,1425,565,506,1057
85,COLLIN,85,0219,850219,1848,5456,2781,2675,1547,457,582,1022,4188,2255,1933,1093,338,419,750
113,DALLAS,113,3808,1133808,2635,7620,1538,6082,69,3138,2873,5892,5515,1377,4138,45,2214,1835,3988
491,WILLIAMSON,491,0310,4910310,9465,3276,1849,1427,32,73,1198,1251,2425,1492,933,21,43,772,807
251,JOHNSON,251,0017,2510017,6176,8084,4641,3443,65,458,2676,3105,6148,3801,2347,44,319,1782,2092
293,LIMESTONE,293,0201,2930201,6465,1102,488,614,12,301,300,591,821,424,397,8,214,167,381
387,RED RIVER,387,0027,3870027,7504,739,653,86,12,31,31,57,601,541,60,10,22,17,37
427,STARR,427,0002,4270002,7799,5669,189,5480,35,19,5419,5425,4169,142,4027,24,12,3978,3983
439,TARRANT,439,3443,4393443,8340,3211,2070,1141,223,269,540,777,2500,1713,787,154,165,384,532
469,VICTORIA,469,0007,4690007,9127,4169,702,3467,35,599,2888,3400,3039,578,2461,28,406,2026,2412
121,DENTON,121,1049,1211049,2973,6529,3677,2852,367,1312,1056,2292,4412,2623,1789,234,792,642,1409
125,DICKENS,125,0003,1250003,3176,444,274,170,5,23,143,159,347,236,111,2,15,90,102
141,EL PASO,141,0201,1410201,3514,5161,396,4765,79,263,4470,4656,3425,288,3137,34,173,2924,3063
201,HARRIS,201,0084,2010084,4301,2726,1397,1329,45,95,1133,1221,1958,1118,840,28,56,708,758
201,HARRIS,201,0919,2010919,5137,4905,2795,2110,1482,90,468,551,3362,2011,1351,945,54,302,353
201,HARRIS,201,0625,2010625,4842,7601,1989,5612,587,3300,1809,4921,5759,1756,4003,464,2247,1295,3448
7,ARANSAS,7,001A,7001A,73,3036,1783,1253,37,59,1049,1104,2431,1519,912,20,41,755,795
29,BEXAR,29,4101,294101,912,1962,666,1296,13,210,1044,1233,1535,564,971,5,157,778,926
39,BRAZORIA,39,0042,390042,1155,1148,543,605,19,162,438,571,863,462,401,9,103,283,376
103,CRANE,103,0002,1030002,1994,1156,341,815,8,13,791,800,832,286,546,4,6,526,532
113,DALLAS,113,2033,1132033,2240,3319,2151,1168,283,349,496,824,3085,2052,1033,259,296,430,715
113,DALLAS,113,4534,1134534,2827,191,25,166,0,4,161,165,123,25,98,0,4,93,97
373,POLK,373,0008,3730008,7404,1978,1310,668,7,289,288,569,1545,1041,504,3,228,196,423
439,TARRANT,439,2731,4392731,8237,3593,992,2601,440,1365,800,2122,2437,688,1749,304,894,535,1415
439,TARRANT,439,4234,4394234,8486,4583,2984,1599,412,358,740,1062,3363,2275,1088,291,236,486,699
453,TRAVIS,453,0132,4530132,8732,14486,1951,12535,809,1749,10062,11603,10597,1729,8868,568,1301,7044,8201
483,WHEELER,483,0301,4830301,9319,1159,827,332,13,56,222,273,880,665,215,7,36,137,172
495,WINKLER,495,0401,4950401,9565,1916,329,1587,53,66,1455,1513,1422,283,1139,39,46,1039,1080
121,DENTON,121,3152,1213152,3076,2746,2183,563,112,74,302,371,2124,1739,385,78,45,202,243
141,EL PASO,141,0009,1410009,3322,4518,1253,3265,94,102,3086,3142,3541,1031,2510,71,67,2365,2409
167,GALVESTON,167,0431,1670431,3909,4161,889,3272,57,2118,1109,3164,3292,762,2530,42,1691,793,2457
189,HALE,189,0304,1890304,4155,1503,589,914,20,91,786,870,1077,495,582,18,67,478,543
201,HARRIS,201,0187,2010187,4404,921,23,898,2,18,883,892,693,23,670,1,15,661,670
201,HARRIS,201,1019,2011019,5237,1819,73,1746,14,390,1354,1715,1219,58,1161,9,254,907,1143
77,CLAY,77,0001,770001,1599,1496,1290,206,14,26,82,106,1157,1014,143,12,19,45,63
113,DALLAS,113,4019,1134019,2681,4932,1312,3620,1134,1129,1335,2427,4302,1258,3044,1028,959,1022,1965
113,DALLAS,113,1324,1131324,2140,4745,1832,2913,396,906,1598,2447,3727,1591,2136,310,667,1117,1755
121,DENTON,121,1003,1211003,2927,3022,2235,787,78,112,498,606,2289,1775,514,46,65,331,394
135,ECTOR,135,0205,1350205,3222,3541,1602,1939,79,205,1576,1753,2547,1308,1239,33,123,1009,1116
141,EL PASO,141,0155,1410155,3468,1927,62,1865,8,21,1843,1856,1480,43,1437,4,16,1422,1434
441,TAYLOR,441,0408,4410408,8632,4955,3964,991,110,114,592,684,3673,3032,641,76,63,363,422
453,TRAVIS,453,0334,4530334,8878,4199,2607,1592,276,181,1095,1237,3251,2126,1125,189,130,757,864
471,WALKER,471,0403B,4710403B,9173,16,12,4,0,4,1,4,5,4,1,0,1,1,1
491,WILLIAMSON,491,0201,4910201,9419,6057,3323,2734,1085,385,1169,1517,4168,2398,1770,711,244,742,967
157,FORT BEND,157,4040,1574040,3763,6201,438,5763,66,1139,4668,5687,4457,349,4108,52,823,3290,4051
181,GRAYSON,181,0304,1810304,4009,6113,4106,2007,386,672,726,1369,4731,3280,1451,310,457,490,934
201,HARRIS,201,0333,2010333,4550,5636,3837,1799,283,266,1081,1319,4429,3136,1293,204,193,748,924
201,HARRIS,201,0873,2010873,5091,1488,127,1361,307,399,667,1042,1148,110,1038,264,298,478,766
395,ROBERTSON,395,0019,3950019,7550,840,737,103,2,13,72,84,692,617,75,2,10,48,57
439,TARRANT,439,2168,4392168,8091,2558,857,1701,135,595,956,1509,1948,716,1232,97,443,660,1078
5,ANGELINA,5,0010A,50010A,36,2272,857,1415,74,647,671,1304,1619,697,922,53,422,421,840
29,BEXAR,29,4221,294221,1032,0,0,0,0,0,0,0,0,0,0,0,0,0,0
29,BEXAR,29,2121,292121,534,913,183,730,32,51,640,683,710,152,558,18,30,498,523
29,BEXAR,29,1118,291118,368,5853,1672,4181,307,970,2961,3767,3815,1175,2640,222,591,1816,2347
67,CASS,67,0006,670006,1530,747,611,136,4,52,47,98,597,494,103,3,39,38,77
141,EL PASO,141,0138,1410138,3451,3712,123,3589,24,91,3509,3557,2924,107,2817,19,60,2761,2799
455,TRINITY,455,0020,4550020,9024,84,57,27,0,21,2,23,75,51,24,0,19,2,21
473,WALLER,473,0315,4730315,9190,480,195,285,3,18,254,270,358,165,193,1,15,167,181
215,HIDALGO,215,0057,2150057,5609,2270,45,2225,7,12,2204,2214,1552,36,1516,6,10,1497,1507
391,REFUGIO,391,002A,391002A,7530,237,164,73,2,4,65,67,201,142,59,1,4,52,54
439,TARRANT,439,1617,4391617,8028,88,28,60,0,3,48,51,68,26,42,0,2,31,33
439,TARRANT,439,2537,4392537,8194,4781,925,3856,165,2023,1642,3606,3532,813,2719,132,1474,1083,2533
439,TARRANT,439,4452,4394452,8526,6659,2298,4361,1832,925,1564,2422,4553,1689,2864,1252,518,1044,1535
451,TOM GREEN,451,0327,4510327,8692,4014,1557,2457,30,249,2138,2360,2998,1271,1727,26,193,1469,1653
157,FORT BEND,157,1014,1571014,3617,12328,5944,6384,2584,1298,2355,3592,8222,4079,4143,1655,820,1552,2342
171,GILLESPIE,171,0010,1710010,3949,1509,1079,430,4,5,387,389,1260,933,327,4,4,293,294
187,GUADALUPE,187,0231,1870231,4115,119,93,26,0,7,15,22,106,82,24,0,7,13,20
201,HARRIS,201,0230,2010230,4447,2011,38,1973,13,961,1007,1961,1445,32,1413,7,759,648,1402
201,HARRIS,201,0396,2010396,4613,2622,29,2593,12,2032,552,2559,2056,24,2032,7,1645,379,2010
201,HARRIS,201,0893,2010893,5111,2999,686,2313,560,954,792,1708,2104,550,1554,405,616,532,1122
29,BEXAR,29,4078,294078,889,2097,1229,868,23,126,690,800,1633,1044,589,20,85,456,533
201,HARRIS,201,0468,2010468,4685,10549,572,9977,1492,1932,6535,8386,7647,487,7160,1202,1412,4529,5895
201,HARRIS,201,1131,2011131,5349,421,283,138,35,45,55,100,325,232,93,26,31,34,65
225,HOUSTON,225,0015,2250015,5890,288,223,65,6,43,7,49,244,187,57,3,41,6,46
27,BELL,27,0204,270204,208,4566,1267,3299,168,1788,1336,2993,3502,1146,2356,140,1240,925,2107
113,DALLAS,113,41A1,11341A1,2793,0,0,0,0,0,0,0,0,0,0,0,0,0,0
121,DENTON,121,3118,1213118,3042,4153,1380,2773,1057,1014,661,1634,3453,1230,2223,814,840,524,1338
139,ELLIS,139,1037,1391037,3291,2367,1838,529,39,135,268,399,1587,1258,329,13,85,160,244
143,ERATH,143,0018,1430018,3540,2683,2141,542,47,15,426,438,2053,1703,350,28,8,270,276
157,FORT BEND,157,4167,1574167,3789,57,6,51,18,12,17,28,38,3,35,9,11,16,26
439,TARRANT,439,1075,4391075,7868,2626,260,2366,28,313,2021,2313,1859,219,1640,16,264,1364,1613
439,TARRANT,439,2267,4392267,8117,5889,1397,4492,458,1716,2316,3968,4227,1160,3067,373,1138,1517,2639
439,TARRANT,439,3558,4393558,8366,4618,3407,1211,662,107,332,432,3313,2576,737,386,68,202,267
441,TAYLOR,441,0206,4410206,8615,4060,3108,952,18,62,753,813,3089,2458,631,12,43,477,518
453,TRAVIS,453,0314,4530314,8864,3724,2010,1714,731,230,730,947,3429,1846,1583,681,218,663,868
183,GREGG,183,0011,1830011,4038,7530,4259,3271,105,1354,1631,2936,5575,3494,2081,66,863,991,1835
201,HARRIS,201,0319,2010319,4536,3925,86,3839,28,1936,1948,3803,2814,80,2734,19,1435,1311,2705
201,HARRIS,201,0070,2010070,4287,5232,3597,1635,536,256,775,1010,4722,3346,1376,427,209,649,850
355,NUECES,355,0006,3550006,7121,5194,2769,2425,330,249,1767,1984,3991,2192,1799,274,178,1246,1413
367,PARKER,367,0345,3670345,7370,3391,2633,758,34,75,520,589,2590,2109,481,23,41,316,354
403,SABINE,403,0005,4030005,7619,1667,1510,157,5,75,50,115,1266,1161,105,2,52,27,75
13,ATASCOSA,13,0008,130008,102,900,323,577,15,8,551,554,681,272,409,9,5,391,392
29,BEXAR,29,3125,293125,729,5807,2501,3306,933,491,1914,2322,4022,1827,2195,622,328,1237,1512
41,BRAZOS,41,0036,410036,1227,7255,3702,3553,253,1390,1784,3105,5889,3285,2604,213,964,1295,2246
85,COLLIN,85,0096,850096,1725,2336,819,1517,108,564,821,1364,1657,657,1000,70,383,520,894
85,COLLIN,85,0145,850145,1774,2372,1154,1218,537,390,264,642,1726,892,834,375,261,176,429
113,DALLAS,113,2084,1132084,2272,915,333,582,76,279,219,492,856,327,529,75,254,194,442
491,WILLIAMSON,491,0117,4910117,9385,9376,3977,5399,2429,1110,1743,2782,7809,3551,4258,1892,868,1402,2221
245,JEFFERSON,245,0074,2450074,6102,4081,3093,988,137,171,618,782,3201,2520,681,100,107,418,524
303,LUBBOCK,303,0126,3030126,6600,2165,1241,924,49,175,675,833,1704,1051,653,38,130,452,576
423,SMITH,423,0004,4230004,7725,4344,1115,3229,18,612,2550,3144,3041,924,2117,12,456,1586,2042
423,SMITH,423,0041,4230041,7762,6170,4911,1259,97,500,483,967,4356,3506,850,62,353,288,636
439,TARRANT,439,2659,4392659,8223,38,10,28,3,1,22,22,26,10,16,3,0,14,14
439,TARRANT,439,3054,4393054,8260,5502,3746,1756,460,336,826,1133,3955,2824,1131,300,216,513,721
141,EL PASO,141,0084,1410084,3397,3375,104,3271,11,28,3254,3260,2633,85,2548,8,18,2537,2543
141,EL PASO,141,0121,1410121,3434,2615,211,2404,73,67,2286,2333,2153,189,1964,62,41,1864,1901
167,GALVESTON,167,0387,1670387,3895,5106,3104,2002,422,290,1170,1437,3511,2252,1259,271,184,691,868
167,GALVESTON,167,4391,1674391,3932,30,15,15,4,9,7,14,22,13,9,3,7,1,8
201,HARRIS,201,0839,2010839,5057,3876,764,3112,587,929,1617,2479,3102,625,2477,449,758,1286,1990
215,HIDALGO,215,0003,2150003,5555,1860,47,1813,6,12,1800,1805,1256,36,1220,1,3,1214,1216
29,BEXAR,29,1087,291087,337,3780,322,3458,66,365,3100,3380,2624,262,2362,46,246,2090,2291
29,BEXAR,29,2173,292173,586,3010,733,2277,122,347,1812,2100,2363,656,1707,97,233,1351,1558
49,BROWN,49,0318,490318,1333,2731,2093,638,34,61,438,484,2179,1749,430,25,32,283,309
61,CAMERON,61,0007,610007,1419,3794,291,3503,15,29,3454,3471,2724,239,2485,11,21,2450,2465
73,CHEROKEE,73,0033,730033,1582,2972,2316,656,30,267,216,476,2297,1853,444,20,181,117,297
85,COLLIN,85,0039,850039,1668,4919,2255,2664,507,831,1243,2025,3827,1945,1882,399,541,854,1375
227,HOWARD,227,0035,2270035,5910,769,373,396,16,64,302,360,599,303,296,16,34,231,262
239,JACKSON,239,0002,2390002,5996,3718,2017,1701,20,166,1456,1602,2789,1599,1190,14,127,994,1113
315,MARION,315,0010,3150010,6743,772,597,175,8,94,50,144,649,516,133,4,77,31,108
339,MONTGOMERY,339,0092,3390092,6992,8298,4386,3912,659,1335,1834,3092,5541,3054,2487,437,844,1130,1941
453,TRAVIS,453,0470,4530470,8993,4144,1556,2588,271,408,1867,2226,3461,1411,2050,230,340,1443,1753
479,WEBB,479,0220,4790220,9242,2872,91,2781,15,7,2756,2759,1973,69,1904,3,6,1891,1894
113,DALLAS,113,4002,1134002,2664,1528,772,756,76,98,579,660,1204,673,531,51,66,399,457
113,DALLAS,113,2614,1132614,2415,462,39,423,389,13,25,35,306,25,281,265,5,12,17
201,HARRIS,201,0696,2010696,4914,5345,1719,3626,131,265,3149,3357,4064,1493,2571,89,188,2205,2357
201,HARRIS,201,0448,2010448,4665,4590,3085,1505,284,182,947,1106,3556,2482,1074,178,107,709,803
215,HIDALGO,215,0109,2150109,5661,8856,653,8203,319,298,7633,7859,6779,551,6228,260,224,5751,5935
215,HIDALGO,215,0195,2150195,5747,2126,732,1394,6,8,1381,1383,1618,722,896,6,2,885,887
29,BEXAR,29,4130,294130,941,1321,438,883,51,254,593,807,998,360,638,41,179,406,570
29,BEXAR,29,4167,294167,978,166,44,122,4,3,113,113,138,44,94,4,2,85,85
29,BEXAR,29,1149,291149,400,4220,821,3399,336,556,2541,3022,3087,667,2420,237,393,1789,2153
113,DALLAS,113,1040,1131040,2023,6766,1404,5362,202,3303,1862,5078,5140,1282,3858,168,2366,1292,3618
113,DALLAS,113,1087,1131087,2060,7216,440,6776,159,3044,3592,6583,5249,373,4876,145,2332,2402,4710
113,DALLAS,113,3501,1133501,2601,14,2,12,8,0,4,4,9,2,7,5,0,2,2
507,ZAVALA,507,004A,507004A,9634,956,54,902,1,13,890,897,681,46,635,1,5,628,630
281,LAMPASAS,281,0005,2810005,6388,709,618,91,7,15,51,66,611,549,62,5,12,28,40
339,MONTGOMERY,339,0034,3390034,6929,3531,2519,1012,147,172,627,780,2780,2076,704,102,116,434,538
439,TARRANT,439,1550,4391550,8011,73,3,70,1,22,47,69,45,3,42,0,16,25,41
439,TARRANT,439,1423,4391423,7974,2904,2267,637,313,89,177,258,2386,1892,494,246,64,136,199
459,UPSHUR,459,0014,4590014,9056,1091,769,322,17,96,145,239,848,609,239,17,77,96,171
499,WOOD,499,01-4,49901-4,9597,1015,842,173,5,16,95,108,790,664,126,3,12,78,88
157,FORT BEND,157,2017,1572017,3646,4005,107,3898,29,2552,1365,3860,3024,92,2932,22,2029,893,2899
157,FORT BEND,157,2120,1572120,3683,4118,2663,1455,441,308,635,929,2996,2007,989,303,220,421,634
201,HARRIS,201,1051,2011051,5269,0,0,0,0,0,0,0,0,0,0,0,0,0,0
201,HARRIS,201,1088,2011088,5306,1382,401,981,47,156,770,913,1009,326,683,35,113,530,632
201,HARRIS,201,0511,2010511,4728,5493,2141,3352,1588,760,960,1684,3592,1452,2140,980,516,602,1105
277,LAMAR,277,002D,277002D,6351,929,705,224,10,112,64,176,722,554,168,8,89,43,132
5,ANGELINA,5,0018,50018,45,1244,670,574,43,286,234,510,1007,575,432,25,225,171,391
29,BEXAR,29,1044,291044,294,3117,150,2967,15,54,2910,2938,2420,116,2304,12,35,2263,2282
29,BEXAR,29,2130,292130,543,3147,823,2324,185,278,1856,2091,2432,714,1718,131,202,1364,1545
29,BEXAR,29,3186,293186,792,0,0,0,0,0,0,0,0,0,0,0,0,0,0
113,DALLAS,113,3021,1133021,2458,1803,40,1763,5,1272,498,1748,1390,35,1355,5,1041,313,1343
113,DALLAS,113,4049,1134049,2707,0,0,0,0,0,0,0,0,0,0,0,0,0,0
475,WARD,475,003N,475003N,9199,2411,1099,1312,22,99,1174,1242,1734,852,882,7,66,784,837
491,WILLIAMSON,491,0266,4910266,9448,5952,3167,2785,998,559,1181,1660,4306,2460,1846,709,346,739,1054
303,LUBBOCK,303,0023,3030023,6537,2121,1291,830,35,185,608,749,1659,1094,565,20,126,405,508
323,MAVERICK,323,004C,323004C,6786,925,16,909,9,8,896,897,689,10,679,8,1,670,670
347,NACOGDOCHES,347,0014,3470014,7035,4677,3342,1335,49,449,740,1174,3407,2546,861,29,319,434,747
361,ORANGE,361,0029,3610029,7284,1790,1628,162,9,12,77,83,1367,1247,120,8,8,51,54
451,TOM GREEN,451,0423,4510423,8701,2023,1553,470,64,56,309,359,1585,1243,342,46,36,225,256
453,TRAVIS,453,0414,4530414,8950,5518,3608,1910,444,271,1084,1324,5163,3443,1720,407,241,944,1165
113,DALLAS,113,1751,1131751,2209,8718,4252,4466,1359,1656,1312,2911,7232,3734,3498,1098,1260,1014,2239
121,DENTON,121,1032,1211032,2956,7237,4644,2593,944,553,971,1488,4911,3302,1609,577,342,597,920
201,HARRIS,201,0654,2010654,4871,4535,932,3603,410,536,2660,3152,3514,822,2692,350,397,1918,2299
201,HARRIS,201,0156,2010156,4373,55,39,16,6,1,2,3,39,27,12,6,1,2,3
201,HARRIS,201,0902,2010902,5120,4752,2968,1784,447,296,985,1253,4114,2614,1500,383,255,812,1048
201,HARRIS,201,0405,2010405,4622,6245,3855,2390,566,593,1160,1728,4176,2663,1513,379,364,711,1064
19,BANDERA,19,0410,190410,145,546,475,71,2,2,61,62,471,416,55,1,1,45,46
29,BEXAR,29,3082,293082,686,3779,1574,2205,171,336,1664,1930,2939,1309,1630,134,209,1225,1406
29,BEXAR,29,3039,293039,643,7009,3473,3536,462,456,2544,2943,4916,2498,2418,323,306,1708,1986
39,BRAZORIA,39,0071,390071,1184,1845,492,1353,365,625,369,980,1430,407,1023,260,508,258,759
113,DALLAS,113,2123,1132123,2309,5191,786,4405,954,2268,1193,3417,3766,638,3128,721,1639,766,2384
113,DALLAS,113,4610,1134610,2850,4979,1414,3565,186,354,2986,3301,3803,1268,2535,152,259,2065,2311
453,TRAVIS,453,0232,4530232,8807,3882,3277,605,204,38,295,329,3141,2693,448,149,28,218,243
453,TRAVIS,453,0224,4530224,8801,2836,2028,808,213,78,438,514,2267,1688,579,146,58,314,370
485,WICHITA,485,0302,4850302,9342,6460,3076,3384,107,617,2560,3116,4896,2620,2276,85,381,1687,2050
485,WICHITA,485,0308,4850308,9348,5920,5080,840,86,88,405,480,4403,3875,528,47,48,235,276
201,HARRIS,201,0262,2010262,4479,13486,2953,10533,732,751,9068,9682,9877,2566,7311,620,563,6133,6599
201,HARRIS,201,0796,2010796,5014,6400,1462,4938,480,1391,3080,4378,4563,1133,3430,337,930,2126,3027
309,MCLENNAN,309,0005,3090005,6637,2434,160,2274,14,158,2118,2249,1678,130,1548,13,117,1425,1526
309,MCLENNAN,309,0011,3090011,6643,2718,1982,736,86,224,376,572,2122,1611,511,63,153,245,390
355,NUECES,355,0063,3550063,7178,3147,1721,1426,76,88,1231,1305,2539,1476,1063,61,67,910,968
355,NUECES,355,0069,3550069,7184,3168,574,2594,24,147,2416,2536,2409,481,1928,19,94,1793,1879
113,DALLAS,113,4616,1134616,2856,4969,538,4431,151,252,4003,4228,3373,449,2924,122,179,2607,2775
113,DALLAS,113,4512,1134512,2807,3763,863,2900,41,488,2371,2821,2640,743,1897,28,306,1558,1842
113,DALLAS,113,2129,1132129,2315,2590,326,2264,60,414,1771,2175,1841,302,1539,57,298,1161,1458
141,EL PASO,141,0035,1410035,3348,3088,809,2279,110,158,1972,2120,2629,736,1893,87,149,1629,1769
201,HARRIS,201,0256,2010256,4473,7817,1150,6667,433,655,5564,6179,5864,1030,4834,339,447,4016,4440
201,HARRIS,201,0802,2010802,5020,0,0,0,0,0,0,0,0,0,0,0,0,0,0
1,ANDERSON,1,0002,10002,2,3811,3159,652,16,256,294,530,2880,2453,427,11,172,173,335
29,BEXAR,29,4024,294024,835,5070,847,4223,67,363,3844,4125,3888,771,3117,49,257,2795,3027
37,BOWIE,37,0027,370027,1084,1045,962,83,1,10,29,39,841,775,66,1,4,22,26
91,COMAL,91,0301A,910301A,1917,11002,3551,7451,161,502,6691,7102,7936,2788,5148,109,333,4599,4887
113,DALLAS,113,1708,1131708,2166,1566,544,1022,34,338,627,947,1218,477,741,27,246,438,678
121,DENTON,121,2075,1212075,2999,2309,601,1708,37,44,1584,1622,1597,493,1104,23,26,1018,1042
297,LIVE OAK,297,0005,2970005,6494,424,308,116,6,2,90,92,346,264,82,5,1,62,63
365,PANOLA,365,0013,3650013,7327,390,274,116,5,55,38,91,309,221,88,5,51,23,72
397,ROCKWALL,397,003E,397003E,7576,3469,2725,744,135,207,290,488,2590,2095,495,81,132,202,331
439,TARRANT,439,3735,4393735,8409,1730,1093,637,337,107,134,233,1282,854,428,240,73,75,146
449,TITUS,449,0007,4490007,8658,1901,1188,713,20,169,484,644,1428,945,483,13,119,311,428
491,WILLIAMSON,491,0370,4910370,9491,4348,2678,1670,91,366,1136,1464,3321,2187,1134,61,205,773,967
135,ECTOR,135,0408,1350408,3248,1762,259,1503,11,90,1408,1476,1314,218,1096,10,72,1017,1072
187,GUADALUPE,187,0126,1870126,4081,40,25,15,0,2,15,15,26,19,7,0,0,7,7
201,HARRIS,201,0945,2010945,5163,352,30,322,3,14,303,312,212,22,190,2,5,182,187
201,HARRIS,201,0113,2010113,4330,4809,1288,3521,452,1418,1644,3005,3639,1151,2488,358,965,1141,2085
205,HARTLEY,205,0201,2050201,5412,412,304,108,3,8,91,95,300,232,68,3,7,52,56
257,KAUFMAN,257,0024,2570024,6245,2124,1279,845,15,208,568,769,1669,1092,577,11,159,361,516
29,BEXAR,29,4124,294124,935,5121,627,4494,48,473,4007,4397,4056,564,3492,39,378,3078,3415
29,BEXAR,29,1143,291143,394,6234,1950,4284,483,866,2971,3748,4456,1544,2912,322,591,1983,2532
61,CAMERON,61,0064,610064,1476,800,86,714,1,2,706,708,573,62,511,1,1,505,506
111,DALLAM,111,0008,1110008,2017,1706,802,904,3,29,853,879,1180,609,571,0,20,537,555
113,DALLAS,113,3116,1133116,2558,14,0,14,0,10,3,13,11,0,11,0,7,3,10
121,DENTON,121,4174,1214174,3099,3292,1311,1981,240,970,767,1695,3045,1240,1805,218,886,698,1545
439,TARRANT,439,4343,4394343,8509,3223,2539,684,142,155,303,456,2684,2121,563,115,136,242,377
439,TARRANT,439,1578,4391578,8017,3333,624,2709,62,1518,1130,2600,2231,476,1755,41,986,718,1677
439,TARRANT,439,4573,4394573,8558,19,3,16,0,11,3,14,16,3,13,0,8,3,11
465,VAL VERDE,465,0040,4650040,9099,8455,623,7832,59,117,7666,7748,6157,507,5650,39,69,5546,5605
283,LA SALLE,283,0002,2830002,6394,1408,529,879,2,57,830,876,1240,524,716,1,54,667,713
337,MONTAGUE,337,0009,3370009,6886,1568,1393,175,4,4,87,90,1329,1211,118,4,3,41,44
339,MONTGOMERY,339,0040,3390040,6935,6621,4388,2233,328,707,1074,1742,5042,3530,1512,225,462,717,1158
375,POTTER,375,0223,3750223,7427,4749,838,3911,49,244,3577,3772,3510,717,2793,32,132,2568,2692
381,RANDALL,381,0307,3810307,7476,1491,1235,256,17,16,175,187,1133,971,162,9,8,104,112
439,TARRANT,439,1412,4391412,7968,0,0,0,0,0,0,0,0,0,0,0,0,0,0
157,FORT BEND,157,1160,1571160,3640,4391,1854,2537,872,648,999,1617,3078,1384,1694,600,421,657,1061
193,HAMILTON,193,0014,1930014,4181,240,215,25,0,1,21,21,200,178,22,0,0,18,18
201,HARRIS,201,1045,2011045,5263,1543,246,1297,753,194,341,508,1080,192,888,528,125,218,335
201,HARRIS,201,0505,2010505,4722,9204,2578,6626,244,1585,4705,6207,7193,2308,4885,198,1172,3403,4543
215,HIDALGO,215,0252,2150252,5804,9,6,3,0,0,3,3,9,6,3,0,0,3,3
275,KNOX,275,0401,2750401,6345,857,466,391,10,51,321,368,620,360,260,4,43,200,243
5,ANGELINA,5,0021,50021,48,1512,1043,469,12,222,215,428,1107,798,309,0,149,137,286
29,BEXAR,29,1129,291129,380,3503,960,2543,296,632,1675,2232,2491,755,1736,207,415,1105,1491
97,COOKE,97,0021,970021,1969,1770,1628,142,16,12,63,75,1315,1231,84,5,3,35,38
113,DALLAS,113,2115,1132115,2301,301,249,52,7,15,27,41,292,246,46,7,13,22,35
113,DALLAS,113,3806,1133806,2633,1707,51,1656,8,1475,197,1649,1210,45,1165,7,1045,123,1159
121,DENTON,121,1041,1211041,2965,8118,3339,4779,2137,1461,1062,2449,5024,2178,2846,1264,874,613,1448
335,MITCHELL,335,0004,3350004,6878,1656,880,776,19,112,624,720,1239,699,540,15,66,436,494
355,NUECES,355,0094,3550094,7210,3103,849,2254,19,128,2081,2196,2415,735,1680,16,92,1539,1627
395,ROBERTSON,395,0003,3950003,7542,675,570,105,1,19,82,100,548,473,75,1,13,59,71
439,TARRANT,439,4494,4394494,8538,238,115,123,3,69,49,115,219,115,104,3,65,33,98
439,TARRANT,439,1082,4391082,7874,1633,349,1284,66,90,1116,1194,1200,290,910,51,46,789,834
439,TARRANT,439,2601,4392601,8206,0,0,0,0,0,0,0,0,0,0,0,0,0,0
139,ELLIS,139,1043,1391043,3297,4933,3256,1677,87,573,882,1432,3589,2446,1143,63,412,577,981
157,FORT BEND,157,1133,1571133,3629,5730,3354,2376,1148,269,842,1074,4105,2481,1624,775,185,563,732
175,GOLIAD,175,0031,1750031,3961,904,591,313,7,48,253,291,703,494,209,7,37,160,192
201,HARRIS,201,0076,2010076,4293,3644,790,2854,230,330,2308,2591,2723,716,2007,187,239,1581,1796
255,KARNES,255,0008,2550008,6214,224,149,75,0,2,69,70,171,126,45,0,2,40,41
303,LUBBOCK,303,0032,3030032,6546,1838,1125,713,29,70,601,664,1241,819,422,21,38,353,389
7,ARANSAS,7,0003,70003,71,5817,4162,1655,213,147,1146,1265,4961,3729,1232,157,101,814,908
29,BEXAR,29,1152,291152,403,1847,447,1400,143,165,1115,1241,1410,368,1042,103,119,827,925
29,BEXAR,29,3131,293131,735,13,3,10,1,5,4,7,6,3,3,1,2,0,2
37,BOWIE,37,0010,370010,1067,2419,1898,521,81,272,93,358,1911,1528,383,53,204,63,264
41,BRAZOS,41,0091A,410091A,1282,12,9,3,0,1,2,3,12,9,3,0,1,2,3
77,CLAY,77,0032,770032,1614,276,248,28,2,7,17,24,225,203,22,2,6,13,19
453,TRAVIS,453,0349,4530349,8893,4865,3243,1622,411,164,962,1101,3730,2614,1116,305,118,625,732
479,WEBB,479,0125,4790125,9225,1657,14,1643,11,9,1623,1624,1190,10,1180,5,7,1173,1173
491,WILLIAMSON,491,0256,4910256,9440,2410,1462,948,129,132,623,729,1790,1159,631,88,92,403,473
339,MONTGOMERY,339,0008,3390008,6901,4793,3521,1272,57,115,953,1050,3634,2796,838,44,87,594,673
355,NUECES,355,0117,3550117,7233,4699,3043,1656,165,118,1260,1347,3617,2463,1154,145,91,821,894
397,ROCKWALL,397,002B,397002B,7565,2791,1640,1151,185,430,477,896,2194,1372,822,148,295,326,617
439,TARRANT,439,1132,4391132,7897,3789,122,3667,12,1364,2293,3646,2687,104,2583,11,1061,1514,2564
439,TARRANT,439,2681,4392681,8229,0,0,0,0,0,0,0,0,0,0,0,0,0,0
439,TARRANT,439,4591,4394591,8561,5231,2508,2723,492,775,1404,2096,3600,1793,1807,335,516,896,1375
93,COMANCHE,93,0015,930015,1946,555,468,87,4,1,62,63,449,392,57,4,1,38,39
113,DALLAS,113,2092,1132092,2278,0,0,0,0,0,0,0,0,0,0,0,0,0,0
113,DALLAS,113,3606,1133606,2610,3723,248,3475,53,3016,425,3400,2919,227,2692,41,2360,291,2634
121,DENTON,121,1018,1211018,2942,1264,554,710,349,162,191,342,785,359,426,203,95,115,208
139,ELLIS,139,1020,1391020,3274,3245,1816,1429,26,179,1168,1329,2386,1483,903,11,120,723,836
153,FLOYD,153,0003,1530003,3606,1349,333,1016,6,61,940,984,941,240,701,5,43,638,677
11,ARMSTRONG,11,0402,110402,94,221,196,25,4,3,10,13,177,161,16,1,1,6,7
29,BEXAR,29,4116,294116,927,77,29,48,8,16,23,36,56,25,31,8,10,13,20
29,BEXAR,29,2014,292014,426,2078,154,1924,12,33,1887,1907,1632,133,1499,7,17,1473,1485
29,BEXAR,29,3152,293152,758,945,466,479,49,32,379,408,743,388,355,35,22,278,299
29,BEXAR,29,2181A,292181A,595,1162,302,860,85,172,614,771,759,221,538,53,113,370,477
37,BOWIE,37,002D,37002D,1090,166,65,101,0,93,6,99,120,54,66,0,60,5,65
219,HOCKLEY,219,0044,2190044,5836,1157,555,602,2,40,539,572,860,450,410,2,29,355,382
251,JOHNSON,251,0010,2510010,6168,5111,2871,2240,159,251,1699,1923,3761,2169,1592,152,179,1136,1305
297,LIVE OAK,297,0011,2970011,6500,1389,231,1158,1,172,979,1150,1352,215,1137,0,172,958,1129
329,MIDLAND,329,0303,3290303,6832,864,134,730,13,52,658,699,608,112,496,9,31,444,470
113,DALLAS,113,3311,1133311,2587,4786,1645,3141,92,853,2139,2938,3396,1356,2040,70,572,1310,1866
119,DELTA,119,0004,1190004,2919,954,748,206,18,94,67,155,771,613,158,12,65,55,118
201,HARRIS,201,0954,2010954,5172,2522,76,2446,25,1204,1229,2395,1680,61,1619,16,817,794,1587
201,HARRIS,201,0291,2010291,4508,2481,792,1689,135,282,1272,1502,1776,662,1114,112,180,806,960
201,HARRIS,201,0623,2010623,4840,7955,2935,5020,784,2025,2181,4097,6193,2546,3647,595,1407,1586,2935
209,HAYS,209,0441,2090441,5504,2949,2313,636,83,42,403,441,2287,1865,422,48,20,280,298
41,BRAZOS,41,0068,410068,1259,0,0,0,0,0,0,0,0,0,0,0,0,0,0
61,CAMERON,61,0010,610010,1422,5030,97,4933,4,15,4918,4919,3613,56,3557,4,9,3546,3547
73,CHEROKEE,73,0045,730045,1591,1677,668,1009,3,109,883,990,1245,552,693,2,102,576,676
85,COLLIN,85,0125,850125,1754,8087,3362,4725,3005,984,622,1588,6113,2725,3388,2133,761,406,1154
91,COMAL,91,0306,910306,1923,5177,2841,2336,180,277,1806,2031,4152,2458,1694,130,197,1301,1472
113,DALLAS,113,2050,1132050,2255,3162,1507,1655,105,443,1066,1492,2381,1245,1136,76,324,710,1019
15,AUSTIN,15,0102,150102,117,1865,1172,693,9,210,438,643,1455,965,490,8,158,295,451
27,BELL,27,0404,270404,240,9053,2639,6414,469,3470,2592,5708,6176,1873,4303,336,2258,1683,3754
29,BEXAR,29,4093,294093,904,4506,1423,3083,122,539,2387,2865,3420,1223,2197,92,370,1672,2015
29,BEXAR,29,3175,293175,781,821,323,498,13,35,446,473,723,295,428,10,29,379,405
29,BEXAR,29,2159,292159,572,308,77,231,29,22,181,198,232,62,170,26,15,131,141
29,BEXAR,29,2037,292037,449,1945,735,1210,113,111,1002,1086,1571,643,928,94,85,752,821
303,LUBBOCK,303,0007,3030007,6523,4531,2754,1777,130,312,1276,1533,3554,2386,1168,104,190,819,985
329,MIDLAND,329,307A,329307A,6855,2418,804,1614,38,220,1343,1533,1787,675,1112,28,153,910,1051
355,NUECES,355,0072,3550072,7187,2799,442,2357,34,97,2239,2315,2120,356,1764,21,63,1674,1725
389,REEVES,389,0005,3890005,7519,552,122,430,7,3,413,416,436,102,334,6,1,320,321
439,TARRANT,439,1014,4391014,7851,1842,360,1482,34,147,1295,1430,1279,322,957,16,85,843,921
113,DALLAS,113,1153,1131153,2109,158,5,153,0,13,137,150,117,5,112,0,13,96,109
113,DALLAS,113,3004,1133004,2441,2722,688,2034,33,727,1272,1980,2156,609,1547,16,623,893,1506
113,DALLAS,113,2024,1132024,2232,2353,1746,607,162,157,258,410,1991,1496,495,130,131,206,334
213,HENDERSON,213,001A,213001A,5527,3287,2476,811,20,66,596,656,2572,2016,556,11,46,393,438
223,HOPKINS,223,0004,2230004,5859,2292,1554,738,28,106,569,670,1698,1239,459,16,73,341,413
251,JOHNSON,251,0032,2510032,6191,5996,3938,2058,62,180,1562,1728,4479,3125,1354,42,115,995,1108
37,BOWIE,37,022A,37022A,1113,160,142,18,2,8,1,9,130,119,11,0,7,1,8
41,BRAZOS,41,0045,410045,1236,180,96,84,2,16,65,75,141,93,48,2,3,38,40
61,CAMERON,61,0033,610033,1445,1897,133,1764,16,33,1723,1744,1292,102,1190,13,25,1159,1175
71,CHAMBERS,71,0017,710017,1568,1445,999,446,41,85,304,387,842,603,239,20,56,154,209
85,COLLIN,85,0148,850148,1777,421,365,56,12,26,17,40,414,361,53,12,24,14,37
91,COMAL,91,0105,910105,1900,5793,4250,1543,71,73,1177,1230,4749,3614,1135,53,45,834,866
29,BEXAR,29,2136,292136,549,6589,2236,4353,385,499,3563,3928,4486,1565,2921,255,313,2344,2612
41,BRAZOS,41,0022,410022,1213,1140,246,894,9,202,679,863,812,233,579,9,110,450,556
61,CAMERON,61,0056,610056,1468,4237,676,3561,150,98,3332,3387,2909,552,2357,121,55,2174,2209
113,DALLAS,113,4501,1134501,2796,3841,1117,2724,399,900,1419,2271,2884,956,1928,296,665,939,1591
113,DALLAS,113,1310,1131310,2132,7540,1816,5724,80,1917,3740,5555,5367,1594,3773,57,1258,2419,3644
121,DENTON,121,4208,1214208,3134,2293,1398,895,331,129,380,507,1552,996,556,196,94,230,323
279,LAMB,279,0005,2790005,6377,810,265,545,2,9,531,539,594,220,374,2,2,368,370
347,NACOGDOCHES,347,0027,3470027,7041,2670,212,2458,24,1891,546,2413,1786,143,1643,15,1312,325,1624
419,SHELBY,419,009N,419009N,7711,1703,1136,567,15,306,187,488,1261,855,406,11,230,115,343
439,TARRANT,439,3580,4393580,8375,0,0,0,0,0,0,0,0,0,0,0,0,0,0
457,TYLER,457,0015,4570015,9039,1357,1249,108,8,17,39,56,1009,933,76,5,11,28,39
505,ZAPATA,505,001A,505001A,9626,149,7,142,0,2,141,141,107,5,102,0,2,101,101
141,EL PASO,141,0147,1410147,3460,2798,107,2691,13,34,2662,2672,2130,85,2045,4,14,2029,2033
159,FRANKLIN,159,0401,1590401,3798,1590,1349,241,9,14,156,165,1303,1132,171,8,7,103,109
201,HARRIS,201,0831,2010831,5049,165,19,146,3,11,133,141,118,16,102,3,8,93,98
201,HARRIS,201,0908,2010908,5126,0,0,0,0,0,0,0,0,0,0,0,0,0,0
201,HARRIS,201,0245,2010245,4462,6382,2725,3657,448,896,2248,3089,4464,2068,2396,324,556,1426,1962
215,HIDALGO,215,0161,2150161,5713,3776,180,3596,204,58,3352,3386,2851,154,2697,173,33,2492,2518
29,BEXAR,29,2113,292113,526,253,24,229,38,51,147,188,170,24,146,22,23,99,122
113,DALLAS,113,4525,1134525,2819,3722,484,3238,126,791,2287,3048,2628,409,2219,107,549,1529,2058
113,DALLAS,113,1410,1131410,2155,5157,693,4464,56,1414,2980,4372,3485,588,2897,37,929,1916,2830
141,EL PASO,141,0170,1410170,3483,7023,380,6643,22,60,6577,6604,4942,304,4638,13,38,4593,4608
161,FREESTONE,161,0015,1610015,3821,460,369,91,3,41,34,73,350,291,59,1,27,19,45
189,HALE,189,0202,1890202,4147,954,85,869,2,108,751,855,692,75,617,1,83,522,604
277,LAMAR,277,004B,277004B,6360,2530,2117,413,8,106,104,205,2022,1748,274,3,70,66,136
277,LAMAR,277,002G,277002G,6354,959,712,247,5,94,104,197,738,570,168,4,72,64,135
343,MORRIS,343,0302,3430302,7024,1698,1069,629,19,422,121,537,1279,846,433,12,308,59,367
415,SCURRY,415,0012,4150012,7688,3251,1588,1663,21,156,1446,1583,2410,1312,1098,16,109,928,1031
439,TARRANT,439,3510,4393510,8352,3472,2736,736,280,111,252,357,2810,2261,549,213,75,180,250
201,HARRIS,201,0145,2010145,4362,2479,29,2450,5,1900,555,2436,1698,25,1673,5,1326,347,1661
201,HARRIS,201,0808,2010808,5026,17,5,12,0,3,6,9,11,5,6,0,0,3,3
201,HARRIS,201,0931,2010931,5149,164,105,59,30,4,18,21,133,82,51,28,4,16,19
201,HARRIS,201,0268,2010268,4485,3238,2046,1192,766,80,308,385,2318,1516,802,524,55,197,252
215,HIDALGO,215,0138,2150138,5690,1095,24,1071,3,5,1066,1069,805,12,793,1,2,792,792
217,HILL,217,0002,2170002,5813,3063,2525,538,14,33,373,402,2353,2003,350,7,15,228,242
29,BEXAR,29,1007,291007,257,2078,89,1989,12,14,1953,1961,1616,76,1540,8,10,1512,1520
29,BEXAR,29,4110,294110,921,1963,743,1220,52,136,1025,1138,1588,652,936,39,106,787,877
85,COLLIN,85,0131,850131,1760,4191,2812,1379,333,426,519,922,3126,2175,951,235,296,351,635
113,DALLAS,113,2808,1132808,2424,5458,2218,3240,2452,183,535,709,3730,1662,2068,1544,122,347,464
113,DALLAS,113,4602,1134602,2842,4107,965,3142,302,230,2595,2792,3093,867,2226,249,163,1786,1937
121,DENTON,121,4163,1214163,3088,5697,2379,3318,517,906,1795,2652,4005,1792,2213,375,607,1139,1720
497,WISE,497,0015,4970015,9580,1971,1653,318,13,27,219,242,1569,1353,216,8,21,136,156
201,HARRIS,201,0785,2010785,5003,6810,1722,5088,754,1775,2591,4235,4510,1270,3240,540,1058,1641,2635
215,HIDALGO,215,0115,2150115,5667,5505,163,5342,11,16,5316,5320,3957,127,3830,8,11,3806,3810
399,RUNNELS,399,0007,3990007,7588,1485,930,555,3,50,475,515,1168,785,383,1,33,327,354
439,TARRANT,439,3036,4393036,8252,4784,1956,2828,517,607,1379,1961,3452,1526,1926,388,349,965,1300
453,TRAVIS,453,0374,4530374,8916,3288,2737,551,83,33,349,379,2624,2242,382,43,21,246,267
465,VAL VERDE,465,0012A,4650012A,9085,318,14,304,5,4,294,295,225,10,215,3,3,207,207
141,EL PASO,141,0193,1410193,3506,3634,797,2837,229,173,2479,2605,2652,639,2013,173,109,1732,1830
157,FORT BEND,157,3175,1573175,3752,2386,379,2007,293,687,1059,1705,1813,323,1490,249,489,752,1224
157,FORT BEND,157,2094,1572094,3675,21,5,16,0,6,10,16,18,5,13,0,6,7,13
191,HALL,191,0202,1910202,4170,609,382,227,7,32,186,212,511,338,173,3,26,140,161
201,HARRIS,201,0122,2010122,4339,2846,93,2753,28,1313,1428,2720,2168,73,2095,17,1078,1003,2070
201,HARRIS,201,0617,2010617,4834,8799,1331,7468,582,2566,4426,6804,6309,1078,5231,471,1694,3080,4688
113,DALLAS,113,3010,1133010,2447,1155,29,1126,6,678,443,1117,734,24,710,3,436,270,705
121,DENTON,121,4186,1214186,3111,2735,2495,240,37,32,116,148,2673,2459,214,34,30,95,125
121,DENTON,121,1064,1211064,2988,3566,2728,838,92,175,439,598,2805,2235,570,69,108,302,402
141,EL PASO,141,0214,1410214,3529,14,2,12,1,5,7,12,9,0,9,0,4,5,9
157,FORT BEND,157,2031,1572031,3652,4779,85,4694,50,2565,2120,4619,3538,80,3458,38,2009,1442,3413
157,FORT BEND,157,4095,1574095,3775,8445,2791,5654,1652,2081,1880,3893,5818,1993,3825,1162,1327,1296,2580
439,TARRANT,439,3696,4393696,8398,7181,4132,3049,565,703,1629,2287,4808,2918,1890,366,410,994,1384
453,TRAVIS,453,0396,4530396,8939,4036,2678,1358,93,82,1019,1086,3168,2237,931,50,51,681,726
459,UPSHUR,459,0020,4590020,9062,166,116,50,8,28,11,38,126,105,21,6,14,2,15
499,WOOD,499,03-3,49903-3,9603,5138,3990,1148,47,621,237,850,4192,3253,939,37,530,175,699
195,HANSFORD,195,0009,1950009,4193,195,99,96,1,1,88,89,141,85,56,0,1,48,49
201,HARRIS,201,0099,2010099,4316,5666,1127,4539,53,916,3514,4382,4146,985,3161,31,649,2407,3033
201,HARRIS,201,0762,2010762,4980,3031,415,2616,706,456,1459,1882,2259,356,1903,549,330,1013,1333
201,HARRIS,201,0222,2010222,4439,3744,2846,898,435,99,324,407,3132,2424,708,348,69,251,313
201,HARRIS,201,0640,2010640,4857,8243,2829,5414,726,1666,2950,4535,6026,2329,3697,543,1057,2001,3031
211,HEMPHILL,211,0401,2110401,5521,718,350,368,8,5,333,337,510,265,245,6,1,220,221
29,BEXAR,29,4156,294156,967,2037,390,1647,153,705,824,1467,1510,309,1201,109,514,579,1078
29,BEXAR,29,3114,293114,718,2808,1824,984,122,69,752,805,2182,1511,671,57,40,520,554
33,BORDEN,33,002A,33002A,1050,95,79,16,0,1,15,16,74,63,11,0,0,11,11
41,BRAZOS,41,0108,410108,1299,0,0,0,0,0,0,0,0,0,0,0,0,0,0
113,DALLAS,113,2109,1132109,2295,0,0,0,0,0,0,0,0,0,0,0,0,0,0
113,DALLAS,113,1065,1131065,2046,7996,731,7265,211,3005,4047,6991,5342,593,4749,161,1962,2608,4546
453,TRAVIS,453,0332,4530332,8876,3470,1970,1500,146,191,1092,1255,2870,1718,1152,91,142,843,969
469,VICTORIA,469,0005,4690005,9125,5041,1178,3863,68,486,3281,3731,3880,1013,2867,51,389,2372,2751
491,WILLIAMSON,491,0301,4910301,9457,10329,4027,6302,4569,456,1131,1551,6709,2865,3844,2713,299,714,998
213,HENDERSON,213,03WS,21303WS,5544,2309,1893,416,16,67,201,266,1861,1566,295,12,49,135,182
215,HIDALGO,215,0075,2150075,5627,194,7,187,0,2,185,185,135,5,130,0,2,128,128
223,HOPKINS,223,004A,223004A,5876,2934,1868,1066,33,218,738,947,2178,1503,675,26,133,448,579
305,LYNN,305,0012,3050012,6623,604,402,202,6,16,176,186,432,298,134,4,8,114,120
439,TARRANT,439,4503,4394503,8544,2626,478,2148,54,70,1996,2060,1895,407,1488,43,58,1364,1419
439,TARRANT,439,2306,4392306,8129,2531,1779,752,99,231,370,587,2061,1521,540,65,175,247,417
113,DALLAS,113,2412,1132412,2378,12,3,9,2,6,3,9,9,3,6,0,4,2,6
177,GONZALES,177,0002,1770002,3967,3061,1136,1925,30,501,1432,1863,2317,1013,1304,25,340,937,1257
199,HARDIN,199,0019,1990019,4216,2492,2098,394,34,48,215,261,1843,1592,251,19,17,142,159
201,HARRIS,201,1077,2011077,5295,6519,733,5786,331,2813,2617,5331,4656,626,4030,265,1989,1725,3667
201,HARRIS,201,0331,2010331,4548,6530,2148,4382,776,1154,2475,3516,4450,1572,2878,518,730,1600,2278
201,HARRIS,201,0082,2010082,4299,5259,2905,2354,634,498,1121,1585,4013,2315,1698,485,336,778,1099
29,BEXAR,29,1030,291030,280,485,58,427,17,70,346,404,290,34,256,10,43,206,245
29,BEXAR,29,3008,293008,612,100,55,45,17,3,23,26,80,40,40,15,3,21,24
59,CALLAHAN,59,0001,590001,1405,1556,1275,281,16,26,168,188,1222,1037,185,10,10,112,120
77,CLAY,77,0015,770015,1608,570,496,74,4,9,42,49,454,395,59,4,5,36,40
85,COLLIN,85,0108,850108,1737,4860,1942,2918,1883,473,490,941,3788,1657,2131,1378,357,332,684
113,DALLAS,113,4076,1134076,2733,9031,641,8390,71,1178,7140,8258,6509,566,5943,63,964,4896,5829
479,WEBB,479,0134,4790134,9231,4450,78,4372,3,11,4360,4365,2937,54,2883,3,5,2876,2881
495,WINKLER,495,0202,4950202,9563,943,568,375,6,8,349,356,670,422,248,5,7,226,233
201,HARRIS,201,0685,2010685,4903,545,275,270,23,38,204,238,435,242,193,15,29,145,170
257,KAUFMAN,257,0010,2570010,6231,3923,2958,965,34,158,601,744,2946,2311,635,25,126,358,472
303,LUBBOCK,303,0051,3030051,6563,350,152,198,3,11,178,187,252,128,124,3,8,110,116
375,POTTER,375,0427,3750427,7442,2578,413,2165,102,258,1811,2041,1853,351,1502,81,195,1218,1399
439,TARRANT,439,4086,4394086,8438,2872,2505,367,39,61,209,266,2400,2121,279,25,35,163,198
453,TRAVIS,453,0178,4530178,8770,2592,1245,1347,207,393,706,1078,2102,1057,1045,164,322,516,825
121,DENTON,121,3141,1213141,3065,4862,3891,971,358,123,321,441,3698,3054,644,219,81,221,302
139,ELLIS,139,1026,1391026,3280,4694,2815,1879,65,433,1265,1652,3668,2290,1378,41,336,901,1207
157,FORT BEND,157,1004,1571004,3612,5592,2761,2831,1149,418,1177,1561,4126,2164,1962,795,289,800,1072
201,HARRIS,201,1017,2011017,5235,819,72,747,16,176,573,727,541,57,484,15,112,364,466
201,HARRIS,201,0722,2010722,4940,10266,197,10069,65,4191,5894,9970,7139,159,6980,47,2981,3970,6904
201,HARRIS,201,0391,2010391,4608,2445,1420,1025,333,254,420,642,2132,1317,815,278,192,307,483
29,BEXAR,29,3068,293068,672,5998,1179,4819,360,766,3743,4390,4610,1061,3549,272,551,2724,3218
113,DALLAS,113,2201,1132201,2341,2334,2019,315,105,39,113,146,1734,1538,196,64,19,78,94
113,DALLAS,113,4011,1134011,2673,1574,282,1292,31,40,1218,1244,1237,249,988,19,35,922,946
157,FORT BEND,157,2085,1572085,3669,5332,2142,3190,328,1004,1780,2736,3955,1705,2250,244,692,1244,1916
181,GRAYSON,181,0206,1810206,4001,3572,2278,1294,207,439,490,906,2855,1946,909,157,298,319,604
215,HIDALGO,215,0038,2150038,5590,5406,592,4814,81,61,4683,4712,4044,508,3536,64,25,3442,3460
359,OLDHAM,359,0103,3590103,7250,180,152,28,3,2,21,23,139,119,20,3,2,13,15
423,SMITH,423,0030,4230030,7751,6679,5140,1539,209,482,700,1149,4779,3847,932,137,277,397,664
439,TARRANT,439,1481,4391481,7997,1818,152,1666,9,50,1604,1647,1251,137,1114,3,34,1074,1105
439,TARRANT,439,2112,4392112,8083,2495,1897,598,69,153,283,428,2014,1604,410,55,104,176,274
463,UVALDE,463,0011,4630011,9079,779,319,460,5,11,422,431,581,251,330,1,9,297,305
215,HIDALGO,215,0121,2150121,5673,185,16,169,3,0,163,163,124,9,115,1,0,111,111
227,HOWARD,227,0208,2270208,5922,8,2,6,1,0,6,6,2,0,2,0,0,2,2
309,MCLENNAN,309,0037,3090037,6669,2171,688,1483,26,495,956,1412,1555,579,976,16,311,628,922
321,MATAGORDA,321,0004,3210004,6755,2052,1254,798,5,40,713,743,1594,1024,570,3,29,497,521
339,MONTGOMERY,339,0101,3390101,7001,5157,2487,2670,626,514,1436,1911,3651,1863,1788,407,372,929,1280
339,MONTGOMERY,339,0025,3390025,6918,3398,2134,1264,85,121,955,1060,2602,1742,860,62,80,634,705
5,ANGELINA,5,0005,50005,31,3543,1417,2126,52,1030,1000,2013,2631,1214,1417,42,697,638,1327
29,BEXAR,29,3054,293054,658,228,71,157,13,22,124,142,206,71,135,11,20,105,123
29,BEXAR,29,1113,291113,363,5119,1398,3721,384,817,2574,3286,4117,1234,2883,295,629,1982,2546
53,BURNET,53,0010,530010,1359,2158,1705,453,11,25,315,334,1739,1429,310,8,14,208,218
85,COLLIN,85,0025,850025,1654,5114,2349,2765,1737,545,393,921,3530,1666,1864,1157,385,268,642
85,COLLIN,85,0062,850062,1691,3438,1982,1456,230,334,768,1083,2786,1724,1062,173,235,540,767
439,TARRANT,439,1279,4391279,7937,3740,846,2894,131,1783,995,2720,2778,754,2024,94,1279,645,1890
439,TARRANT,439,3665,4393665,8392,21,11,10,1,2,8,10,12,10,2,1,0,2,2
453,TRAVIS,453,0390,4530390,8933,6080,3922,2158,843,347,848,1161,4314,2915,1399,560,227,539,745
267,KIMBLE,267,0009,2670009,6314,721,531,190,6,5,163,166,591,452,139,6,4,119,122
303,LUBBOCK,303,0142,3030142,6609,254,145,109,4,10,92,99,210,125,85,2,7,71,75
349,NAVARRO,349,0204,3490204,7064,390,231,159,4,66,77,140,308,194,114,3,51,49,99
363,PALO PINTO,363,0023,3630023,7310,2836,1937,899,104,120,610,719,2143,1542,601,71,69,385,453
371,PECOS,371,0010,3710010,7396,2287,368,1919,21,197,1692,1880,1825,341,1484,16,188,1274,1458
171,GILLESPIE,171,0012,1710012,3950,3294,2400,894,9,19,790,805,2651,2052,599,4,10,526,534
25,BEE,25,0005,250005,180,1126,577,549,6,4,506,507,875,493,382,2,1,354,354
37,BOWIE,37,006B,37006B,1102,2741,2021,720,130,356,127,475,2119,1620,499,99,233,87,318
85,COLLIN,85,0137,850137,1766,3068,1524,1544,1047,220,233,448,2338,1262,1076,715,170,163,329
93,COMANCHE,93,0002,930002,1935,2942,1629,1313,17,36,1184,1211,2220,1356,864,11,18,778,793
113,DALLAS,113,4109,1134109,2762,131,1,130,0,33,97,130,95,1,94,0,31,63,94
113,DALLAS,113,3328,1133328,2599,74,25,49,2,5,39,44,55,24,31,2,2,26,28
299,LLANO,299,0410,2990410,6512,5188,4335,853,62,38,554,580,4278,3647,631,41,21,380,395
329,MIDLAND,329,0402,3290402,6841,1595,1140,455,24,67,323,376,1184,884,300,21,33,209,235
355,NUECES,355,0061,3550061,7176,1744,61,1683,3,239,1452,1672,1272,44,1228,3,181,1042,1219
387,RED RIVER,387,0029,3870029,7505,446,336,110,5,52,43,93,398,310,88,5,43,30,73
439,TARRANT,439,2453,4392453,8172,4626,1189,3437,558,2096,754,2830,3349,938,2411,382,1468,520,1978
491,WILLIAMSON,491,0208,4910208,9426,2713,1806,907,71,111,626,723,1930,1355,575,49,74,374,439
141,EL PASO,141,0113,1410113,3426,4255,345,3910,64,160,3717,3838,3297,297,3000,48,122,2841,2940
149,FAYETTE,149,0425,1490425,3595,3982,2497,1485,26,491,969,1409,3136,2126,1010,23,335,634,947
201,HARRIS,201,0963,2010963,5181,2365,313,2052,83,324,1648,1940,1561,249,1312,58,212,1033,1228
201,HARRIS,201,0043,2010043,4259,5249,779,4470,303,197,3947,4104,3868,713,3155,255,141,2725,2853
221,HOOD,221,0211,2210211,5845,3205,2387,818,35,60,594,647,2434,1894,540,23,37,392,428
251,JOHNSON,251,0021,2510021,6180,2538,2008,530,8,56,382,429,2009,1656,353,3,30,246,269
29,BEXAR,29,2122,292122,535,4078,874,3204,812,560,1883,2349,3202,777,2425,613,395,1412,1771
73,CHEROKEE,73,0028,730028,1580,2210,1230,980,16,562,367,921,1944,1026,918,12,531,345,869
113,DALLAS,113,2039,1132039,2244,3794,2907,887,203,109,498,592,3076,2410,666,137,79,380,451
113,DALLAS,113,1174,1131174,2121,3571,2361,1210,106,328,687,1000,2859,1986,873,73,249,484,723
113,DALLAS,113,4145,1134145,2785,0,0,0,0,0,0,0,0,0,0,0,0,0,0
113,DALLAS,113,32A1,11332A1,2576,0,0,0,0,0,0,0,0,0,0,0,0,0,0
295,LIPSCOMB,295,0303,2950303,6486,512,376,136,3,2,100,101,399,303,96,2,1,68,68
391,REFUGIO,391,002B,391002B,7531,341,203,138,3,5,121,122,277,174,103,0,3,92,93
439,TARRANT,439,2541,4392541,8195,3886,841,3045,729,1425,912,2286,2817,652,2165,541,985,637,1602
439,TARRANT,439,4454,4394454,8527,4941,2657,2284,160,472,1587,2011,3593,2085,1508,105,301,1047,1319
473,WALLER,473,0416,4730416,9191,569,291,278,5,35,230,262,451,250,201,5,27,159,185
121,DENTON,121,4192,1214192,3117,2168,1494,674,17,53,512,557,1624,1181,443,13,43,311,351
135,ECTOR,135,0314,1350314,3240,2626,1070,1556,51,297,1198,1448,1949,878,1071,33,198,811,989
157,FORT BEND,157,4117,1574117,3781,2803,878,1925,552,777,586,1328,1931,650,1281,377,512,381,877
201,HARRIS,201,0609,2010609,4826,6832,2167,4665,1465,616,2568,3138,5195,1884,3311,1108,463,1699,2143
209,HAYS,209,0400,2090400,5490,0,0,0,0,0,0,0,0,0,0,0,0,0,0
217,HILL,217,0011,2170011,5822,1227,854,373,8,59,276,327,950,695,255,8,32,182,214
5,ANGELINA,5,0030,50030,57,1499,1392,107,3,18,42,59,1167,1094,73,1,10,26,36
29,BEXAR,29,3117,293117,721,3836,2169,1667,150,138,1354,1460,3188,1906,1282,114,99,1032,1114
29,BEXAR,29,2142,292142,555,1611,311,1300,45,126,1108,1214,1218,258,960,32,87,819,898
29,BEXAR,29,3123,293123,727,1827,648,1179,57,81,1021,1092,1249,486,763,35,48,652,696
113,DALLAS,113,3039,1133039,2476,3218,49,3169,22,1845,1326,3144,2474,47,2427,15,1607,817,2411
113,DALLAS,113,4061,1134061,2719,5707,250,5457,26,115,5315,5398,4175,222,3953,17,85,3846,3911
453,TRAVIS,453,0107,4530107,8713,4321,2438,1883,646,370,840,1171,3627,2131,1496,506,292,660,924
453,TRAVIS,453,0115,4530115,8719,1799,226,1573,34,291,1250,1513,1405,219,1186,26,237,911,1133
453,TRAVIS,453,0343A,4530343A,8885,3671,2398,1273,626,115,484,580,2556,1744,812,385,72,322,384
491,WILLIAMSON,491,0116A,4910116A,9383,1869,1299,570,208,87,260,334,1415,1013,402,159,54,169,218
201,HARRIS,201,0589,2010589,4806,6011,1552,4459,263,1131,3091,4116,4593,1333,3260,202,809,2257,2992
201,HARRIS,201,1086,2011086,5304,7843,4045,3798,233,385,3009,3355,5766,3200,2566,159,248,2032,2261
303,LUBBOCK,303,0041,3030041,6555,3531,2128,1403,21,52,1282,1316,2539,1582,957,7,21,890,908
309,MCLENNAN,309,0087,3090087,6721,4483,1316,3167,25,727,2380,3060,3173,1112,2061,18,457,1534,1970
325,MEDINA,325,003E,325003E,6798,181,127,54,0,4,46,46,155,114,41,0,0,35,35
355,NUECES,355,0103,3550103,7219,4640,1528,3112,43,140,2888,2979,3272,1215,2057,27,89,1884,1950
113,DALLAS,113,2010,1132010,2221,1738,1330,408,127,36,202,235,1297,1028,269,81,27,139,166
113,DALLAS,113,4653,1134653,2885,919,65,854,8,79,763,842,638,49,589,7,66,511,577
113,DALLAS,113,3950,1133950,2642,7389,1512,5877,52,2917,2936,5804,5581,1422,4159,33,2149,1962,4107
121,DENTON,121,4214,1214214,3140,3247,2191,1056,381,215,410,610,2459,1710,749,271,145,282,422
201,HARRIS,201,0423,2010423,4640,7941,263,7678,82,489,7199,7558,5245,209,5036,68,347,4667,4945
201,HARRIS,201,0417,2010417,4634,1989,529,1460,103,271,1091,1336,1504,459,1045,91,206,743,934
27,BELL,27,0202,270202,206,7647,3298,4349,520,2017,1672,3510,5528,2600,2928,350,1332,1049,2301
29,BEXAR,29,4059,294059,870,3602,1325,2277,175,515,1594,2053,2781,1120,1661,128,380,1124,1480
29,BEXAR,29,3100,293100,704,5543,2097,3446,330,663,2479,3051,3944,1628,2316,208,410,1656,2027
53,BURNET,53,0019,530019,1368,5552,4247,1305,65,104,1005,1086,4416,3569,847,45,60,628,681
181,GRAYSON,181,0107,1810107,3993,2622,2182,440,26,47,208,242,2074,1786,288,21,29,126,147
201,HARRIS,201,0937,2010937,5155,4221,2384,1837,691,360,768,1103,3769,2204,1565,587,300,635,925
491,WILLIAMSON,491,0428,4910428,9526,4200,2227,1973,45,404,1455,1813,3078,1780,1298,31,253,949,1189
355,NUECES,355,0081,3550081,7196,4996,3873,1123,155,94,775,842,4156,3312,844,112,59,567,623
365,PANOLA,365,0002,3650002,7319,3123,2151,972,38,528,349,866,2341,1709,632,27,357,208,561
367,PARKER,367,0305,3670305,7362,4178,3350,828,53,123,520,637,3058,2548,510,39,73,299,372
439,TARRANT,439,1056,4391056,7860,1771,610,1161,23,863,227,1074,1506,587,919,15,672,178,840
453,TRAVIS,453,0312,4530312,8862,5768,1768,4000,2035,520,1518,1974,5722,1755,3967,2019,516,1501,1957
485,WICHITA,485,0410,4850410,9360,598,448,150,22,33,67,98,537,406,131,22,29,54,82
201,HARRIS,201,0274,2010274,4491,3704,2308,1396,381,302,676,943,2982,1879,1103,276,243,553,774
201,HARRIS,201,0440,2010440,4657,3867,2765,1102,690,36,313,344,2820,2076,744,494,14,193,204
249,JIM WELLS,249,0020,2490020,6157,1135,82,1053,11,14,1023,1028,862,52,810,9,8,789,791
309,MCLENNAN,309,0023,3090023,6655,4177,3380,797,172,155,355,488,3039,2557,482,118,85,201,278
309,MCLENNAN,309,0065,3090065,6698,2040,1553,487,8,101,297,396,1552,1236,316,6,74,176,250
329,MIDLAND,329,0201,3290201,6821,5690,2162,3528,30,94,3281,3362,4060,1774,2286,13,45,2128,2171
1,ANDERSON,1,0016,10016,14,1184,911,273,9,128,101,227,915,718,197,8,97,65,161
29,BEXAR,29,4036,294036,847,4623,465,4158,29,1754,2457,4110,3427,424,3003,21,1354,1664,2970
41,BRAZOS,41,0077,410077,1268,1375,365,1010,2,53,908,952,946,301,645,2,31,569,592
91,COMAL,91,0404,910404,1929,5641,3998,1643,170,129,1212,1327,4147,3038,1109,110,91,806,888
113,DALLAS,113,1141,1131141,2101,1961,1228,733,53,410,244,641,1409,917,492,24,291,151,437
139,ELLIS,139,1006,1391006,3260,4922,2435,2487,147,985,1206,2149,3391,1794,1597,114,629,730,1355
491,WILLIAMSON,491,0395,4910395,9503,283,250,33,15,2,11,13,280,248,32,15,1,11,12
299,LLANO,299,0108,2990108,6506,998,907,91,6,8,32,38,944,861,83,5,8,28,34
309,MCLENNAN,309,0046,3090046,6678,937,160,777,4,209,551,750,616,123,493,1,112,369,477
367,PARKER,367,0110,3670110,7339,2996,2270,726,39,56,478,526,2285,1809,476,27,21,313,330
387,RED RIVER,387,03-4,38703-4,7511,730,587,143,4,82,47,125,632,510,122,3,75,35,107
439,TARRANT,439,4724,4394724,8593,1567,1202,365,37,41,234,269,1146,896,250,24,23,155,177
479,WEBB,479,0273,4790273,9260,3420,121,3299,8,3,3287,3287,2344,79,2265,8,0,2258,2258
141,EL PASO,141,0119,1410119,3432,4183,456,3727,78,224,3447,3626,3288,392,2896,64,161,2674,2817
187,GUADALUPE,187,0209,1870209,4093,2137,245,1892,8,192,1692,1855,1594,197,1397,5,146,1234,1368
201,HARRIS,201,1129,2011129,5347,0,0,0,0,0,0,0,0,0,0,0,0,0,0
201,HARRIS,201,0297,2010297,4514,7293,700,6593,951,1155,4584,5571,5375,596,4779,808,791,3252,3935
207,HASKELL,207,0009,2070009,5424,353,310,43,3,11,29,33,279,257,22,2,4,11,15
241,JASPER,241,0011,2410011,6014,605,530,75,1,37,26,63,462,410,52,0,24,20,44
5,ANGELINA,5,0010B,50010B,37,392,73,319,6,146,157,302,233,49,184,3,95,75,170
29,BEXAR,29,2165,292165,578,3887,1463,2424,304,234,1902,2086,2946,1199,1747,222,156,1349,1489
113,DALLAS,113,4085,1134085,2742,1924,59,1865,6,57,1806,1851,1438,55,1383,5,42,1335,1372
113,DALLAS,113,1105,1131105,2078,154,8,146,2,27,117,139,107,4,103,1,20,81,97
113,DALLAS,113,3615,1133615,2619,4132,285,3847,49,3257,570,3781,3123,257,2866,34,2454,385,2811
139,ELLIS,139,1029,1391029,3283,1015,529,486,9,51,403,447,774,436,338,9,32,277,308
381,RANDALL,381,0429,3810429,7488,5969,4066,1903,130,378,1254,1597,4519,3324,1195,81,208,773,968
439,TARRANT,439,1619,4391619,8029,89,1,88,0,19,72,88,45,1,44,0,15,32,44
439,TARRANT,439,4620,4394620,8570,545,111,434,10,44,370,412,364,85,279,9,32,233,263
439,TARRANT,439,2381,4392381,8152,2012,272,1740,94,1102,591,1640,1489,235,1254,76,777,416,1168
451,TOM GREEN,451,0348,4510348,8693,2465,1379,1086,19,30,957,984,1902,1155,747,12,20,658,677
479,WEBB,479,0154,4790154,9234,10891,253,10638,17,36,10580,10591,6642,135,6507,9,29,6472,6483
201,HARRIS,201,1106,2011106,5324,3665,205,3460,83,1452,1934,3330,2685,182,2503,62,921,1509,2401
201,HARRIS,201,0566,2010566,4783,8161,1274,6887,965,2651,3360,5849,6440,1112,5328,783,2077,2521,4490
209,HAYS,209,0200,2090200,5447,2,0,2,0,0,1,1,1,0,1,0,0,0,0
223,HOPKINS,223,0014,2230014,5865,1790,1271,519,28,40,402,438,1361,1011,350,21,19,264,282
235,IRION,235,0400,2350400,5988,379,310,69,7,4,46,48,309,251,58,6,3,37,38
303,LUBBOCK,303,0013,3030013,6529,1500,731,769,28,201,550,721,1180,647,533,24,122,379,494
85,COLLIN,85,0180,850180,1809,6710,2528,4182,2147,1052,891,1888,4570,1868,2702,1412,651,571,1202
113,DALLAS,113,1085,1131085,2058,3900,217,3683,11,139,3534,3644,2735,185,2550,5,95,2435,2520
113,DALLAS,113,4510,1134510,2805,5157,580,4577,265,315,3986,4274,3695,498,3197,213,203,2767,2954
113,DALLAS,113,3114,1133114,2556,0,0,0,0,0,0,0,0,0,0,0,0,0,0
113,DALLAS,113,2121,1132121,2307,3934,291,3643,85,2774,807,3529,2954,264,2690,70,2069,556,2595
121,DENTON,121,3130,1213130,3054,13057,2989,10068,1386,1692,6900,8473,9203,2554,6649,883,1173,4469,5585
355,NUECES,355,0018,3550018,7133,6027,3133,2894,242,406,2069,2401,4703,2603,2100,179,283,1450,1695
369,PARMER,369,0201,3690201,7382,1888,304,1584,3,25,1554,1572,1315,237,1078,3,19,1055,1071
405,SAN AUGUSTINE,405,0009,4050009,7631,1145,1048,97,6,25,25,49,956,885,71,3,16,19,34
439,TARRANT,439,1090,4391090,7880,4101,228,3873,133,2145,1614,3730,2601,162,2439,75,1379,975,2345
493,WILSON,493,0205,4930205,9552,4231,2575,1656,20,41,1544,1566,3257,2097,1160,12,33,1067,1086
139,ELLIS,139,1049,1391049,3303,910,585,325,7,60,230,283,696,491,205,4,39,136,172
143,ERATH,143,0035,1430035,3552,398,215,183,0,68,106,172,385,208,177,0,64,104,166
247,JIM HOGG,247,0005,2470005,6137,3,0,3,0,0,3,3,2,0,2,0,0,2,2
281,LAMPASAS,281,0003,2810003,6386,3942,2398,1544,54,120,1260,1356,3028,1935,1093,39,73,891,947
309,MCLENNAN,309,0003,3090003,6635,10963,6358,4605,1487,1234,1798,2932,10060,5976,4084,1383,1020,1569,2521
337,MONTAGUE,337,0007,3370007,6884,1309,1130,179,1,5,102,107,1038,909,129,1,3,62,65
27,BELL,27,0408,270408,243,9094,2112,6982,775,3884,2386,5947,6234,1639,4595,530,2471,1521,3844
29,BEXAR,29,3184,293184,790,623,185,438,9,13,420,430,478,163,315,4,8,303,309
41,BRAZOS,41,0096,410096,1288,11,7,4,0,1,3,4,8,7,1,0,0,1,1
113,DALLAS,113,2612,1132612,2413,1705,204,1501,1063,223,195,406,1317,180,1137,796,184,140,320
113,DALLAS,113,3013,1133013,2450,3396,526,2870,8,618,2214,2796,2276,431,1845,5,421,1377,1781
115,DAWSON,115,0013,1150013,2911,234,179,55,0,4,53,54,168,137,31,0,3,29,30
491,WILLIAMSON,491,0263,4910263,9446,5147,2919,2228,483,377,1258,1608,3673,2215,1458,333,232,805,1029
315,MARION,315,0008,3150008,6741,1031,799,232,12,176,23,195,874,706,168,9,125,17,140
323,MAVERICK,323,002C,323002C,6778,6627,82,6545,21,20,5791,5801,4401,63,4338,13,13,3862,3867
355,NUECES,355,0123,3550123,7239,3282,1299,1983,34,88,1839,1895,2403,1028,1375,17,49,1265,1305
361,ORANGE,361,0021,3610021,7276,359,283,76,2,2,52,54,281,226,55,2,1,42,43
439,TARRANT,439,3706,4393706,8401,4967,2792,2175,543,619,921,1504,4395,2603,1792,464,494,739,1206
453,TRAVIS,453,0412,4530412,8948,3239,1710,1529,151,308,1024,1305,2602,1525,1077,112,201,726,910
121,DENTON,121,1024,1211024,2948,6057,3198,2859,1835,372,538,899,3936,2191,1745,1105,245,325,565
187,GUADALUPE,187,0115,1870115,4073,451,316,135,2,4,118,120,332,230,102,2,3,85,87
201,HARRIS,201,0900,2010900,5118,30,6,24,0,1,23,24,21,6,15,0,0,15,15
201,HARRIS,201,0354,2010354,4571,8046,778,7268,270,3346,3714,6944,5929,679,5250,216,2440,2595,4977
215,HIDALGO,215,0064,2150064,5616,9927,100,9827,23,25,9774,9785,6349,64,6285,18,14,6250,6258
257,KAUFMAN,257,0022,2570022,6243,1803,1399,404,27,57,260,308,1366,1098,268,17,42,162,196
29,BEXAR,29,2023,292023,435,3841,326,3515,34,85,3404,3458,2976,309,2667,19,60,2578,2620
29,BEXAR,29,1099,291099,349,4202,869,3333,252,524,2556,3019,3319,740,2579,189,398,1948,2322
29,BEXAR,29,2181D,292181D,598,500,119,381,53,88,246,321,294,87,207,32,34,145,174
29,BEXAR,29,3080,293080,684,1624,794,830,65,65,686,740,1347,687,660,44,51,539,584
61,CAMERON,61,0019,610019,1431,4132,193,3939,23,37,3898,3914,2657,151,2506,14,13,2480,2487
85,COLLIN,85,0051,850051,1680,3696,985,2711,212,418,2053,2443,2840,876,1964,190,302,1447,1733
479,WEBB,479,0252,4790252,9254,5181,103,5078,8,21,5053,5063,3601,80,3521,5,11,3505,3512
485,WICHITA,485,0211,4850211,9340,117,36,81,8,11,61,71,83,26,57,7,3,45,48
215,HIDALGO,215,0207,2150207,5759,3984,442,3542,153,38,3335,3360,2915,351,2564,127,30,2389,2413
241,JASPER,241,0005,2410005,6008,173,137,36,3,17,9,26,151,122,29,3,15,4,19
439,TARRANT,439,1547,4391547,8009,0,0,0,0,0,0,0,0,0,0,0,0,0,0
439,TARRANT,439,3043,4393043,8258,5340,3733,1607,161,405,895,1258,3571,2593,978,96,238,547,772
453,TRAVIS,453,0491B,4530491B,9005,0,0,0,0,0,0,0,0,0,0,0,0,0,0
465,VAL VERDE,465,0021,4650021,9091,3167,52,3115,1,28,3097,3106,2214,45,2169,0,10,2166,2169
157,FORT BEND,157,2116,1572116,3681,2847,71,2776,22,2293,505,2742,2192,60,2132,18,1799,329,2102
167,GALVESTON,167,4191,1674191,3930,0,0,0,0,0,0,0,0,0,0,0,0,0,0
201,HARRIS,201,0460,2010460,4677,9564,750,8814,531,2763,5578,8209,6869,627,6242,401,2053,3789,5781
201,HARRIS,201,0794,2010794,5012,2548,133,2415,39,1084,1316,2351,1699,107,1592,37,728,835,1541
201,HARRIS,201,0546,2010546,4763,3016,2517,499,124,57,247,295,2232,1906,326,81,44,156,191
201,HARRIS,201,0708,2010708,4926,1807,139,1668,9,80,1572,1645,1261,115,1146,7,46,1084,1125
29,BEXAR,29,4228,294228,1039,964,547,417,59,50,299,347,871,522,349,51,39,249,286
37,BOWIE,37,0019,370019,1076,1024,885,139,21,34,19,51,832,723,109,14,25,12,35
79,COCHRAN,79,0303,790303,1617,91,51,40,0,1,38,38,69,40,29,0,0,27,27
113,DALLAS,113,4039,1134039,2699,1710,41,1669,14,397,1278,1655,1201,33,1168,8,330,841,1160
113,DALLAS,113,4000,1134000,2662,1998,195,1803,111,331,1352,1671,1455,179,1276,106,237,927,1155
157,FORT BEND,157,3155,1573155,3744,5464,508,4956,2550,1006,1394,2375,4069,384,3685,1970,734,960,1680
345,MOTLEY,345,0001,3450001,7027,271,223,48,3,4,37,39,202,169,33,1,3,23,25
439,TARRANT,439,2026,4392026,8072,3059,1850,1209,77,250,828,1071,2476,1620,856,51,188,567,751
441,TAYLOR,441,0204,4410204,8613,3430,2127,1303,131,323,764,1071,2651,1747,904,106,199,520,711
447,THROCKMORTON,447,4005,4474005,8650,117,104,13,1,3,8,9,94,88,6,1,1,3,4
201,HARRIS,201,0105,2010105,4322,6232,322,5910,43,169,5704,5841,4454,275,4179,37,128,4022,4128
201,HARRIS,201,1149,2011149,5367,5720,2099,3621,411,1573,1653,3127,3945,1529,2416,285,1080,1016,2063
201,HARRIS,201,0068,2010068,4285,5952,162,5790,36,4970,848,5715,4253,122,4131,25,3586,547,4073
203,HARRISON,203,0021,2030021,5404,988,643,345,9,219,98,314,794,521,273,4,189,62,248
231,HUNT,231,0105,2310105,5945,1843,829,1014,15,205,762,957,1265,648,617,8,122,464,581
339,MONTGOMERY,339,0090,3390090,6990,5513,4431,1082,110,150,663,805,3813,3138,675,63,109,401,507
41,BRAZOS,41,0034,410034,1225,5339,2530,2809,960,710,1132,1798,4432,2194,2238,827,493,873,1346
61,CAMERON,61,0062,610062,1474,5095,245,4850,33,32,4800,4810,3846,199,3647,24,28,3605,3614
85,COLLIN,85,0094,850094,1723,5778,2561,3217,2321,443,388,804,4293,2002,2291,1662,310,270,563
97,COOKE,97,004C,97004C,1972,4504,2687,1817,100,345,1220,1542,3325,2205,1120,75,226,690,908
141,EL PASO,141,0076,1410076,3389,2031,135,1896,24,37,1845,1871,1680,116,1564,21,30,1517,1541
157,FORT BEND,157,1156,1571156,3638,3252,2270,982,293,169,420,572,2404,1754,650,210,106,276,377
421,SHERMAN,421,0201,4210201,7717,504,151,353,1,8,339,345,344,116,228,0,4,218,220
439,TARRANT,439,4138,4394138,8464,2734,773,1961,25,51,1850,1887,1943,661,1282,16,27,1206,1226
439,TARRANT,439,1407,4391407,7966,79,32,47,2,9,29,38,73,32,41,2,9,23,32
439,TARRANT,439,2636,4392636,8215,4997,2557,2440,211,1023,1120,2092,3693,2108,1585,136,633,751,1358
167,GALVESTON,167,0356,1670356,3887,4821,3724,1097,271,131,562,673,3594,2851,743,188,87,368,447
187,GUADALUPE,187,0414,1870414,4136,6243,2797,3446,309,1300,1841,3019,4301,2086,2215,194,807,1167,1927
215,HIDALGO,215,0250,2150250,5802,753,21,732,4,6,723,723,464,14,450,4,4,443,443
215,HIDALGO,215,0001,2150001,5553,2664,61,2603,5,5,2599,2601,1699,43,1656,2,0,1654,1654
245,JEFFERSON,245,0023,2450023,6051,2939,676,2263,36,1882,340,2187,2307,610,1697,28,1440,208,1636
265,KERR,265,0312,2650312,6300,5547,3009,2538,93,198,2140,2286,4393,2588,1805,67,146,1484,1600
49,BROWN,49,0212,490212,1325,985,816,169,0,17,125,140,806,686,120,0,8,89,97
49,BROWN,49,0308,490308,1331,715,617,98,5,5,55,60,572,509,63,2,1,30,31
85,COLLIN,85,0243,850243,1872,1886,1290,596,277,96,187,278,1319,924,395,184,69,115,180
85,COLLIN,85,0237,850237,1866,3812,1513,2299,841,755,618,1348,2565,1054,1511,564,514,378,882
141,EL PASO,141,0176,1410176,3489,1458,340,1118,36,47,1029,1062,1132,286,846,27,33,780,806
141,EL PASO,141,0182,1410182,3495,8096,1345,6751,199,803,5754,6429,5828,1175,4653,160,528,3917,4399
439,TARRANT,439,3552,4393552,8364,6224,2966,3258,810,1109,1245,2285,4294,2170,2124,557,675,794,1435
491,WILLIAMSON,491,0368,4910368,9489,6989,3099,3890,208,531,3132,3575,5159,2549,2610,134,342,2094,2403
251,JOHNSON,251,0041,2510041,6200,6397,4944,1453,110,319,854,1161,4678,3717,961,69,209,537,735
251,JOHNSON,251,0035,2510035,6194,6303,4581,1722,77,159,1271,1423,4955,3744,1211,51,117,864,977
365,PANOLA,365,0010,3650010,7325,410,252,158,3,119,30,143,333,212,121,2,94,15,108
431,STERLING,431,0001A,4310001A,7817,269,200,69,6,2,51,52,217,177,40,2,0,28,28
431,STERLING,431,0002E,4310002E,7823,58,19,39,1,2,38,39,35,10,25,0,1,24,25
439,TARRANT,439,1071,4391071,7866,5742,2138,3604,258,2181,1171,3268,4801,1991,2810,220,1656,918,2518
183,GREGG,183,0003,1830003,4030,3601,2271,1330,76,693,472,1156,2979,2008,971,55,517,327,842
183,GREGG,183,0009,1830009,4036,5863,3774,2089,174,1172,643,1777,4792,3265,1527,138,853,441,1274
201,HARRIS,201,0943,2010943,5161,3015,79,2936,161,715,2097,2743,2081,70,2011,133,484,1407,1851
215,HIDALGO,215,0150,2150150,5702,3817,363,3454,117,35,3306,3320,2880,330,2550,91,24,2429,2441
215,HIDALGO,215,0107,2150107,5659,4575,260,4315,43,39,4216,4240,3313,210,3103,32,29,3016,3034
215,HIDALGO,215,0101,2150101,5653,1145,134,1011,38,12,971,979,841,108,733,32,7,695,702
13,ATASCOSA,13,0006,130006,100,712,258,454,6,15,432,439,514,211,303,4,9,285,288
29,BEXAR,29,4122,294122,933,119,56,63,1,3,55,56,92,48,44,1,2,39,40
39,BRAZORIA,39,0069,390069,1182,4179,858,3321,1483,1207,651,1806,2785,604,2181,986,810,383,1155
111,DALLAM,111,0006,1110006,2015,1014,450,564,4,21,522,542,710,347,363,2,14,336,349
113,DALLAS,113,2074,1132074,2264,1914,612,1302,666,368,253,606,1597,562,1035,489,316,213,517
121,DENTON,121,4172,1214172,3097,3892,1996,1896,446,690,743,1395,3730,1930,1800,430,659,694,1316
303,LUBBOCK,303,0118,3030118,6592,3056,1272,1784,61,344,1357,1676,2284,1103,1181,26,228,886,1111
375,POTTER,375,0221,3750221,7425,5326,888,4438,230,398,3845,4158,3700,787,2913,144,230,2547,2739
411,SAN SABA,411,003B,411003B,7674,588,286,302,7,2,282,284,416,226,190,2,0,176,176
439,TARRANT,439,4340,4394340,8507,3716,3011,705,41,62,481,530,2962,2465,497,28,35,325,355
453,TRAVIS,453,0160,4530160,8756,4899,1532,3367,363,1261,1759,2926,3455,1208,2247,255,830,1142,1918
497,WISE,497,0025,4970025,9589,1649,1208,441,18,25,323,348,1235,955,280,9,13,196,209
141,EL PASO,141,0033,1410033,3346,2334,713,1621,75,47,1497,1526,1899,622,1277,56,26,1177,1191
193,HAMILTON,193,0009,1930009,4179,255,228,27,2,2,19,19,201,188,13,2,1,7,7
201,HARRIS,201,0211,2010211,4428,8809,551,8258,774,477,6994,7427,6440,500,5940,622,397,4888,5266
201,HARRIS,201,1043,2011043,5261,3548,2113,1435,138,287,952,1225,2691,1695,996,106,188,655,830
209,HAYS,209,0448,2090448,5510,2520,2027,493,48,38,340,372,1862,1544,318,31,23,214,233
275,KNOX,275,0301,2750301,6343,769,374,395,6,71,314,367,588,318,270,2,45,201,246
29,BEXAR,29,4222,294222,1033,396,292,104,12,14,75,85,300,232,68,11,8,47,51
29,BEXAR,29,2079,292079,492,1633,49,1584,25,50,1522,1556,1049,33,1016,9,27,981,1001
29,BEXAR,29,2128,292128,541,5421,233,5188,65,218,4936,5090,3715,181,3534,48,154,3340,3461
37,BOWIE,37,0024,370024,1082,732,638,94,3,29,50,78,569,512,57,1,16,29,45
73,CHEROKEE,73,0022,730022,1574,1135,702,433,6,230,159,386,865,560,305,4,149,112,260
81,COKE,81,0004A,810004A,1623,778,589,189,4,2,174,174,611,471,140,0,1,126,126
397,ROCKWALL,397,003C,397003C,7574,4230,3505,725,134,136,310,430,3060,2575,485,102,80,204,275
439,TARRANT,439,2263,4392263,8115,6776,1030,5746,241,566,4876,5388,4653,873,3780,187,336,3190,3512
449,TITUS,449,0005,4490005,8656,367,321,46,0,6,28,33,279,248,31,0,4,17,21
475,WARD,475,001E,475001E,9197,2636,639,1997,28,259,1730,1959,1864,494,1370,21,161,1193,1344
201,HARRIS,201,0652,2010652,4869,4352,166,4186,735,2382,1100,3429,3480,157,3323,630,1894,816,2670
201,HARRIS,201,0111,2010111,4328,5606,2308,3298,679,1070,1542,2543,3857,1666,2191,467,697,992,1659
205,HARTLEY,205,0101,2050101,5410,612,351,261,5,13,236,247,416,262,154,2,11,140,149
231,HUNT,231,0111,2310111,5951,1382,844,538,42,207,249,449,1031,679,352,28,136,154,288
297,LIVE OAK,297,0003,2970003,6492,1650,555,1095,9,18,1054,1067,1277,457,820,5,13,784,793
347,NACOGDOCHES,347,0012,3470012,7033,2969,2318,651,37,192,335,521,2317,1861,456,23,145,213,352
113,DALLAS,113,4047,1134047,2705,1914,13,1901,4,722,1198,1894,1309,11,1298,0,565,743,1296
113,DALLAS,113,1168,1131168,2115,3880,3161,719,201,70,350,408,2956,2514,442,115,50,226,267
113,DALLAS,113,3971,1133971,2656,5182,2407,2775,325,1039,1333,2331,4073,2058,2015,262,745,931,1653
113,DALLAS,113,1706,1131706,2164,8680,1027,7653,1213,631,5812,6405,6257,870,5387,954,433,4003,4411
135,ECTOR,135,0406,1350406,3246,6899,985,5914,32,428,5486,5838,4923,786,4137,24,292,3834,4085
157,FORT BEND,157,4163,1574163,3787,2118,328,1790,810,638,325,956,1591,244,1347,632,468,231,693
29,BEXAR,29,2140,292140,553,3468,553,2915,189,544,2204,2687,2526,465,2061,140,369,1540,1885
61,CAMERON,61,0077,610077,1489,5739,98,5641,11,17,5625,5627,4104,67,4037,6,13,4025,4026
113,DALLAS,113,2502,1132502,2382,2460,2073,387,149,32,158,185,1723,1475,248,104,14,90,102
201,HARRIS,201,0080,2010080,4297,5822,524,5298,41,1487,3813,5226,4348,452,3896,31,1183,2697,3843
29,BEXAR,29,2055,292055,467,3116,1865,1251,299,148,785,920,2946,1780,1166,283,139,720,850
355,NUECES,355,0033,3550033,7148,2579,863,1716,30,170,1475,1632,2233,831,1402,23,127,1206,1328
141,EL PASO,141,0005,1410005,3318,6611,643,5968,111,155,5738,5840,4683,497,4186,83,89,4018,4089
201,HARRIS,201,1015,2011015,5233,0,0,0,0,0,0,0,0,0,0,0,0,0,0
57,CALHOUN,57,0010,570010,1403,1938,1326,612,78,16,473,485,1553,1100,453,62,14,340,351
351,NEWTON,351,0022,3510022,7105,588,293,295,1,269,13,282,468,219,249,0,231,9,240
439,TARRANT,439,1652,4391652,8041,800,27,773,18,683,78,754,419,16,403,7,351,45,396
251,JOHNSON,251,0011,2510011,6169,5402,4176,1226,75,116,808,917,4238,3396,842,52,70,538,606
255,KARNES,255,0006,2550006,6212,243,221,22,0,2,16,18,189,176,13,0,1,10,11
113,DALLAS,113,2155,1132155,2339,2997,2122,875,157,195,457,634,2226,1611,615,110,140,311,443
113,DALLAS,113,3048,1133048,2485,3755,121,3634,18,2510,1132,3603,2840,113,2727,9,2019,715,2713
201,HARRIS,201,1058,2011058,5276,496,90,406,47,202,168,361,389,80,309,41,156,117,269
61,CAMERON,61,0034,610034,1446,2884,655,2229,22,15,2174,2183,2209,590,1619,19,13,1570,1579
477,WASHINGTON,477,0121,4770121,9209,133,69,64,3,22,34,53,108,65,43,0,18,19,34
269,KING,269,0001,2690001,6315,64,55,9,1,1,6,7,54,47,7,0,0,5,5
69,CASTRO,69,0307,690307,1549,438,143,295,2,5,287,290,319,119,200,2,4,193,196
29,BEXAR,29,3009,293009,613,29,9,20,4,0,16,16,18,9,9,1,0,8,8
29,BEXAR,29,2097,292097,510,4187,1004,3183,80,334,2790,3070,3118,836,2282,52,229,1990,2196
201,HARRIS,201,1161,2011161,5379,0,0,0,0,0,0,0,0,0,0,0,0,0,0
303,LUBBOCK,303,0036,3030036,6550,3598,1916,1682,7,156,1453,1582,2709,1560,1149,4,97,983,1072
201,HARRIS,201,0418,2010418,4635,10152,1010,9142,1383,2672,5119,7684,7289,866,6423,1079,1792,3533,5282
29,BEXAR,29,3199,293199,805,5392,2359,3033,589,441,1957,2353,3883,1772,2111,395,315,1329,1624
201,HARRIS,201,0269,2010269,4486,2987,2243,744,201,162,333,481,2612,2002,610,165,132,261,386
113,DALLAS,113,3208,1133208,2571,4425,719,3706,73,1160,2461,3591,3219,667,2552,55,835,1642,2465
491,WILLIAMSON,491,0151,4910151,9401,7371,4107,3264,931,679,1576,2164,5920,3470,2450,747,474,1143,1568
381,RANDALL,381,0421,3810421,7486,6879,4446,2433,87,572,1619,2137,5421,3724,1697,55,368,1109,1468
207,HASKELL,207,0007,2070007,5422,165,108,57,0,4,49,52,144,102,42,0,4,35,38
479,WEBB,479,0422,4790422,9295,1004,34,970,3,8,966,968,775,27,748,1,7,744,746
141,EL PASO,141,0194,1410194,3507,5537,1334,4203,320,933,3067,3791,3658,962,2696,194,579,1937,2429
439,TARRANT,439,4045,4394045,8422,3455,2726,729,92,82,450,519,2710,2233,477,57,53,282,329
277,LAMAR,277,003G,277003G,6358,741,679,62,4,11,15,25,583,548,35,3,2,7,9
201,HARRIS,201,0226,2010226,4443,6689,197,6492,172,211,6144,6315,4940,175,4765,143,157,4481,4617
157,FORT BEND,157,3035,1573035,3699,2812,760,2052,1380,246,412,651,2198,601,1597,1094,186,298,479
85,COLLIN,85,0112,850112,1741,3974,2343,1631,1175,154,256,403,3084,1868,1216,917,103,165,264
143,ERATH,143,0033,1430033,3550,1998,1386,612,41,70,405,465,1640,1185,455,34,50,286,331
209,HAYS,209,0445,2090445,5508,2999,2433,566,148,41,311,350,2279,1910,369,99,28,188,216
375,POTTER,375,0125,3750125,7423,5729,3627,2102,131,434,1349,1734,4596,3117,1479,77,295,931,1210
85,COLLIN,85,0006,850006,1635,2409,1008,1401,698,395,279,663,1686,712,974,494,265,188,450
201,HARRIS,201,0355,2010355,4572,3236,205,3031,169,1972,943,2855,2352,173,2179,111,1473,617,2056
29,BEXAR,29,2157,292157,570,0,0,0,0,0,0,0,0,0,0,0,0,0,0
295,LIPSCOMB,295,0308,2950308,6487,237,182,55,2,1,46,46,188,151,37,1,1,30,30
157,FORT BEND,157,1005,1571005,3613,2084,1445,639,85,185,327,497,1612,1176,436,49,132,209,332
85,COLLIN,85,0069,850069,1698,5071,2984,2087,1106,398,470,853,4024,2542,1482,800,259,329,582
471,WALKER,471,0206,4710206,9166,1473,1000,473,59,185,172,348,1209,854,355,43,143,120,257
157,FORT BEND,157,1148B,1571148B,3636,0,0,0,0,0,0,0,0,0,0,0,0,0,0
213,HENDERSON,213,2PSS,2132PSS,5551,3916,3333,583,34,106,270,372,3240,2821,419,17,65,179,244
29,BEXAR,29,3156,293156,762,7,0,7,0,0,7,7,0,0,0,0,0,0,0
113,DALLAS,113,4015,1134015,2677,2408,653,1755,55,740,938,1667,2033,610,1423,45,664,681,1344
141,EL PASO,141,0108,1410108,3421,2860,478,2382,70,128,2208,2306,2282,448,1834,57,101,1679,1765
485,WICHITA,485,0408,4850408,9358,1666,1249,417,13,115,234,345,1291,1025,266,3,70,142,210
201,HARRIS,201,0972,2010972,5190,3958,2796,1162,456,152,485,623,2773,2030,743,298,105,285,387
113,DALLAS,113,3106,1133106,2548,6100,751,5349,85,3604,1712,5212,4310,634,3676,62,2507,1137,3579
367,PARKER,367,0250,3670250,7357,1724,1456,268,23,27,151,174,1357,1176,181,5,13,110,121
287,LEE,287,0402,2870402,6421,189,75,114,0,99,8,104,167,69,98,0,89,3,92
113,DALLAS,113,4040,1134040,2700,1358,26,1332,7,535,798,1326,1004,24,980,4,455,521,974
141,EL PASO,141,0171,1410171,3484,5773,93,5680,18,37,5630,5647,3998,53,3945,10,22,3909,3920
201,HARRIS,201,0038,2010038,4254,4049,2717,1332,447,149,653,785,3555,2461,1094,351,110,551,653
201,HARRIS,201,0332,2010332,4549,7939,234,7705,346,1964,5453,7336,5782,183,5599,275,1443,3900,5298
439,TARRANT,439,2697,4392697,8230,5935,2211,3724,384,2363,920,3214,4254,1694,2560,263,1634,585,2190
201,HARRIS,201,0203,2010203,4420,2487,168,2319,17,494,1806,2288,1825,147,1678,12,359,1302,1651
439,TARRANT,439,3530,4393530,8359,3928,2697,1231,624,119,394,511,2965,2137,828,408,83,263,345
29,BEXAR,29,3095,293095,699,5519,1810,3709,720,708,2267,2913,4747,1591,3156,621,574,1919,2469
209,HAYS,209,0344,2090344,5485,4103,3322,781,58,54,525,573,3244,2699,545,49,32,347,376
363,PALO PINTO,363,0005,3630005,7294,633,410,223,5,10,196,204,513,352,161,3,6,143,149
29,BEXAR,29,1153,291153,404,2097,561,1536,126,314,1125,1390,1342,406,936,59,196,673,849
29,BEXAR,29,3098,293098,702,1756,835,921,143,62,730,771,1309,672,637,104,38,500,527
75,CHILDRESS,75,0101,750101,1595,2509,1082,1427,31,418,943,1356,2145,906,1239,20,409,779,1186
491,WILLIAMSON,491,0257,4910257,9441,6667,3948,2719,418,590,1599,2131,4758,2982,1776,291,382,990,1348
391,REFUGIO,391,0002,3910002,7526,1084,683,401,5,28,361,380,851,556,295,4,19,261,277
141,EL PASO,141,0111,1410111,3424,2821,159,2662,34,47,2590,2623,2073,121,1952,18,35,1899,1921
113,DALLAS,113,3211,1133211,2574,3180,438,2742,35,309,2393,2679,2162,377,1785,22,212,1542,1743
439,TARRANT,439,3249,4393249,8293,6085,3019,3066,755,1098,1069,2122,4869,2601,2268,591,759,786,1527
201,HARRIS,201,0246,2010246,4463,7505,2808,4697,1060,1605,2023,3545,5699,2278,3421,823,1151,1393,2501
201,HARRIS,201,1121,2011121,5339,2494,90,2404,26,401,2021,2375,1644,54,1590,23,298,1306,1566
71,CHAMBERS,71,0018,710018,1569,2703,2014,689,86,103,423,516,1769,1366,403,53,56,229,284
157,FORT BEND,157,4124,1574124,3782,8082,2428,5654,3008,1364,1259,2579,6387,2016,4371,2202,1124,1021,2117
201,HARRIS,201,1078,2011078,5296,4008,1356,2652,441,613,1609,2180,2921,1042,1879,301,429,1136,1538
201,HARRIS,201,0289,2010289,4506,3790,387,3403,56,109,3276,3334,2743,340,2403,37,63,2317,2354
29,BEXAR,29,3072,293072,676,6720,3045,3675,604,554,2519,2987,4637,2190,2447,402,365,1634,1962
491,WILLIAMSON,491,0344,4910344,9484,2097,1556,541,131,116,277,375,1797,1364,433,113,93,201,285
469,VICTORIA,469,0006,4690006,9126,883,117,766,27,157,600,739,711,90,621,25,141,466,595
479,WEBB,479,0342,4790342,9272,4189,220,3969,60,35,3867,3897,3081,175,2906,46,26,2825,2850
439,TARRANT,439,2712,4392712,8233,4633,1957,2676,689,1224,725,1910,3319,1474,1845,471,851,458,1298
215,HIDALGO,215,0102,2150102,5654,1560,829,731,12,5,697,699,1427,828,599,10,2,567,569
355,NUECES,355,0053,3550053,7168,1423,151,1272,9,53,1232,1263,1088,129,959,3,34,926,951
29,BEXAR,29,2117,292117,530,1647,71,1576,5,37,1540,1573,1080,59,1021,2,30,990,1018
113,DALLAS,113,3807,1133807,2634,3643,371,3272,25,2594,676,3217,2756,333,2423,16,1936,477,2383
373,POLK,373,0004,3730004,7400,6717,3175,3542,99,1652,1701,3325,5984,2762,3222,84,1571,1494,3044
277,LAMAR,277,004D,277004D,6361,2129,1820,309,16,67,126,188,1609,1416,193,8,51,71,121
85,COLLIN,85,0049,850049,1678,2794,2106,688,203,139,271,399,2301,1800,501,153,93,191,280
113,DALLAS,113,2601,1132601,2402,6192,1064,5128,3686,800,555,1335,4539,958,3581,2414,643,436,1073
273,KLEBERG,273,0035,2730035,6335,1746,348,1398,6,8,1380,1382,1310,301,1009,2,1,1000,1001
141,EL PASO,141,0154,1410154,3467,3399,56,3343,21,34,3308,3327,2611,32,2579,16,28,2551,2567
29,BEXAR,29,3052,293052,656,2464,901,1563,369,279,942,1186,1754,705,1049,234,174,646,804
469,VICTORIA,469,0026,4690026,9146,1219,687,532,10,43,457,489,897,566,331,7,26,284,304
209,HAYS,209,0254,2090254,5465,3348,1404,1944,181,218,1548,1733,2498,1149,1349,131,147,1063,1195
215,HIDALGO,215,0019,2150019,5571,285,55,230,2,2,226,228,221,37,184,1,2,181,183
157,FORT BEND,157,2050,1572050,3656,3854,94,3760,64,3133,623,3693,3017,79,2938,46,2484,441,2884
367,PARKER,367,0450,3670450,7380,3331,2639,692,45,46,463,508,2514,2088,426,26,31,269,300
201,HARRIS,201,0120,2010120,4337,5114,1481,3633,511,426,2666,3056,3864,1296,2568,429,342,1756,2077
113,DALLAS,113,2806,1132806,2422,4463,2135,2328,1334,323,603,907,3211,1670,1541,875,208,400,601
113,DALLAS,113,3091,1133091,2528,0,0,0,0,0,0,0,0,0,0,0,0,0,0
473,WALLER,473,0314,4730314,9189,2525,659,1866,74,144,1631,1763,1853,526,1327,64,98,1138,1235
439,TARRANT,439,2299,4392299,8124,3164,443,2721,1101,1107,524,1608,2259,341,1918,793,778,339,1106
361,ORANGE,361,0019,3610019,7274,2955,2597,358,26,33,228,257,2311,2059,252,20,16,152,168
149,FAYETTE,149,0422,1490422,3593,901,783,118,1,17,95,106,711,640,71,0,6,59,65
85,COLLIN,85,0155,850155,1784,4172,2491,1681,571,586,445,1013,2937,1784,1153,387,398,302,691
439,TARRANT,439,3709,4393709,8402,2285,1429,856,217,177,432,585,1560,1033,527,139,111,246,349
85,COLLIN,85,0092,850092,1721,6619,3034,3585,494,1037,1945,2933,5244,2669,2575,379,750,1332,2054
259,KENDALL,259,4050,2594050,6272,4001,2273,1728,25,38,1512,1543,3240,2002,1238,20,30,1063,1090
141,EL PASO,141,0215,1410215,3530,8381,527,7854,76,272,7576,7751,5367,389,4978,45,174,4771,4908
439,TARRANT,439,2521,4392521,8187,2054,1142,912,148,291,429,701,1572,931,641,103,196,286,478
367,PARKER,367,0100,3670100,7337,5395,4395,1000,71,92,653,734,4264,3551,713,51,58,446,503
213,HENDERSON,213,001M,213001M,5528,3575,2250,1325,36,566,628,1188,2767,1862,905,27,398,404,800
377,PRESIDIO,377,0001,3770001,7443,601,145,456,5,5,438,443,483,122,361,4,2,346,348
479,WEBB,479,0250C,4790250C,9252,140,1,139,2,1,136,137,94,0,94,2,1,91,92
157,FORT BEND,157,3092,1573092,3719,1169,354,815,49,457,320,759,904,303,601,38,350,210,558
29,BEXAR,29,2137,292137,550,1983,499,1484,79,165,1268,1388,1600,465,1135,62,101,971,1054
85,COLLIN,85,0037,850037,1666,3967,2831,1136,46,72,852,919,2900,2205,695,20,35,517,549
201,HARRIS,201,0217,2010217,4434,3591,2511,1080,460,140,436,565,2814,2076,738,265,100,342,436
29,BEXAR,29,4005,294005,816,2812,389,2423,58,307,2081,2330,2150,333,1817,46,212,1548,1733
73,CHEROKEE,73,0034,730034,1583,2200,1932,268,32,43,138,178,1639,1463,176,21,27,89,115
201,HARRIS,201,0429,2010429,4646,9533,541,8992,1091,2923,4999,7753,6763,439,6324,954,2122,3221,5260
439,TARRANT,439,3131,4393131,8264,3106,1854,1252,90,328,752,1053,2463,1592,871,68,206,510,711
113,DALLAS,113,4074,1134074,2731,4079,1482,2597,79,352,2114,2445,3260,1276,1984,55,305,1564,1857
209,HAYS,209,0425,2090425,5496,1011,714,297,15,3,256,257,802,586,216,10,1,182,183
303,LUBBOCK,303,0049,3030049,6561,381,59,322,96,195,16,211,375,59,316,96,190,15,205
87,COLLINGSWORTH,87,0101,870101,1878,663,537,126,2,17,101,116,490,419,71,2,7,58,65
479,WEBB,479,0404,4790404,9286,3737,61,3676,2,9,3673,3673,2554,38,2516,2,9,2513,2513
281,LAMPASAS,281,0009,2810009,6392,2474,1766,708,89,163,353,500,1956,1465,491,59,114,226,331
309,MCLENNAN,309,0012,3090012,6644,6024,519,5505,20,4573,955,5410,4163,445,3718,13,3178,521,3655
29,BEXAR,29,3086,293086,690,2227,1256,971,106,87,765,840,1790,1041,749,72,61,597,654
157,FORT BEND,157,3172,1573172,3750,3264,516,2748,621,551,1592,2110,2490,439,2051,508,396,1150,1526
309,MCLENNAN,309,0054,3090054,6687,4017,2573,1444,125,524,724,1211,2776,1889,887,86,310,421,714
29,BEXAR,29,4091,294091,902,1621,612,1009,122,147,736,847,1337,559,778,99,102,559,644
113,DALLAS,113,4617,1134617,2857,336,95,241,27,23,189,207,254,95,159,18,13,123,134
201,HARRIS,201,0303,2010303,4520,4849,3652,1197,442,216,453,657,3965,3011,954,339,179,351,524
479,WEBB,479,0218,4790218,9240,4304,103,4201,22,22,4163,4169,3059,83,2976,17,14,2944,2949
215,HIDALGO,215,0070,2150070,5622,5212,105,5107,9,16,5079,5085,3505,73,3432,4,8,3411,3414
113,DALLAS,113,31A5,11331A5,2562,0,0,0,0,0,0,0,0,0,0,0,0,0,0
29,BEXAR,29,4174,294174,985,2563,589,1974,83,298,1613,1861,1906,494,1412,64,224,1121,1316
113,DALLAS,113,4122,1134122,2774,0,0,0,0,0,0,0,0,0,0,0,0,0,0
141,EL PASO,141,0142,1410142,3455,1781,56,1725,12,20,1707,1712,1405,50,1355,10,11,1344,1346
157,FORT BEND,157,1130,1571130,3627,8417,3911,4506,1757,610,2048,2620,6063,2889,3174,1213,421,1460,1863
201,HARRIS,201,0598,2010598,4815,6808,849,5959,337,1523,4118,5559,4679,656,4023,241,990,2765,3715
215,HIDALGO,215,0116,2150116,5668,4589,482,4107,66,46,4012,4034,3368,419,2949,56,24,2865,2886
367,PARKER,367,0335,3670335,7368,5483,4807,676,43,60,391,445,3812,3362,450,29,42,238,280
201,HARRIS,201,0091,2010091,4308,4131,2206,1925,441,604,872,1419,3417,1903,1514,351,446,677,1099
439,TARRANT,439,2657,4392657,8221,102,22,80,2,55,20,74,80,21,59,1,46,11,56
143,ERATH,143,0011,1430011,3538,1098,730,368,7,36,290,322,881,608,273,4,29,205,231
439,TARRANT,439,4373,4394373,8516,411,294,117,9,1,83,84,336,257,79,8,0,51,51
29,BEXAR,29,3066,293066,670,2542,1057,1485,48,116,1334,1402,2064,955,1109,32,79,997,1043
85,COLLIN,85,0126,850126,1755,7019,3955,3064,923,1055,944,1955,4995,2922,2073,649,685,631,1298
479,WEBB,479,0462,4790462,9303,957,30,927,2,6,921,924,714,26,688,0,4,685,687
371,PECOS,371,0001,3710001,7388,4564,1137,3427,80,302,3029,3300,3649,1031,2618,61,271,2261,2524
385,REAL,385,0001,3850001,7494,718,540,178,7,8,154,161,592,473,119,1,3,105,108
319,MASON,319,0101,3190101,6750,1000,779,221,5,13,182,189,798,643,155,1,7,127,128
373,POLK,373,0018,3730018,7414,2086,935,1151,17,606,450,1054,1554,760,794,13,446,276,720
29,BEXAR,29,3023,293023,627,88,59,29,2,1,23,24,65,50,15,0,1,11,12
113,DALLAS,113,3100,1133100,2542,3462,542,2920,71,2067,815,2831,2530,474,2056,57,1467,532,1982
29,BEXAR,29,3129,293129,733,4489,1455,3034,405,240,2408,2610,3539,1231,2308,320,185,1799,1959
389,REEVES,389,0006,3890006,7520,307,104,203,3,2,193,195,231,81,150,3,2,140,142
439,TARRANT,439,4587,4394587,8559,564,8,556,3,184,367,551,407,8,399,1,139,257,396
29,BEXAR,29,3190,293190,796,802,242,560,108,67,379,438,641,203,438,72,59,294,350
157,FORT BEND,157,2009,1572009,3644,4094,2486,1608,836,284,435,710,3496,2201,1295,729,210,318,522
85,COLLIN,85,0206,850206,1835,3014,1873,1141,410,299,361,651,2061,1365,696,261,195,192,386
113,DALLAS,113,3601,1133601,2605,2384,472,1912,48,1589,277,1839,1970,416,1554,46,1301,199,1487
491,WILLIAMSON,491,0138,4910138,9392,2908,963,1945,331,769,863,1581,2398,871,1527,291,581,652,1207
113,DALLAS,113,4006,1134006,2668,1853,936,917,65,83,735,810,1434,768,666,53,60,531,587
211,HEMPHILL,211,0201,2110201,5516,802,505,297,9,7,258,262,544,382,162,3,3,149,152
263,KENT,263,0302,2630302,6286,46,45,1,0,0,1,1,39,38,1,0,0,1,1
201,HARRIS,201,0260,2010260,4477,2900,641,2259,1131,353,746,1078,2221,533,1688,862,260,529,780
201,HARRIS,201,0555,2010555,4772,7019,321,6698,244,2546,4073,6407,4961,271,4690,209,1873,2718,4458
441,TAYLOR,441,0306,4410306,8622,6507,4868,1639,322,323,879,1176,4838,3786,1052,222,177,564,728
29,BEXAR,29,4048,294048,859,3507,295,3212,59,93,3082,3147,2681,247,2434,49,52,2336,2372
201,HARRIS,201,0197,2010197,4414,4162,50,4112,50,2702,1368,4038,3138,47,3091,39,2100,965,3035
67,CASS,67,0019,670019,1540,706,589,117,9,34,30,63,539,449,90,5,22,24,45
113,DALLAS,113,4674,1134674,2900,0,0,0,0,0,0,0,0,0,0,0,0,0,0
201,HARRIS,201,0492,2010492,4709,5873,1778,4095,378,2123,1670,3663,4311,1457,2854,297,1408,1193,2512
439,TARRANT,439,3387,4393387,8327,2738,2182,556,74,75,325,382,2141,1765,376,60,41,213,247
209,HAYS,209,0217,2090217,5453,80,19,61,1,13,44,57,62,16,46,0,10,36,46
497,WISE,497,0010,4970010,9575,812,657,155,4,6,121,125,616,513,103,3,2,77,79
215,HIDALGO,215,0193,2150193,5745,1135,62,1073,34,9,1027,1035,777,38,739,27,8,699,707
91,COMAL,91,0208B,910208B,1915,93,52,41,6,9,25,34,69,44,25,4,6,15,21
439,TARRANT,439,4736,4394736,8596,2695,2167,528,42,70,306,371,1990,1654,336,29,40,185,222
163,FRIO,163,0010,1630010,3830,3817,621,3196,31,519,2607,3119,2827,532,2295,17,472,1798,2265
443,TERRELL,443,0004B,4430004B,8639,43,31,12,0,2,10,12,35,24,11,0,2,9,11
309,MCLENNAN,309,0049,3090049,6681,1076,309,767,12,167,597,739,742,262,480,9,101,358,456
409,SAN PATRICIO,409,0116,4090116,7660,4923,3060,1863,313,124,1348,1448,3711,2427,1284,206,99,900,983
201,HARRIS,201,0549,2010549,4766,5612,194,5418,335,1836,3296,5071,4158,158,4000,285,1434,2327,3716
403,SABINE,403,0003,4030003,7617,875,559,316,2,246,50,286,630,407,223,2,175,28,197
309,MCLENNAN,309,0090,3090090,6724,705,375,330,7,85,225,307,561,326,235,5,64,153,216
321,MATAGORDA,321,001D,321001D,6767,3453,746,2707,24,376,2312,2644,2500,621,1879,17,262,1589,1833
29,BEXAR,29,4168,294168,979,4164,805,3359,149,1213,2106,3193,2919,653,2266,98,818,1379,2139
201,HARRIS,201,0592,2010592,4809,5925,547,5378,712,960,3710,4616,4216,460,3756,540,694,2504,3171
491,WILLIAMSON,491,0437,4910437,9532,8323,4250,4073,1574,871,1528,2334,5910,3179,2731,1062,569,982,1524
451,TOM GREEN,451,0215,4510215,8682,4095,2487,1608,152,219,1144,1321,3099,2012,1087,99,134,768,886
113,DALLAS,113,4662,1134662,2894,918,147,771,23,31,708,736,654,126,528,21,16,482,497
201,HARRIS,201,0635,2010635,4852,5500,3546,1954,187,371,1284,1621,4062,2775,1287,146,224,830,1044
121,DENTON,121,1013,1211013,2937,4419,2778,1641,132,615,712,1294,2834,1891,943,65,333,415,729
29,BEXAR,29,4211,294211,1022,43,21,22,8,1,13,14,40,19,21,8,1,12,13
419,SHELBY,419,0004,4190004,7703,1031,779,252,4,191,48,234,837,650,187,0,151,25,173
5,ANGELINA,5,0016,50016,43,4402,1294,3108,23,1014,2055,3043,3315,1089,2226,13,765,1426,2186
167,GALVESTON,167,0227,1670227,3873,5227,3970,1257,60,104,938,1033,3967,3115,852,41,70,609,677
503,YOUNG,503,0016,5030016,9618,775,681,94,5,9,51,59,617,557,60,2,7,34,40
97,COOKE,97,0003,970003,1958,853,736,117,12,4,79,80,636,568,68,6,0,43,43
329,MIDLAND,329,109A,329109A,6853,28,8,20,0,0,19,19,19,6,13,0,0,13,13
121,DENTON,121,2099,1212099,3023,3633,2531,1102,403,257,364,604,3007,2173,834,308,208,244,446
215,HIDALGO,215,0236,2150236,5788,934,81,853,25,11,822,827,651,71,580,20,5,554,559
201,HARRIS,201,0720,2010720,4938,3904,2080,1824,277,542,969,1477,3217,1785,1432,242,416,753,1143
227,HOWARD,227,0104,2270104,5917,225,134,91,3,8,83,85,165,100,65,3,5,57,59
113,DALLAS,113,1115,1131115,2087,3049,640,2409,25,199,2153,2332,2294,584,1710,17,148,1510,1651
37,BOWIE,37,012A,37012A,1108,58,56,2,1,0,2,2,36,36,0,0,0,0,0
39,BRAZORIA,39,0038,390038,1151,819,663,156,15,24,78,99,720,597,123,11,17,59,74
201,HARRIS,201,0763,2010763,4981,3020,194,2826,37,73,2709,2761,2134,165,1969,33,47,1874,1912
29,BEXAR,29,4194,294194,1005,2092,633,1459,98,246,1146,1330,1597,521,1076,83,178,817,965
223,HOPKINS,223,0036,2230036,5874,1470,1224,246,12,46,163,204,1123,967,156,11,20,101,119
113,DALLAS,113,1063,1131063,2044,3773,628,3145,48,242,2816,3032,2817,555,2262,44,169,2000,2159
113,DALLAS,113,4641,1134641,2877,1130,309,821,41,26,740,760,850,271,579,26,14,526,538
423,SMITH,423,0025,4230025,7746,2941,2209,732,96,276,277,547,2372,1846,526,55,193,210,402
9,ARCHER,9,0012,90012,86,113,101,12,2,0,2,2,87,80,7,2,0,0,0
93,COMANCHE,93,0010,930010,1941,694,544,150,1,4,128,129,566,457,109,1,2,93,94
329,MIDLAND,329,0102,3290102,6810,5702,2500,3202,361,522,2241,2745,3834,1782,2052,254,333,1395,1723
167,GALVESTON,167,0458,1670458,3916,2247,1735,512,4,25,412,433,1728,1377,351,4,18,275,290
27,BELL,27,0211,270211,215,2373,664,1709,159,989,560,1472,1709,536,1173,130,630,370,967
183,GREGG,183,0018,1830018,4045,4677,1927,2750,34,1744,908,2632,3714,1677,2037,24,1404,549,1947
121,DENTON,121,1056,1211056,2980,1964,1150,814,23,29,691,713,1467,952,515,18,24,411,432
439,TARRANT,439,3653,4393653,8387,0,0,0,0,0,0,0,0,0,0,0,0,0,0
491,WILLIAMSON,491,0320,4910320,9472,1716,1351,365,70,24,214,237,1321,1063,258,52,18,142,159
157,FORT BEND,157,3111,1573111,3727,2123,901,1222,583,239,378,602,1604,737,867,437,141,264,403
29,BEXAR,29,4065,294065,876,4002,587,3415,108,960,2470,3297,2788,463,2325,86,610,1653,2221
113,DALLAS,113,4161,1134161,2791,2250,123,2127,86,575,1487,2033,1535,107,1428,75,366,999,1354
303,LUBBOCK,303,0075,3030075,6578,1481,1142,339,40,43,235,270,1192,940,252,35,29,167,188
85,COLLIN,85,0226,850226,1855,6834,3663,3171,780,1355,937,2250,4796,2698,2098,551,864,592,1441
85,COLLIN,85,0120,850120,1749,4945,3171,1774,916,328,456,768,3633,2461,1172,616,204,285,485
439,TARRANT,439,4492,4394492,8536,2421,1593,828,111,328,369,673,2271,1540,731,98,287,328,593
201,HARRIS,201,0446,2010446,4663,1201,119,1082,26,37,1026,1048,826,100,726,17,28,679,699
29,BEXAR,29,4002,294002,813,1901,122,1779,11,157,1623,1755,1446,103,1343,2,121,1215,1329
439,TARRANT,439,4115,4394115,8450,743,651,92,21,17,39,53,586,531,55,16,8,21,26
157,FORT BEND,157,2068,1572068,3664,813,474,339,6,54,273,319,577,376,201,4,37,147,184
303,LUBBOCK,303,0021,3030021,6535,4112,1673,2439,60,377,1970,2294,2984,1385,1599,45,212,1272,1475
309,MCLENNAN,309,0032,3090032,6664,1608,1132,476,10,205,260,438,1300,1007,293,8,106,171,262
387,RED RIVER,387,19-1,38719-1,7514,301,259,42,1,4,27,29,246,215,31,1,4,19,21
215,HIDALGO,215,0047,2150047,5599,3797,112,3685,22,44,3636,3649,2835,75,2760,14,31,2721,2732
401,RUSK,401,0215,4010215,7600,3156,1930,1226,15,451,675,1113,2324,1491,833,10,317,427,741
7,ARANSAS,7,0001,70001,69,3109,2318,791,17,35,635,666,2587,2035,552,10,27,426,450
29,BEXAR,29,4108,294108,919,6844,2156,4688,224,1020,3489,4351,5091,1822,3269,164,666,2413,3007
113,DALLAS,113,4071,1134071,2728,1689,63,1626,6,109,1516,1615,1172,50,1122,5,82,1033,1112
453,TRAVIS,453,0176,4530176,8768,86,31,55,6,11,40,49,54,29,25,5,2,20,20
23,BAYLOR,23,0001,230001,172,863,709,154,4,26,101,124,656,565,91,1,14,59,73
175,GOLIAD,175,0021,1750021,3959,1402,630,772,20,92,660,728,1083,514,569,16,56,494,536
491,WILLIAMSON,491,0118,4910118,9386,4647,2802,1845,479,288,987,1249,3606,2327,1279,330,206,656,851
435,SUTTON,435,0301,4350301,7832,890,469,421,9,15,394,400,672,386,286,4,8,272,275
219,HOCKLEY,219,0032,2190032,5831,3841,1251,2590,27,231,2324,2515,2808,1037,1771,18,153,1574,1719
215,HIDALGO,215,0176,2150176,5728,3758,219,3539,4,16,3502,3505,2432,187,2245,4,10,2224,2227
201,HARRIS,201,0677,2010677,4895,4411,247,4164,54,149,3973,4089,3057,206,2851,41,98,2704,2792
121,DENTON,121,4162A,1214162A,3086,804,557,247,35,55,137,185,608,425,183,22,37,104,138
201,HARRIS,201,0383,2010383,4600,5503,687,4816,146,1053,3627,4624,4041,596,3445,115,813,2502,3299
181,GRAYSON,181,0407,1810407,4022,647,339,308,12,161,101,249,446,272,174,8,79,53,130
213,HENDERSON,213,004A,213004A,5536,2397,1151,1246,50,500,662,1138,1923,1022,901,48,383,436,811
339,MONTGOMERY,339,0003,3390003,6896,5937,3465,2472,562,352,1425,1739,4149,2529,1620,360,214,958,1145
201,HARRIS,201,0575,2010575,4792,8882,2904,5978,1331,1856,2752,4493,6206,2180,4026,912,1211,1821,2977
225,HOUSTON,225,0019,2250019,5894,890,692,198,3,144,35,174,729,572,157,1,119,19,136
21,BASTROP,21,1004,211004,149,3014,1546,1468,46,524,814,1312,2322,1284,1038,30,379,548,921
453,TRAVIS,453,0146,4530146,8745,1043,335,708,28,24,664,684,734,284,450,18,18,417,431
221,HOOD,221,0317,2210317,5851,2875,2421,454,31,39,275,310,2266,1970,296,16,24,180,203
169,GARZA,169,0003,1690003,3936,2696,476,2220,26,196,2027,2176,2424,402,2022,22,152,1863,1982
453,TRAVIS,453,0205,4530205,8788,4010,3188,822,249,81,410,477,3401,2742,659,177,54,340,386
423,SMITH,423,0045,4230045,7766,2740,2270,470,32,112,236,342,2147,1839,308,23,84,128,209
215,HIDALGO,215,0256,2150256,5808,519,102,417,3,3,413,414,393,75,318,2,3,316,317
333,MILLS,333,0009,3330009,6873,863,644,219,4,8,177,185,669,506,163,4,8,127,135
423,SMITH,423,0002,4230002,7723,2193,98,2095,7,420,1667,2073,1493,80,1413,4,291,1108,1397
491,WILLIAMSON,491,0410,4910410,9512,7679,3590,4089,239,858,2941,3658,5260,2642,2618,149,544,1837,2326
215,HIDALGO,215,0130,2150130,5682,3044,235,2809,10,12,2778,2785,2170,218,1952,7,3,1933,1935
401,RUSK,401,0212,4010212,7597,1141,834,307,6,181,102,278,926,698,228,4,137,70,207
157,FORT BEND,157,4069,1574069,3767,9879,1992,7887,2639,3333,1944,5156,6471,1359,5112,1805,2064,1212,3235
29,BEXAR,29,4105,294105,916,1709,620,1089,115,207,801,960,1299,515,784,81,133,582,694
499,WOOD,499,01-2,49901-2,9595,3234,2739,495,13,44,345,381,2772,2430,342,12,19,233,248
41,BRAZOS,41,0023,410023,1214,127,80,47,0,8,35,43,95,63,32,0,5,25,30
113,DALLAS,113,1091,1131091,2064,5506,319,5187,40,1094,4069,5128,3919,284,3635,30,901,2706,3588
121,DENTON,121,4204,1214204,3129,4254,3280,974,254,151,438,574,3233,2557,676,163,109,308,406
177,GONZALES,177,04/6,17704/6,3979,3025,750,2275,20,88,2150,2226,2148,635,1513,17,66,1412,1475
3,ANDREWS,3,0001,30001,23,4698,1784,2914,26,67,2765,2816,3245,1338,1907,18,41,1792,1830
167,GALVESTON,167,0173,1670173,3853,1618,1016,602,188,134,241,371,1115,705,410,129,82,174,254
441,TAYLOR,441,0303,4410303,8619,2860,2453,407,8,26,280,300,2057,1802,255,5,12,155,164
29,BEXAR,29,4045,294045,856,4273,1093,3180,157,514,2497,2966,3332,979,2353,136,384,1812,2170
215,HIDALGO,215,0173,2150173,5725,4177,555,3622,5,7,3588,3594,2822,522,2300,4,6,2271,2277
89,COLORADO,89,0402,890402,1895,4402,1212,3190,12,946,2251,3127,3301,1034,2267,3,662,1575,2221
27,BELL,27,0315,270315,235,6235,3314,2921,341,938,1656,2462,4160,2332,1828,216,591,983,1512
453,TRAVIS,453,0262,4530262,8831,6330,2498,3832,2838,225,663,867,4977,2215,2762,1981,179,523,686
325,MEDINA,325,001D,325001D,6790,1880,999,881,13,32,820,838,1437,824,613,7,23,570,584
121,DENTON,121,1036,1211036,2960,5733,3012,2721,980,863,778,1588,3845,2110,1735,611,558,468,1005
113,DALLAS,113,1148,1131148,2107,0,0,0,0,0,0,0,0,0,0,0,0,0,0
201,HARRIS,201,0783,2010783,5001,2518,72,2446,58,949,1462,2381,1638,47,1591,42,658,909,1545
453,TRAVIS,453,0372B,4530372B,8914,89,51,38,17,1,15,16,68,43,25,12,0,11,11
37,BOWIE,37,0011,370011,1068,1174,932,242,6,128,66,191,892,732,160,0,91,38,127
305,LYNN,305,0006,3050006,6621,667,320,347,11,35,294,326,495,259,236,8,21,196,217
85,COLLIN,85,0183,850183,1812,108,88,20,1,0,12,12,80,70,10,0,0,4,4
201,HARRIS,201,0489,2010489,4706,3491,619,2872,193,829,1861,2658,2717,553,2164,157,680,1329,1987
29,BEXAR,29,4214,294214,1025,2999,454,2545,35,108,2406,2478,2061,360,1701,24,60,1613,1659
39,BRAZORIA,39,0018,390018,1131,6753,3903,2850,472,727,1510,2194,4844,2857,1987,318,534,1023,1540
121,DENTON,121,1016,1211016,2940,6627,3517,3110,1155,940,901,1802,4094,2224,1870,702,576,497,1052
423,SMITH,423,0028,4230028,7749,6306,4631,1675,108,693,713,1390,4475,3448,1027,67,410,403,812
301,LOVING,301,0003,3010003,6515,26,25,1,1,1,0,1,20,19,1,1,1,0,1
439,TARRANT,439,4252,4394252,8493,1622,911,711,37,56,571,622,1311,797,514,26,49,398,446
113,DALLAS,113,4665,1134665,2897,0,0,0,0,0,0,0,0,0,0,0,0,0,0
37,BOWIE,37,002B,37002B,1088,1005,289,716,12,584,91,674,667,212,455,10,373,48,420
121,DENTON,121,2079,1212079,3003,4802,3115,1687,746,358,465,801,3716,2542,1174,515,263,298,545
201,HARRIS,201,0595,2010595,4812,5501,277,5224,155,1459,3651,5048,3875,247,3628,129,1075,2440,3486
201,HARRIS,201,0426,2010426,4643,2504,429,2075,623,231,1217,1432,1971,400,1571,525,196,839,1027
85,COLLIN,85,0246,850246,1875,3607,2064,1543,1027,231,231,454,2839,1711,1128,762,167,151,315
5,ANGELINA,5,0040,50040,66,1309,564,745,27,402,305,695,989,493,496,21,262,196,454
113,DALLAS,113,4542,1134542,2834,0,0,0,0,0,0,0,0,0,0,0,0,0,0
157,FORT BEND,157,2123,1572123,3684,4021,61,3960,29,2638,1351,3919,2747,50,2697,21,1830,864,2663
201,HARRIS,201,0532,2010532,4749,2349,871,1478,67,488,916,1367,1727,725,1002,48,314,620,923
449,TITUS,449,0011,4490011,8662,622,171,451,6,11,430,434,422,134,288,6,6,273,277
317,MARTIN,317,0004,3170004,6747,965,620,345,7,29,300,325,665,435,230,3,21,198,218
439,TARRANT,439,4568,4394568,8556,102,65,37,1,3,27,29,85,56,29,0,2,19,21
85,COLLIN,85,0140,850140,1769,6339,4682,1657,418,535,597,1119,4699,3542,1157,301,370,397,759
503,YOUNG,503,0024,5030024,9621,3692,2371,1321,21,58,1141,1189,2769,1893,876,12,30,753,781
93,COMANCHE,93,0006,930006,1938,488,311,177,0,8,153,158,391,273,118,0,6,99,103
215,HIDALGO,215,0067,2150067,5619,4239,475,3764,72,59,3633,3672,3309,413,2896,49,48,2789,2822
121,DENTON,121,3142,1213142,3066,1028,576,452,57,40,322,359,714,427,287,50,25,190,213
161,FREESTONE,161,0007A,1610007A,3810,1183,799,384,8,210,145,350,899,620,279,2,160,93,249
15,AUSTIN,15,0414,150414,129,2438,1119,1319,33,176,1076,1216,1766,916,850,25,104,672,765
157,FORT BEND,157,3166,1573166,3747,146,112,34,13,13,6,19,137,109,28,9,13,4,17
41,BRAZOS,41,0003,410003,1194,1890,770,1120,5,237,844,1077,1363,621,742,1,197,519,712
107,CROSBY,107,0011,1070011,2001,1141,365,776,7,44,710,747,836,305,531,7,32,474,506
339,MONTGOMERY,339,0023,3390023,6916,8119,3991,4128,96,1014,2848,3816,5705,3081,2624,62,658,1749,2394
29,BEXAR,29,4151,294151,962,803,546,257,14,11,213,224,639,454,185,9,5,151,156
201,HARRIS,201,0658,2010658,4875,5181,2098,3083,237,993,1761,2700,3725,1679,2046,153,653,1149,1788
453,TRAVIS,453,0123,4530123,8725,3291,675,2616,168,637,1820,2419,2412,581,1831,109,510,1208,1693
309,MCLENNAN,309,0052,3090052,6684,939,833,106,23,28,40,66,853,785,68,14,20,20,39
27,BELL,27,0104,270104,192,4960,3778,1182,109,149,772,900,3805,3023,782,65,80,508,576
491,WILLIAMSON,491,0317,4910317,9469,1765,650,1115,939,22,145,165,1135,467,668,557,11,87,98
41,BRAZOS,41,0043,410043,1234,1122,393,729,10,292,426,717,1102,388,714,10,292,411,702
201,HARRIS,201,0846,2010846,5064,675,49,626,4,116,498,614,492,46,446,3,100,336,436
339,MONTGOMERY,339,0080A,3390080A,6979,6836,4425,2411,302,437,1522,1930,4895,3299,1596,212,289,977,1254
113,DALLAS,113,2002,1132002,2213,1965,1095,870,99,98,616,714,1553,926,627,72,79,431,510
239,JACKSON,239,0006,2390006,6000,1395,561,834,26,122,672,780,1010,468,542,19,59,447,501
29,BEXAR,29,1048,291048,298,3996,300,3696,19,49,3642,3670,2918,255,2663,12,35,2623,2645
439,TARRANT,439,1198,4391198,7915,1507,295,1212,73,54,1073,1125,1071,250,821,53,32,725,755
41,BRAZOS,41,0087,410087,1277,0,0,0,0,0,0,0,0,0,0,0,0,0,0
439,TARRANT,439,1080,4391080,7872,2843,97,2746,25,1494,1254,2710,1933,69,1864,22,1053,791,1832
121,DENTON,121,4223,1214223,3149,3949,2446,1503,247,549,594,1127,2822,1860,962,173,336,365,695
201,HARRIS,201,0803,2010803,5021,6355,3322,3033,702,787,1461,2197,4876,2753,2123,519,536,963,1481
339,MONTGOMERY,339,0041,3390041,6936,7011,4703,2308,61,173,1864,2020,5063,3592,1471,32,113,1166,1273
453,TRAVIS,453,0294,4530294,8851,3324,2237,1087,227,75,699,771,2760,1949,811,169,59,511,568
187,GUADALUPE,187,0201,1870201,4085,1178,311,867,10,83,770,844,869,262,607,8,60,533,590
113,DALLAS,113,1712,1131712,2170,3974,1556,2418,114,298,1941,2216,2966,1332,1634,74,200,1286,1474
391,REFUGIO,391,004B,391004B,7534,154,86,68,4,5,64,67,128,73,55,0,2,52,54
439,TARRANT,439,4163,4394163,8470,1700,1366,334,64,44,184,225,1192,1003,189,27,25,104,129
491,WILLIAMSON,491,0371,4910371,9492,4269,2730,1539,95,328,1059,1347,3401,2343,1058,78,219,708,907
215,HIDALGO,215,0110,2150110,5662,3441,72,3369,19,27,3333,3344,2112,49,2063,16,14,2042,2047
85,COLLIN,85,0203,850203,1832,3914,3025,889,154,269,389,635,2968,2373,595,106,176,259,423
433,STONEWALL,433,0004,4330004,7829,339,252,87,3,7,75,80,269,210,59,3,6,48,53
231,HUNT,231,0319,2310319,5957,2759,2305,454,23,78,236,309,2115,1813,302,14,48,148,195
201,HARRIS,201,0552,2010552,4769,5627,4085,1542,223,366,829,1173,4216,3172,1044,161,239,550,778
439,TARRANT,439,4820,4394820,8599,0,0,0,0,0,0,0,0,0,0,0,0,0,0
409,SAN PATRICIO,409,0119,4090119,7663,1652,1007,645,44,45,484,525,1308,846,462,30,35,347,380
1,ANDERSON,1,0003,10003,3,1925,1408,517,25,150,294,435,1473,1151,322,15,97,159,256
303,LUBBOCK,303,0124,3030124,6598,2389,1682,707,51,69,522,584,1939,1406,533,43,43,388,426
113,DALLAS,113,4115,1134115,2768,444,299,145,20,9,103,112,340,238,102,14,9,69,78
187,GUADALUPE,187,0405,1870405,4128,3302,2048,1254,50,89,1075,1148,2526,1680,846,30,63,707,766
337,MONTAGUE,337,0016,3370016,6893,452,393,59,2,1,42,43,340,297,43,2,1,30,31
165,GAINES,165,0004,1650004,3833,5417,3098,2319,50,92,2135,2203,3532,1971,1561,32,55,1423,1472
419,SHELBY,419,0007,4190007,7706,1017,673,344,6,273,53,325,794,538,256,6,208,34,242
5,ANGELINA,5,0019,50019,46,1952,1248,704,126,340,187,525,1535,1022,513,95,247,124,370
215,HIDALGO,215,0239,2150239,5791,6425,450,5975,18,32,5927,5947,4402,398,4004,15,24,3961,3979
121,DENTON,121,3122,1213122,3046,5130,1832,3298,401,1787,1093,2820,4277,1659,2618,341,1354,873,2197
321,MATAGORDA,321,003A,321003A,6770,4248,1010,3238,444,153,2642,2775,3129,842,2287,352,107,1814,1913
29,BEXAR,29,4171,294171,982,1744,737,1007,47,102,844,927,1332,608,724,28,76,603,665
201,HARRIS,201,0638,2010638,4855,4789,116,4673,129,2586,1995,4511,3543,105,3438,99,1956,1387,3304
219,HOCKLEY,219,0036,2190036,5834,982,178,804,3,44,757,794,725,155,570,3,34,533,563
167,GALVESTON,167,0462,1670462,3919,4616,3055,1561,760,141,555,688,3089,2120,969,469,92,339,430
329,MIDLAND,329,0304,3290304,6833,5782,633,5149,36,696,4437,5060,4090,504,3586,29,485,3066,3526
201,HARRIS,201,0700,2010700,4918,4263,2900,1363,45,167,1043,1199,3118,2190,928,32,116,686,799
445,TERRY,445,0201,4450201,8642,2028,718,1310,18,124,1157,1264,1476,562,914,14,92,794,880
113,DALLAS,113,4614,1134614,2854,707,417,290,42,44,197,235,534,347,187,25,25,122,143
311,MCMULLEN,311,0002,3110002,6727,143,80,63,1,3,58,59,109,59,50,1,2,46,47
157,FORT BEND,157,4170,1574170,3790,350,102,248,3,144,104,245,350,102,248,3,144,104,245
201,HARRIS,201,0509,2010509,4726,5397,1612,3785,417,1160,2209,3249,4139,1363,2776,305,843,1612,2385
215,HIDALGO,215,0153,2150153,5705,912,17,895,1,4,888,888,597,7,590,1,1,588,588
225,HOUSTON,225,0022,2250022,5897,386,272,114,0,55,46,99,338,236,102,0,52,39,89
99,CORYELL,99,0309,990309,1981,1036,874,162,5,19,97,110,806,700,106,2,11,63,71
179,GRAY,179,0003,1790003,3982,169,147,22,2,0,14,14,137,120,17,2,0,9,9
309,MCLENNAN,309,0009,3090009,6641,2481,482,1999,19,578,1406,1931,1748,393,1355,14,413,913,1303
201,HARRIS,201,0615,2010615,4832,3786,1035,2751,310,1170,1276,2386,2916,915,2001,256,840,892,1699
215,HIDALGO,215,0216,2150216,5768,2568,105,2463,19,26,2421,2434,2058,85,1973,13,8,1951,1955
439,TARRANT,439,4369,4394369,8513,5684,3642,2042,300,414,1226,1594,4209,2833,1376,210,298,775,1047
309,MCLENNAN,309,0071,3090071,6704,1367,845,522,3,289,183,457,1001,672,329,1,181,108,285
491,WILLIAMSON,491,0267,4910267,9449,3632,2251,1381,193,216,910,1089,2526,1647,879,122,134,566,688
439,TARRANT,439,4640,4394640,8576,1082,518,564,44,97,411,497,962,502,460,43,82,323,396
31,BLANCO,31,0303,310303,1045,1046,850,196,7,8,143,149,926,768,158,5,8,109,115
397,ROCKWALL,397,004A,397004A,7577,7319,4367,2952,314,859,1610,2419,4831,2990,1841,189,550,964,1496
423,SMITH,423,0048,4230048,7769,2653,678,1975,14,424,1512,1917,1859,582,1277,10,311,925,1223
13,ATASCOSA,13,0015,130015,109,4280,1205,3075,28,73,2919,2956,3084,959,2125,20,49,2008,2039
453,TRAVIS,453,0233,4530233,8808,4342,3385,957,388,82,396,475,3405,2743,662,271,59,272,329
113,DALLAS,113,1067,1131067,2047,38,9,29,1,0,27,27,19,5,14,1,0,12,12
451,TOM GREEN,451,0436,4510436,8705,5748,3718,2030,77,193,1657,1808,4491,3063,1428,53,99,1150,1241
407,SAN JACINTO,407,0007,4070007,7640,2546,1961,585,22,364,120,479,2199,1755,444,17,268,95,360
497,WISE,497,0013,4970013,9578,995,744,251,4,14,188,202,768,599,169,3,14,113,127
91,COMAL,91,0301B,910301B,1918,0,0,0,0,0,0,0,0,0,0,0,0,0,0
121,DENTON,121,1059,1211059,2983,3584,2360,1224,130,333,644,946,2944,2044,900,119,248,436,670
427,STARR,427,0012,4270012,7809,7168,148,7020,54,22,6946,6958,4799,99,4700,41,18,4647,4659
121,DENTON,121,2076,1212076,3000,5465,2439,3026,248,891,1737,2610,4060,1989,2071,190,572,1177,1744
201,HARRIS,201,0697,2010697,4915,5895,430,5465,407,1380,3714,5027,4351,375,3976,356,1083,2556,3591
329,MIDLAND,329,0211,3290211,6830,6365,2886,3479,179,557,2653,3168,4089,1982,2107,107,308,1615,1903
39,BRAZORIA,39,0015,390015,1128,4176,2928,1248,57,243,855,1080,3223,2291,932,32,199,611,805
121,DENTON,121,3119,1213119,3043,308,122,186,142,15,18,33,235,95,140,106,14,14,28
305,LYNN,305,0003,3050003,6618,762,309,453,0,5,440,445,565,236,329,0,5,317,322
439,TARRANT,439,4483,4394483,8533,138,23,115,4,2,110,111,110,20,90,3,1,85,86
37,BOWIE,37,0028,370028,1085,888,779,109,1,12,47,59,731,654,77,1,6,35,41
201,HARRIS,201,0740,2010740,4958,503,319,184,12,16,150,164,384,262,122,6,12,95,105
449,TITUS,449,0008,4490008,8659,3467,495,2972,20,448,2488,2912,2378,401,1977,10,317,1623,1928
317,MARTIN,317,0001,3170001,6744,1355,634,721,10,24,678,695,1004,502,502,8,19,468,482
113,DALLAS,113,1405,1131405,2150,1368,169,1199,6,382,807,1182,907,152,755,6,216,524,739
187,GUADALUPE,187,0105,1870105,4065,4851,2706,2145,38,149,1832,1963,3730,2232,1498,18,113,1264,1372
309,MCLENNAN,309,0029,3090029,6661,2000,728,1272,42,612,635,1191,1648,639,1009,39,498,473,933
113,DALLAS,113,4538,1134538,2831,2408,341,2067,82,553,1406,1927,1659,276,1383,68,343,940,1272
201,HARRIS,201,0529,2010529,4746,6850,4769,2081,146,436,1358,1772,5324,3855,1469,102,288,959,1237
233,HUTCHINSON,233,0023,2330023,5980,1072,707,365,23,42,236,261,780,546,234,23,22,134,155
439,TARRANT,439,1126,4391126,7895,2324,682,1642,125,1109,382,1465,1864,596,1268,97,867,271,1126
415,SCURRY,415,0007,4150007,7683,3393,1933,1460,41,90,1288,1364,2454,1550,904,20,47,798,843
119,DELTA,119,0001,1190001,2917,947,852,95,3,32,36,67,724,656,68,2,18,26,44
423,SMITH,423,0005,4230005,7726,6261,4798,1463,105,501,674,1162,4545,3627,918,56,316,397,710
167,GALVESTON,167,0388,1670388,3896,6205,3757,2448,557,461,1351,1774,4628,2857,1771,425,327,941,1251
29,BEXAR,29,1028,291028,278,1407,87,1320,12,18,1294,1296,1058,69,989,12,10,968,969
85,COLLIN,85,0163,850163,1792,4499,1947,2552,1402,519,567,1068,2980,1372,1608,881,328,361,687
439,TARRANT,439,1431,4391431,7978,3402,2285,1117,86,324,619,919,2542,1805,737,65,212,385,591
221,HOOD,221,0409,2210409,5854,6512,5273,1239,163,98,759,845,4899,4101,798,113,64,463,522
113,DALLAS,113,1041,1131041,2024,2400,233,2167,22,1650,481,2107,1770,225,1545,18,1178,332,1494
17,BAILEY,17,0002,170002,132,1754,866,888,9,15,842,852,1307,731,576,6,9,542,549
39,BRAZORIA,39,0058,390058,1171,5473,1822,3651,1184,1676,781,2413,3753,1267,2486,800,1179,491,1638
493,WILSON,493,0311,4930311,9555,3614,2652,962,38,60,784,833,2781,2073,708,22,42,575,613
113,DALLAS,113,4023,1134023,2685,155,61,94,0,68,27,93,141,61,80,0,62,19,80
229,HUDSPETH,229,003N,229003N,5937,240,89,151,1,3,138,138,186,74,112,0,2,103,103
201,HARRIS,201,0655,2010655,4872,7060,3049,4011,1027,938,1947,2820,5188,2330,2858,800,647,1309,1929
29,BEXAR,29,4148,294148,959,270,77,193,4,14,176,188,210,62,148,4,12,135,145
201,HARRIS,201,0572,2010572,4789,7319,2582,4737,672,1939,2128,3968,6301,2382,3919,591,1625,1696,3248
379,RAINS,379,0102,3790102,7451,1088,936,152,21,19,64,81,878,782,96,13,11,34,43
201,HARRIS,201,0680,2010680,4898,262,177,85,21,25,32,57,253,171,82,21,24,30,54
451,TOM GREEN,451,0424,4510424,8702,3675,2027,1648,151,194,1233,1391,2903,1716,1187,114,129,867,990
215,HIDALGO,215,0090,2150090,5642,5706,130,5576,13,36,5505,5512,3924,95,3829,11,13,3781,3787
27,BELL,27,0107,270107,195,1067,565,502,19,81,394,457,804,439,365,12,55,271,324
167,GALVESTON,167,0274,1670274,3876,1078,940,138,18,15,83,92,993,877,116,12,6,76,81
451,TOM GREEN,451,0230,4510230,8685,4892,3018,1874,148,324,1373,1642,3831,2471,1360,103,219,988,1189
215,HIDALGO,215,0133,2150133,5685,353,16,337,8,5,329,329,238,10,228,7,5,221,221
157,FORT BEND,157,4073B,1574073B,3770,0,0,0,0,0,0,0,0,0,0,0,0,0,0
97,COOKE,97,0007,970007,1961,2447,1950,497,15,86,283,362,1853,1550,303,15,29,178,205
107,CROSBY,107,0044,1070044,2004,1403,594,809,17,47,746,775,1060,525,535,11,32,487,512
29,BEXAR,29,4022,294022,833,508,96,412,16,48,350,390,366,76,290,14,25,247,271
91,COMAL,91,0103,910103,1898,4904,3847,1057,129,87,746,821,3832,3096,736,87,62,494,553
113,DALLAS,113,4092,1134092,2748,305,84,221,2,23,191,213,229,72,157,1,21,128,149
161,FREESTONE,161,0009A,1610009A,3813,386,235,151,2,27,114,141,293,187,106,2,16,82,98
11,ARMSTRONG,11,0201,110201,89,343,272,71,6,8,47,51,267,225,42,6,4,21,24
29,BEXAR,29,4128,294128,939,219,87,132,4,18,109,122,194,77,117,4,12,95,107
403,SABINE,403,0006,4030006,7620,2118,1783,335,19,156,89,236,1780,1512,268,16,118,63,180
491,WILLIAMSON,491,0470,4910470,9535,4107,2185,1922,147,321,1375,1638,2934,1693,1241,109,205,852,1034
453,TRAVIS,453,0151A,4530151A,8748,4358,2043,2315,660,686,959,1601,2887,1425,1462,411,463,560,1000
215,HIDALGO,215,0027,2150027,5579,1962,74,1888,8,5,1872,1876,1510,52,1458,7,2,1445,1447
29,BEXAR,29,4085,294085,896,85,42,43,5,5,34,38,68,42,26,1,5,21,25
491,WILLIAMSON,491,0216,4910216,9429,1742,1213,529,157,44,293,331,1335,968,367,122,40,178,214
201,HARRIS,201,0403,2010403,4620,2265,1662,603,173,107,285,388,1668,1279,389,121,60,183,241
113,DALLAS,113,4516,1134516,2811,654,158,496,1,170,328,494,563,149,414,1,169,248,413
21,BASTROP,21,1007,211007,152,2394,1514,880,53,172,602,762,1923,1300,623,40,132,396,527
113,DALLAS,113,1094,1131094,2067,3641,102,3539,18,774,2771,3519,2545,89,2456,13,637,1823,2438
499,WOOD,499,02-1,49902-1,9598,702,575,127,4,29,72,100,560,471,89,3,17,47,64
181,GRAYSON,181,0207,1810207,4002,1302,1037,265,14,21,151,170,1037,853,184,9,14,101,114
29,BEXAR,29,4191,294191,1002,23,1,22,1,16,9,20,13,0,13,1,11,5,11
215,HIDALGO,215,0259,2150259,5811,2528,28,2500,0,4,2495,2496,1678,19,1659,0,0,1656,1656
423,SMITH,423,0077,4230077,7789,1313,673,640,14,299,308,598,1045,607,438,8,209,197,402
157,FORT BEND,157,3053,1573053,3707,100,55,45,16,13,11,23,85,55,30,10,12,8,20
169,GARZA,169,0006,1690006,3939,169,142,27,0,1,24,24,153,137,16,0,0,15,15
3,ANDREWS,3,0004,30004,26,4637,1472,3165,33,107,2978,3052,3252,1133,2119,25,73,1983,2041
215,HIDALGO,215,0196,2150196,5748,1762,660,1102,20,6,1076,1079,1484,650,834,18,5,811,813
323,MAVERICK,323,004D,323004D,6787,6082,53,6029,7,14,6010,6012,4227,33,4194,5,7,4182,4182
29,BEXAR,29,3164,293164,770,2819,1591,1228,151,145,902,1026,2054,1209,845,103,109,603,701
113,DALLAS,113,1308,1131308,2130,5262,954,4308,77,818,3446,4202,3685,827,2858,66,563,2229,2757
113,DALLAS,113,4634,1134634,2874,7709,2735,4974,2251,1491,1160,2598,6528,2489,4039,1779,1221,970,2157
37,BOWIE,37,0007,370007,1065,6117,3542,2575,83,1849,422,2252,4552,2819,1733,67,1247,260,1504
397,ROCKWALL,397,0004B,3970004B,7557,0,0,0,0,0,0,0,0,0,0,0,0,0,0
439,TARRANT,439,1015,4391015,7852,2077,699,1378,68,112,1173,1269,1687,623,1064,60,83,900,976
489,WILLACY,489,0001,4890001,9366,711,60,651,5,3,645,646,512,51,461,4,2,455,456
201,HARRIS,201,0466,2010466,4683,7183,1902,5281,819,1984,2474,4387,5729,1725,4004,687,1540,1752,3249
37,BOWIE,37,009A,37009A,1106,286,241,45,2,12,21,33,236,199,37,1,12,15,27
439,TARRANT,439,2680,4392680,8228,0,0,0,0,0,0,0,0,0,0,0,0,0,0
363,PALO PINTO,363,0003,3630003,7292,1118,978,140,4,3,84,85,999,888,111,4,3,57,58
477,WASHINGTON,477,0115,4770115,9207,1528,804,724,15,229,454,681,1183,694,489,12,173,280,452
175,GOLIAD,175,0011,1750011,3957,1226,442,784,12,94,679,751,940,364,576,7,68,504,557
277,LAMAR,277,003E,277003E,6356,1592,1388,204,7,20,74,92,1238,1100,138,6,11,49,60
439,TARRANT,439,3164,4393164,8271,3752,2130,1622,91,259,1139,1384,2950,1841,1109,68,162,765,921
29,BEXAR,29,3093,293093,697,4053,1989,2064,546,213,1290,1466,3002,1537,1465,353,154,913,1054
85,COLLIN,85,0004,850004,1633,3558,2260,1298,220,507,433,904,2583,1744,839,150,314,268,563
113,DALLAS,113,3029,1133029,2466,1935,36,1899,16,1403,489,1864,1329,31,1298,7,980,309,1279
365,PANOLA,365,0028,3650028,7335,3139,2244,895,30,411,402,805,2470,1829,641,29,301,273,568
141,EL PASO,141,0192,1410192,3505,6929,1034,5895,165,219,5527,5688,4941,840,4101,114,160,3797,3933
439,TARRANT,439,2302,4392302,8125,4720,524,4196,257,2197,1776,3901,3099,400,2699,214,1363,1120,2451
201,HARRIS,201,0078,2010078,4295,3174,257,2917,23,99,2779,2859,2505,244,2261,20,84,2144,2217
29,BEXAR,29,2053,292053,465,1972,226,1746,25,45,1693,1717,1576,207,1369,18,32,1320,1342
471,WALKER,471,0204B,4710204B,9164,889,573,316,6,185,94,271,732,480,252,6,149,69,213
453,TRAVIS,453,0323,4530323,8869,3501,2526,975,558,69,298,359,2461,1878,583,334,30,184,210
29,BEXAR,29,1140,291140,391,2342,443,1899,105,385,1435,1772,1572,355,1217,63,228,913,1133
55,CALDWELL,55,0305,550305,1387,891,475,416,6,33,352,379,678,393,285,5,10,247,256
71,CHAMBERS,71,0002,710002,1553,1016,526,490,11,283,146,426,783,406,377,11,231,96,327
89,COLORADO,89,0101,890101,1885,3912,2026,1886,54,631,1200,1788,2990,1692,1298,35,469,776,1225
113,DALLAS,113,1078,1131078,2051,3757,301,3456,27,1432,2010,3412,2664,262,2402,25,1086,1289,2362
459,UPSHUR,459,0005,4590005,9047,852,638,214,0,74,115,188,634,482,152,0,65,67,131
491,WILLIAMSON,491,0489,4910489,9545,4875,2591,2284,756,488,943,1406,3376,1859,1517,474,338,628,955
201,HARRIS,201,0042,2010042,4258,1422,18,1404,3,966,444,1397,1042,12,1030,1,767,273,1028
201,HARRIS,201,0373,2010373,4590,339,9,330,5,105,220,318,252,8,244,1,90,146,236
201,HARRIS,201,0539,2010539,4756,3439,1090,2349,539,631,1171,1776,2449,826,1623,401,418,786,1193
439,TARRANT,439,4532,4394532,8549,1578,1325,253,36,37,139,167,1321,1139,182,22,22,99,116
439,TARRANT,439,1710,4391710,8051,2833,1297,1536,77,323,1111,1404,2137,1064,1073,62,205,764,959
439,TARRANT,439,3637,4393637,8383,4461,2083,2378,662,719,928,1611,3209,1577,1632,465,451,635,1074
113,DALLAS,113,2905,1132905,2432,521,420,101,43,23,31,54,455,376,79,39,13,22,35
113,DALLAS,113,3327,1133327,2598,11,1,10,0,0,10,10,11,1,10,0,0,10,10
113,DALLAS,113,2503,1132503,2383,3431,2927,504,175,67,184,248,2426,2105,321,125,35,112,144
121,DENTON,121,4171,1214171,3096,713,388,325,58,67,182,241,603,367,236,35,39,145,177
149,FAYETTE,149,0423,1490423,3594,1074,786,288,1,142,140,274,876,671,205,1,102,92,193
187,GUADALUPE,187,0208,1870208,4092,5996,3628,2368,99,215,1970,2147,4520,2925,1595,69,141,1296,1425
29,BEXAR,29,3140,293140,746,57,13,44,1,1,43,43,43,11,32,1,0,31,31
59,CALLAHAN,59,0006,590006,1410,1507,1264,243,15,39,137,172,1185,1016,169,6,23,90,113
73,CHEROKEE,73,0027,730027,1579,1473,894,579,7,286,267,553,1136,724,412,2,224,167,391
85,COLLIN,85,0113,850113,1742,5670,2918,2752,512,850,1290,2097,4251,2383,1868,383,544,855,1380
113,DALLAS,113,2038,1132038,2243,4592,3609,983,290,147,469,594,3886,3078,808,230,122,387,495
113,DALLAS,113,2605,1132605,2406,4750,577,4173,3805,134,203,324,3195,460,2735,2485,94,116,205
249,JIM WELLS,249,0019,2490019,6156,643,219,424,0,8,406,413,452,168,284,0,8,270,277
295,LIPSCOMB,295,0207B,2950207B,6485,10,1,9,0,0,9,9,8,1,7,0,0,7,7
329,MIDLAND,329,0110,3290110,6820,4224,3092,1132,257,64,741,796,3010,2278,732,175,39,457,491
355,NUECES,355,0037,3550037,7152,2212,228,1984,18,75,1891,1947,1657,168,1489,6,55,1419,1464
429,STEPHENS,429,0005,4290005,7816,113,109,4,1,0,0,0,91,90,1,0,0,0,0
491,WILLIAMSON,491,0155,4910155,9402,6409,2494,3915,738,1034,2098,3062,5070,2171,2899,560,759,1504,2235
113,DALLAS,113,32A0,11332A0,2575,0,0,0,0,0,0,0,0,0,0,0,0,0,0
135,ECTOR,135,0313,1350313,3239,2346,1274,1072,20,93,901,983,1775,1025,750,15,52,624,675
201,HARRIS,201,0608,2010608,4825,4893,223,4670,118,50,4503,4534,3195,176,3019,93,33,2892,2919
201,HARRIS,201,0019,2010019,4235,2175,1010,1165,244,436,462,881,1998,952,1046,214,387,420,792
209,HAYS,209,0372,2090372,5489,578,134,444,20,100,319,412,349,87,262,14,48,189,235
217,HILL,217,0010,2170010,5821,3861,2368,1493,33,300,1031,1307,2851,1863,988,20,217,648,852
25,BEE,25,0004,250004,179,861,390,471,6,5,447,452,656,315,341,5,5,321,326
29,BEXAR,29,2098,292098,511,2733,397,2336,55,142,2162,2262,2027,334,1693,39,89,1568,1642
41,BRAZOS,41,0033,410033,1224,4054,1900,2154,325,858,1006,1783,3528,1791,1737,302,593,871,1394
85,COLLIN,85,0136,850136,1765,2776,1715,1061,256,385,372,744,2375,1536,839,204,298,290,582
113,DALLAS,113,4108,1134108,2761,146,0,146,0,36,108,144,88,0,88,0,24,63,87
113,DALLAS,113,2009,1132009,2220,2690,2037,653,73,71,440,506,2005,1544,461,51,48,311,358
477,WASHINGTON,477,0312,4770312,9216,1674,1170,504,17,129,314,437,1298,968,330,13,89,195,280
245,JEFFERSON,245,0102,2450102,6130,3737,856,2881,32,1250,1617,2831,3717,851,2866,32,1246,1606,2820
293,LIMESTONE,293,0102,2930102,6462,834,685,149,7,32,72,100,642,532,110,6,21,49,69
299,LLANO,299,0307,2990307,6511,5326,3914,1412,49,109,1059,1143,4223,3273,950,30,75,679,743
355,NUECES,355,0060,3550060,7175,1953,71,1882,3,52,1820,1864,1457,58,1399,2,28,1359,1385
439,TARRANT,439,2451,4392451,8171,495,135,360,12,203,136,335,351,112,239,11,137,84,220
453,TRAVIS,453,0266,4530266,8835,4322,2622,1700,641,221,755,964,3915,2452,1463,530,193,662,846
113,DALLAS,113,4652,1134652,2884,3233,237,2996,74,73,2847,2910,2222,213,2009,58,53,1893,1942
135,ECTOR,135,0110,1350110,3216,6178,2219,3959,226,427,3238,3613,4052,1621,2431,162,215,1976,2178
141,EL PASO,141,0112,1410112,3425,10357,745,9612,155,441,9126,9440,7588,594,6994,124,293,6616,6841
157,FORT BEND,157,4024,1574024,3757,700,317,383,12,21,339,358,479,240,239,10,14,205,218
201,HARRIS,201,0253,2010253,4470,3522,72,3450,13,2185,1262,3429,2467,62,2405,5,1641,757,2391
209,HAYS,209,0314,2090314,5466,1978,1502,476,30,35,376,405,1693,1347,346,15,14,283,294
27,BELL,27,0201,270201,205,6365,2529,3836,268,1759,1713,3324,4658,2070,2588,191,1200,1059,2199
29,BEXAR,29,4058,294058,869,3182,1410,1772,140,233,1373,1555,2534,1227,1307,108,163,987,1122
29,BEXAR,29,3099,293099,703,5237,1964,3273,943,255,2080,2290,3709,1425,2284,641,166,1464,1609
53,BURNET,53,0018,530018,1367,2564,1571,993,18,43,850,889,2022,1361,661,14,21,547,566
113,DALLAS,113,3614,1133614,2618,1470,102,1368,10,1070,292,1339,1067,91,976,5,801,164,955
121,DENTON,121,4191,1214191,3116,2907,2143,764,18,70,534,593,2225,1690,535,13,36,371,403
491,WILLIAMSON,491,0427,4910427,9525,4147,2339,1808,67,357,1310,1637,3310,2025,1285,43,232,923,1142
309,MCLENNAN,309,0064,3090064,6697,2013,1283,730,42,181,441,613,1568,1074,494,27,118,294,408
355,NUECES,355,0080,3550080,7195,2554,116,2438,19,357,2084,2411,1894,80,1814,11,276,1529,1794
367,PARKER,367,0300,3670300,7361,2563,1987,576,16,104,361,454,2023,1623,400,7,62,247,303
439,TARRANT,439,1034,4391034,7859,4883,3357,1526,99,262,1014,1259,3719,2675,1044,61,191,663,843
453,TRAVIS,453,0311,4530311,8861,5286,2717,2569,1552,241,769,995,4443,2264,2179,1314,191,650,833
485,WICHITA,485,0409,4850409,9359,992,796,196,8,56,104,157,797,660,137,7,42,71,110
139,ELLIS,139,1028,1391028,3282,4284,2338,1946,25,217,1592,1790,3136,1851,1285,21,147,1013,1153
157,FORT BEND,157,4113,1574113,3780,14424,782,13642,4741,5911,3120,8868,10176,594,9582,3629,3825,2191,5912
201,HARRIS,201,1062,2011062,5280,4292,1665,2627,170,124,2309,2398,3238,1425,1813,128,72,1588,1646
201,HARRIS,201,0565,2010565,4782,8509,200,8309,442,1632,6365,7804,5789,133,5656,337,1245,4155,5274
209,HAYS,209,0145,2090145,5446,2476,982,1494,77,312,1118,1378,2098,882,1216,54,252,895,1123
231,HUNT,231,0104,2310104,5944,1489,953,536,11,65,410,471,1155,798,357,10,48,256,304
29,BEXAR,29,4035,294035,846,37,18,19,3,2,14,16,26,15,11,1,2,8,10
51,BURLESON,51,0301,510301,1344,2181,1449,732,19,187,485,660,1716,1188,528,13,131,343,469
61,CAMERON,61,0098,610098,1510,10268,405,9863,114,86,9684,9726,6866,273,6593,82,56,6465,6491
121,DENTON,121,4213,1214213,3139,2096,1434,662,228,134,245,374,1340,929,411,141,90,149,235
201,HARRIS,201,1085,2011085,5303,3421,2616,805,53,95,536,624,2598,2047,551,37,63,355,414
201,HARRIS,201,1079,2011079,5297,5084,246,4838,155,1476,3246,4655,3524,199,3325,139,979,2208,3164
381,RANDALL,381,0112,3810112,7461,7394,4040,3354,95,598,2524,3035,5378,3247,2131,54,344,1573,1896
387,RED RIVER,387,03-1B,38703-1B,7510,83,24,59,2,30,28,57,69,21,48,1,27,20,47
437,SWISHER,437,0003,4370003,7836,1091,617,474,6,59,390,437,856,528,328,5,41,260,298
439,TARRANT,439,1544,4391544,8008,26,5,21,0,0,20,20,23,5,18,0,0,17,17
439,TARRANT,439,1501,4391501,8002,1104,375,729,53,395,285,666,774,294,480,34,258,192,443
491,WILLIAMSON,491,0394,4910394,9502,3051,2860,191,39,24,85,109,3031,2856,175,35,23,77,100
201,HARRIS,201,0416,2010416,4633,7016,2840,4176,548,1443,2134,3488,5541,2434,3107,438,1027,1556,2540
201,HARRIS,201,0913,2010913,5131,724,36,688,75,110,503,607,511,29,482,59,72,351,421
221,HOOD,221,0202,2210202,5844,5823,4625,1198,66,77,800,868,4637,3825,812,43,37,541,573
325,MEDINA,325,003D,325003D,6797,8004,2151,5853,64,676,5075,5718,6387,1820,4567,48,641,3838,4460
363,PALO PINTO,363,0006,3630006,7295,1151,1015,136,17,7,77,80,982,884,98,12,3,50,52
367,PARKER,367,0105,3670105,7338,3129,2524,605,45,23,405,421,2422,2018,404,28,17,265,275
29,BEXAR,29,2164,292164,577,3612,1101,2511,373,357,1763,2089,2999,1001,1998,314,280,1380,1640
41,BRAZOS,41,0053,410053,1244,312,199,113,14,11,73,84,296,194,102,14,10,66,76
91,COMAL,91,0202B,910202B,1908,0,0,0,0,0,0,0,0,0,0,0,0,0,0
113,DALLAS,113,4084,1134084,2741,1496,21,1475,3,230,1250,1466,1090,17,1073,2,183,890,1071
113,DALLAS,113,1104,1131104,2077,7020,281,6739,21,1792,4926,6679,4796,249,4547,13,1287,3225,4502
141,EL PASO,141,0095,1410095,3408,4212,583,3629,76,146,3409,3518,3345,534,2811,61,112,2624,2716
365,PANOLA,365,0001,3650001,7318,2488,1702,786,11,345,370,711,1910,1363,547,11,268,220,486
381,RANDALL,381,0426,3810426,7487,6248,4317,1931,129,291,1348,1588,4630,3451,1179,84,129,806,930
439,TARRANT,439,2379,4392379,8151,6345,1139,5206,1238,2679,1279,3892,4489,899,3590,881,1838,835,2643
439,TARRANT,439,4615,4394615,8569,0,0,0,0,0,0,0,0,0,0,0,0,0,0
479,WEBB,479,0136,4790136,9233,268,10,258,4,4,254,255,200,10,190,3,1,186,187
187,GUADALUPE,187,0114,1870114,4072,1919,905,1014,17,60,907,958,1423,719,704,12,33,632,662
201,HARRIS,201,0936,2010936,5154,368,32,336,10,90,232,317,258,32,226,8,57,162,217
201,HARRIS,201,1105,2011105,5323,579,8,571,2,519,49,567,331,7,324,2,297,24,320
201,HARRIS,201,0273,2010273,4490,2945,2169,776,413,48,243,277,2280,1694,586,329,35,173,200
235,IRION,235,0300,2350300,5987,378,259,119,6,7,110,115,291,210,81,1,2,76,77
309,MCLENNAN,309,0022,3090022,6654,1193,279,914,11,419,474,870,822,245,577,9,254,289,538
1,ANDERSON,1,0015,10015,13,1317,973,344,9,139,163,301,1072,851,221,6,88,103,191
19,BANDERA,19,0101,190101,136,2188,1687,501,24,26,382,407,1807,1429,378,15,24,277,300
29,BEXAR,29,2141,292141,554,1957,497,1460,154,189,1129,1285,1500,405,1095,120,136,833,947
29,BEXAR,29,3073,293073,677,2105,921,1184,209,123,863,969,1727,803,924,160,97,662,749
41,BRAZOS,41,0027,410027,1218,3510,2598,912,53,105,662,753,2716,2109,607,37,57,440,493
113,DALLAS,113,4060,1134060,2718,6995,268,6727,150,1950,4680,6563,4651,226,4425,117,1165,3155,4297
439,TARRANT,439,2305,4392305,8128,2918,1566,1352,235,623,449,1060,2215,1275,940,173,426,295,719
449,TITUS,449,0019,4490019,8669,1670,594,1076,6,175,872,1035,1194,507,687,4,130,529,653
477,WASHINGTON,477,0202,4770202,9210,222,166,56,0,19,25,44,209,153,56,0,19,25,44
489,WILLACY,489,011A,489011A,9382,3407,459,2948,141,398,2410,2794,3144,447,2697,139,391,2166,2549
207,HASKELL,207,0008,2070008,5423,212,157,55,0,0,49,49,176,141,35,0,0,30,30
231,HUNT,231,0426,2310426,5964,966,731,235,3,23,167,188,731,566,165,3,14,108,121
247,JIM HOGG,247,0004,2470004,6136,1280,100,1180,23,4,1141,1142,905,68,837,17,2,810,810
299,LLANO,299,0102,2990102,6505,779,693,86,1,3,58,61,724,658,66,1,3,44,47
309,MCLENNAN,309,0045,3090045,6677,1110,480,630,22,332,268,582,861,422,439,15,233,172,400
355,NUECES,355,0102,3550102,7218,2200,670,1530,22,31,1454,1476,1623,543,1080,17,19,1013,1031
139,ELLIS,139,1005,1391005,3259,5110,3227,1883,116,751,899,1631,3732,2506,1226,81,519,549,1057
141,EL PASO,141,0069,1410069,3382,6883,338,6545,41,124,6384,6463,5461,302,5159,24,83,5035,5096
141,EL PASO,141,0118,1410118,3431,3332,373,2959,70,139,2790,2896,2703,347,2356,55,102,2220,2306
167,GALVESTON,167,0482,1670482,3923,387,241,146,5,13,118,124,284,185,99,3,5,80,84
177,GONZALES,177,0009,1770009,3972,1663,517,1146,11,176,957,1100,1268,435,833,7,125,677,792
201,HARRIS,201,0296,2010296,4513,3044,666,2378,583,173,1616,1771,2425,593,1832,478,130,1208,1327
41,BRAZOS,41,0095,410095,1287,0,0,0,0,0,0,0,0,0,0,0,0,0,0
67,CASS,67,0015,670015,1536,453,394,59,2,38,4,42,358,318,40,1,27,3,30
113,DALLAS,113,4038,1134038,2698,3654,293,3361,31,1106,2243,3316,2696,261,2435,21,908,1518,2408
113,DALLAS,113,3012,1133012,2449,420,11,409,5,212,190,397,272,11,261,4,129,127,254
121,DENTON,121,1023,1211023,2947,3939,2375,1564,939,269,274,528,2638,1684,954,564,183,149,323
131,DUVAL,131,0005,1310005,3196,577,74,503,2,5,453,458,441,70,371,2,2,339,341
343,MORRIS,343,0401,3430401,7026,3156,2158,998,14,607,340,936,2421,1755,666,5,431,191,621
361,ORANGE,361,0020,3610020,7275,2603,2334,269,12,18,170,185,1968,1790,178,8,13,103,113
389,REEVES,389,0011,3890011,7524,1429,73,1356,5,34,1311,1340,1008,57,951,5,21,917,937
423,SMITH,423,0052,4230052,7773,3016,2246,770,47,304,297,598,2279,1758,521,20,233,175,408
491,WILLIAMSON,491,0262,4910262,9445,3536,2302,1234,188,208,751,931,2650,1797,853,126,136,503,629
141,EL PASO,141,0132,1410132,3445,1031,84,947,35,57,873,913,799,70,729,25,46,674,708
157,FORT BEND,157,3016,1573016,3694,5875,1076,4799,3258,774,757,1507,4677,901,3776,2604,575,589,1153
201,HARRIS,201,1148,2011148,5366,2720,163,2557,273,578,1727,2281,1970,139,1831,236,409,1198,1593
215,HIDALGO,215,0063,2150063,5615,1659,122,1537,34,15,1484,1493,1367,111,1256,29,12,1209,1217
223,HOPKINS,223,0013,2230013,5864,1815,1106,709,15,66,562,627,1307,865,442,13,47,333,380
323,MAVERICK,323,002B,323002B,6777,4370,46,4324,9,8,4289,4295,3066,32,3034,7,4,3013,3017
29,BEXAR,29,4121,294121,932,462,205,257,4,19,226,238,362,178,184,2,11,159,166
29,BEXAR,29,1134,291134,385,17,1,16,1,9,16,16,5,1,4,1,2,4,4
29,BEXAR,29,2022,292022,434,2866,113,2753,6,46,2710,2734,2113,94,2019,6,35,1990,2010
61,CAMERON,61,0018,610018,1430,4823,243,4580,15,23,4531,4540,3530,198,3332,14,20,3297,3305
91,COMAL,91,0403,910403,1928,3577,2751,826,55,75,570,634,3083,2433,650,41,58,434,481
113,DALLAS,113,1084,1131084,2057,4830,984,3846,77,1875,1889,3715,3823,871,2952,71,1529,1339,2833
497,WISE,497,0024,4970024,9588,3298,2220,1078,36,59,811,857,2433,1744,689,14,36,489,518
257,KAUFMAN,257,0035,2570035,6256,7991,2737,5254,244,3057,1929,4876,4911,1904,3007,146,1658,1148,2770
281,LAMPASAS,281,0002,2810002,6385,4890,3750,1140,83,97,796,878,3746,3009,737,54,58,492,544
337,MONTAGUE,337,0006,3370006,6883,1489,1168,321,20,25,180,204,1089,904,185,12,4,102,106
369,PARMER,369,0101,3690101,7381,2576,777,1799,10,56,1732,1763,1873,651,1222,7,33,1175,1197
439,TARRANT,439,1089,4391089,7879,2928,145,2783,14,1381,1430,2760,2085,111,1974,10,1103,883,1955
465,VAL VERDE,465,0020,4650020,9090,162,113,49,1,1,41,42,138,97,41,1,1,33,34
113,DALLAS,113,3113,1133113,2555,22,0,22,2,20,3,22,19,0,19,0,19,1,19
121,DENTON,121,3129,1213129,3053,3034,1467,1567,576,402,538,906,2415,1259,1156,425,310,376,666
143,ERATH,143,0034,1430034,3551,1625,1400,225,21,14,117,129,1251,1097,154,12,6,77,81
201,HARRIS,201,0545,2010545,4762,3288,875,2413,698,502,1224,1683,2558,762,1796,538,382,872,1237
201,HARRIS,201,1042,2011042,5260,5089,887,4202,836,1131,2227,3309,3672,688,2984,629,747,1582,2306
215,HIDALGO,215,0206,2150206,5758,2734,135,2599,45,59,2499,2541,1873,109,1764,35,35,1690,1720
27,BELL,27,0406,270406,242,7387,2177,5210,340,2654,2208,4654,5619,1875,3744,291,1869,1486,3265
29,BEXAR,29,4178,294178,989,8,0,8,1,1,4,4,7,0,7,1,1,3,3
37,BOWIE,37,0018,370018,1075,6170,3195,2975,45,1657,1100,2735,5339,2652,2687,35,1487,1029,2505
49,BROWN,49,0204,490204,1324,4256,2087,2169,64,453,1559,1973,3093,1651,1442,38,307,1014,1294
113,DALLAS,113,1098,1131098,2071,4771,221,4550,35,1201,3316,4492,3344,203,3141,26,930,2188,3099
113,DALLAS,113,3984,1133984,2661,2340,1241,1099,159,218,605,817,1784,1003,781,118,147,429,572
453,TRAVIS,453,0354,4530354,8898,4867,3873,994,260,95,520,601,3788,3035,753,194,72,379,443
215,HIDALGO,215,0100,2150100,5652,5449,275,5174,21,27,5136,5142,3867,224,3643,11,16,3621,3627
339,MONTGOMERY,339,0089,3390089,6989,7286,5289,1997,332,271,1165,1416,5178,3866,1312,204,180,750,920
355,NUECES,355,0122,3550122,7238,6052,3110,2942,369,274,2228,2460,4382,2388,1994,285,185,1465,1630
439,TARRANT,439,2007,4392007,8071,2749,1963,786,142,270,316,578,2286,1690,596,106,218,218,435
439,TARRANT,439,3365,4393365,8320,5654,4535,1119,299,167,478,630,4089,3365,724,186,111,315,420
447,THROCKMORTON,447,3003,4473003,8649,383,336,47,2,4,36,40,284,256,28,2,1,21,22
115,DAWSON,115,0012,1150012,2910,124,70,54,1,0,53,53,92,51,41,1,0,40,40
157,FORT BEND,157,3147,1573147,3743,10271,1374,8897,6736,1444,685,2087,6844,967,5877,4496,909,446,1329
181,GRAYSON,181,0106,1810106,3992,5166,3629,1537,59,255,1011,1249,3663,2738,925,36,145,578,715
201,HARRIS,201,0104,2010104,4321,2978,49,2929,17,1697,1216,2893,2194,33,2161,13,1391,750,2135
201,HARRIS,201,0353,2010353,4570,8604,354,8250,258,3072,4998,7960,6236,301,5935,214,2266,3484,5702
203,HARRISON,203,0020,2030020,5403,3955,2557,1398,15,647,625,1255,3083,2063,1020,9,502,406,902
5,ANGELINA,5,0029,50029,56,2177,1840,337,12,59,245,298,1665,1450,215,10,34,156,188
29,BEXAR,29,2181C,292181C,597,254,92,162,11,20,134,150,152,47,105,9,15,85,96
29,BEXAR,29,3079,293079,683,4222,2193,2029,197,269,1511,1752,3609,1961,1648,160,210,1228,1416
85,COLLIN,85,0050,850050,1679,7520,1777,5743,1977,1097,2635,3684,5489,1449,4040,1491,775,1729,2480
113,DALLAS,113,2120,1132120,2306,6456,1186,5270,608,2859,1780,4582,4862,1058,3804,441,2129,1207,3304
139,ELLIS,139,1048,1391048,3302,2838,1613,1225,44,383,732,1095,2164,1322,842,32,269,486,749
485,WICHITA,485,0210,4850210,9339,865,366,499,18,158,297,450,653,295,358,16,111,204,313
309,MCLENNAN,309,0002,3090002,6634,1403,339,1064,24,495,530,1000,1046,314,732,17,299,383,676
405,SAN AUGUSTINE,405,0008,4050008,7630,892,827,65,6,14,33,47,737,686,51,3,12,23,35
421,SHERMAN,421,0102,4210102,7716,554,171,383,6,19,354,365,390,142,248,4,11,227,234
439,TARRANT,439,3041,4393041,8257,8156,3963,4193,441,1255,2309,3488,6173,3272,2901,335,831,1553,2346
453,TRAVIS,453,0106,4530106,8712,4211,2496,1715,603,250,822,1044,3201,1974,1227,397,174,617,767
479,WEBB,479,0251,4790251,9253,1680,216,1464,18,4,1446,1449,1290,204,1086,12,2,1076,1078
141,EL PASO,141,0075,1410075,3388,2192,287,1905,20,32,1862,1875,1803,257,1546,17,21,1511,1524
167,GALVESTON,167,2323,1672323,3929,507,409,98,10,8,69,74,473,388,85,8,8,57,62
201,HARRIS,201,0167,2010167,4384,93,4,89,2,13,78,89,72,4,68,0,7,63,68
201,HARRIS,201,0793,2010793,5011,8417,1467,6950,158,727,6051,6685,5923,1307,4616,108,432,4040,4419
201,HARRIS,201,0707,2010707,4925,1354,631,723,170,100,445,534,1120,567,553,132,76,341,406
241,JASPER,241,0004,2410004,6007,801,753,48,6,8,16,23,701,666,35,2,3,11,14
27,BELL,27,0111,270111,199,5321,2692,2629,283,950,1316,2204,4017,2176,1841,201,699,855,1523
29,BEXAR,29,2036,292036,448,1917,1120,797,63,45,668,706,1624,978,646,51,39,537,570
85,COLLIN,85,0236,850236,1865,3900,2669,1231,449,290,392,664,2841,1985,856,301,218,256,461
113,DALLAS,113,1165,1131165,2114,2750,2366,384,122,26,157,181,1872,1665,207,51,19,94,112
113,DALLAS,113,1173,1131173,2120,1257,1042,215,46,32,114,141,1004,860,144,29,20,72,90
113,DALLAS,113,2313,1132313,2363,0,0,0,0,0,0,0,0,0,0,0,0,0,0
441,TAYLOR,441,0107,4410107,8606,1217,833,384,7,44,282,319,935,670,265,7,29,185,210
453,TRAVIS,453,0303,4530303,8855,623,475,148,60,21,62,83,604,458,146,60,21,60,81
291,LIBERTY,291,0004,2910004,6442,796,532,264,9,55,167,218,588,415,173,6,38,99,136
291,LIBERTY,291,0011,2910011,6448,889,520,369,3,267,76,337,707,407,300,3,229,50,277
309,MCLENNAN,309,0058,3090058,6691,6844,2902,3942,69,1760,2041,3705,5020,2448,2572,53,1139,1274,2376
439,TARRANT,439,3527,4393527,8357,3522,2588,934,160,184,486,651,2745,2062,683,112,123,340,457
439,TARRANT,439,3545,4393545,8363,3280,2352,928,479,118,247,364,2392,1806,586,289,73,148,220
441,TAYLOR,441,0203,4410203,8612,8353,3737,4616,139,1540,2905,4303,6325,3186,3139,97,982,1933,2888
113,DALLAS,113,3608,1133608,2612,4464,150,4314,65,3770,517,4225,3285,131,3154,52,2787,326,3088
183,GREGG,183,0002,1830002,4029,5715,3935,1780,151,1038,496,1511,4657,3364,1293,116,793,306,1090
201,HARRIS,201,0061,2010061,4278,4465,291,4174,60,202,3947,4109,3188,252,2936,38,149,2762,2893
201,HARRIS,201,0067,2010067,4284,10537,448,10089,88,1041,9055,9966,7582,387,7195,64,731,6447,7105
201,HARRIS,201,0310,2010310,4527,2236,1074,1162,215,169,767,919,1949,993,956,196,132,617,738
251,JOHNSON,251,0034,2510034,6193,4000,3051,949,60,116,574,679,3015,2411,604,27,66,365,427
29,BEXAR,29,1098,291098,348,1543,82,1461,24,26,1412,1428,1195,75,1120,19,18,1077,1093
61,CAMERON,61,0061,610061,1473,3894,327,3567,64,36,3461,3488,2975,282,2693,58,23,2603,2624
97,COOKE,97,0033,970033,1971,630,548,82,7,4,46,50,517,468,49,5,2,24,26
111,DALLAM,111,0005,1110005,2014,40,38,2,0,2,1,2,36,36,0,0,0,0,0
113,DALLAS,113,3075,1133075,2512,333,26,307,3,135,175,300,254,22,232,1,121,107,226
157,FORT BEND,157,1149,1571149,3637,6613,5185,1428,222,333,707,1023,4991,3986,1005,159,247,487,719
329,MIDLAND,329,0401,3290401,6840,2219,1302,917,32,61,766,810,1566,1011,555,16,22,459,478
439,TARRANT,439,4137,4394137,8463,1865,1547,318,44,50,189,229,1487,1263,224,26,31,134,164
439,TARRANT,439,1404,4391404,7965,5604,1355,4249,784,2349,1066,3340,4796,1261,3535,647,1922,883,2768
439,TARRANT,439,4338,4394338,8506,4741,2173,2568,406,644,1424,2023,3398,1663,1735,283,435,943,1361
453,TRAVIS,453,0491A,4530491A,9004,8907,1561,7346,187,1681,5484,7034,6315,1306,5009,140,1225,3617,4775
187,GUADALUPE,187,0413,1870413,4135,1018,739,279,9,59,176,229,813,609,204,7,39,119,158
193,HAMILTON,193,0007,1930007,4178,2186,1743,443,15,13,323,336,1715,1389,326,14,8,220,228
201,HARRIS,201,0459,2010459,4676,4995,3726,1269,287,206,647,839,3712,2876,836,169,137,424,552
215,HIDALGO,215,0249,2150249,5801,806,55,751,4,5,738,740,605,44,561,2,3,552,552
265,KERR,265,0308,2650308,6299,1523,714,809,12,10,747,755,1175,637,538,3,3,500,502
275,KNOX,275,0202,2750202,6342,545,263,282,3,46,214,260,379,208,171,1,28,126,154
29,BEXAR,29,2078,292078,491,4382,826,3556,93,252,3188,3403,3249,686,2563,71,189,2272,2443
29,BEXAR,29,3136,293136,740,2648,730,1918,125,289,1524,1760,2065,627,1438,99,216,1112,1300
73,CHEROKEE,73,0015,730015,1573,6835,2980,3855,100,1152,2484,3605,4932,2468,2464,75,743,1549,2285
85,COLLIN,85,0193,850193,1822,1903,1275,628,55,52,422,472,1425,1026,399,30,27,265,290
113,DALLAS,113,3970,1133970,2655,4089,2332,1757,366,525,759,1256,3306,1986,1320,304,385,546,911
115,DAWSON,115,0001,1150001,2904,3804,1025,2779,11,699,2049,2729,3186,901,2285,10,664,1588,2243
453,TRAVIS,453,0361,4530361,8904,2113,1509,604,103,47,389,432,1713,1280,433,66,30,273,300
469,VICTORIA,469,0027,4690027,9147,2384,1876,508,16,29,401,426,1733,1402,331,7,19,249,264
491,WILLIAMSON,491,0145,4910145,9396,5365,1990,3375,358,770,2254,2942,3956,1586,2370,260,504,1572,2039
315,MARION,315,0007,3150007,6740,1168,531,637,23,560,31,586,935,457,478,14,418,23,439
339,MONTGOMERY,339,0083,3390083,6983,2623,1774,849,35,55,703,749,2001,1436,565,19,38,452,488
355,NUECES,355,0116,3550116,7232,7233,2033,5200,244,508,4445,4874,5634,1718,3916,198,363,3320,3649
431,STERLING,431,0002D,4310002D,7822,37,12,25,0,0,25,25,24,8,16,0,0,16,16
439,TARRANT,439,3335,4393335,8314,3227,2042,1185,200,297,599,875,2554,1727,827,135,182,429,603
439,TARRANT,439,1752,4391752,8065,0,0,0,0,0,0,0,0,0,0,0,0,0,0
157,FORT BEND,157,3131B,1573131B,3737,0,0,0,0,0,0,0,0,0,0,0,0,0,0
179,GRAY,179,0007,1790007,3986,4788,2401,2387,37,290,1911,2175,3549,1987,1562,29,207,1201,1396
201,HARRIS,201,0850,2010850,5068,293,63,230,18,59,155,208,224,52,172,17,39,115,152
201,HARRIS,201,0602,2010602,4819,2336,1132,1204,479,293,390,658,1744,881,863,341,203,277,473
227,HOWARD,227,0014,2270014,5901,460,144,316,3,29,283,308,364,115,249,3,21,220,241
249,JIM WELLS,249,0013,2490013,6150,769,23,746,7,5,731,736,595,20,575,3,3,564,567
13,ATASCOSA,13,0005,130005,99,3398,627,2771,13,58,2667,2706,2403,502,1901,8,41,1823,1853
29,BEXAR,29,3036,293036,640,7354,2168,5186,1225,687,3329,3886,5726,1819,3907,889,478,2527,2937
39,BRAZORIA,39,0068,390068,1181,4347,571,3776,418,1576,1768,3317,3013,449,2564,321,1051,1179,2217
85,COLLIN,85,0093,850093,1722,403,338,65,5,5,45,49,315,274,41,1,4,28,31
113,DALLAS,113,2058,1132058,2263,1766,905,861,122,267,460,711,1411,753,658,95,215,334,539
113,DALLAS,113,4509,1134509,2804,3381,815,2566,98,205,2230,2414,2496,699,1797,82,132,1542,1662
303,LUBBOCK,303,0114,3030114,6591,1383,332,1051,44,160,838,971,1010,278,732,30,94,583,673
355,NUECES,355,0017,3550017,7132,5664,1505,4159,297,379,3452,3769,4562,1308,3254,260,278,2661,2911
411,SAN SABA,411,003A,411003A,7673,666,541,125,8,8,90,98,548,460,88,6,8,60,68
439,TARRANT,439,2635,4392635,8214,3188,639,2549,560,1270,735,1965,2293,485,1808,433,901,475,1349
453,TRAVIS,453,0156,4530156,8755,4698,1867,2831,517,879,1405,2209,3314,1419,1895,364,580,920,1463
479,WEBB,479,0446,4790446,9296,6622,204,6418,30,17,6373,6383,4919,135,4784,20,12,4751,4760
141,EL PASO,141,0032,1410032,3345,2807,510,2297,107,80,2121,2178,2322,461,1861,77,67,1703,1758
167,GALVESTON,167,0355,1670355,3886,4602,2622,1980,220,417,1278,1652,3480,2090,1390,162,296,871,1149
201,HARRIS,201,0210,2010210,4427,4301,1126,3175,517,2002,673,2637,3781,1058,2723,469,1702,559,2239
201,HARRIS,201,0750,2010750,4968,2908,717,2191,133,422,1619,1985,2077,596,1481,107,264,1075,1324
209,HAYS,209,0446,2090446,5509,3327,2517,810,187,86,454,532,2252,1757,495,126,52,257,307
245,JEFFERSON,245,0022,2450022,6050,4371,1350,3021,122,2170,710,2826,3238,1163,2075,66,1516,450,1939
29,BEXAR,29,4138,294138,949,0,0,0,0,0,0,0,0,0,0,0,0,0,0
29,BEXAR,29,1035,291035,285,9990,5591,4399,504,2322,1678,3730,9174,5171,4003,436,2166,1519,3427
29,BEXAR,29,3013,293013,617,2826,1021,1805,122,142,1521,1634,2322,913,1409,96,101,1181,1268
41,BRAZOS,41,0090,410090,1281,27,13,14,0,3,7,10,18,9,9,0,3,2,5
77,CLAY,77,0027,770027,1613,648,523,125,3,19,46,61,497,411,86,3,12,27,37
133,EASTLAND,133,0002,1330002,3202,522,432,90,3,6,72,76,426,363,63,0,3,50,53
467,VAN ZANDT,467,001E,467001E,9107,1452,1082,370,14,120,201,320,1048,819,229,10,72,121,193
491,WILLIAMSON,491,0255,4910255,9439,4374,2814,1560,213,324,936,1226,3021,2034,987,134,186,576,747
213,HENDERSON,213,0004,2130004,5526,2473,1786,687,41,163,419,572,1929,1480,449,30,112,270,377
377,PRESIDIO,377,0005,3770005,7447,1437,46,1391,14,4,1367,1370,1046,39,1007,13,2,987,989
423,SMITH,423,0058,4230058,7779,5546,3834,1712,339,761,479,1211,4413,3128,1285,262,546,354,892
439,TARRANT,439,4096,4394096,8443,1420,956,464,62,57,306,361,1143,778,365,48,35,239,273
439,TARRANT,439,2235,4392235,8111,8615,1414,7201,605,1745,4828,6477,6107,1178,4929,499,1152,3234,4333
453,TRAVIS,453,0184,4530184,8775,5358,1328,4030,1145,1090,1783,2803,3977,1113,2864,883,700,1239,1908
141,EL PASO,141,0219,1410219,3534,2192,37,2155,3,21,2097,2108,1650,31,1619,1,17,1579,1587
167,GALVESTON,167,0216,1670216,3866,5172,1142,4030,91,857,3085,3869,3851,976,2875,54,611,2178,2750
199,HARDIN,199,0001,1990001,4198,2355,1629,726,40,473,138,606,1797,1271,526,25,352,92,442
201,HARRIS,201,0976,2010976,5194,2547,406,2141,62,262,1834,2067,1752,345,1407,42,199,1172,1347
201,HARRIS,201,0645,2010645,4862,6920,1592,5328,1031,2524,1763,4206,5490,1345,4145,796,1974,1349,3271
201,HARRIS,201,0313,2010313,4530,112,10,102,8,17,81,93,84,10,74,8,11,57,65
29,BEXAR,29,1012,291012,262,4222,482,3740,90,296,3407,3632,3115,417,2698,63,216,2418,2604
29,BEXAR,29,2180B,292180B,594,118,25,93,15,14,72,80,82,13,69,11,11,52,58
201,HARRIS,201,0999,2010999,5217,0,0,0,0,0,0,0,0,0,0,0,0,0,0
201,HARRIS,201,0336,2010336,4553,9885,710,9175,894,5777,2616,8208,7213,605,6608,727,4147,1769,5823
201,HARRIS,201,0005,2010005,4221,2016,1421,595,82,38,450,479,1744,1273,471,60,31,348,374
201,HARRIS,201,0668,2010668,4885,8323,3411,4912,1182,1304,2355,3564,6496,2872,3624,882,963,1696,2602
375,POTTER,375,0126,3750126,7424,5704,2744,2960,659,743,1367,2017,4187,2274,1913,388,440,868,1283
423,SMITH,423,0035,4230035,7756,4170,1547,2623,108,1868,615,2461,3238,1394,1844,92,1331,384,1703
439,TARRANT,439,4042,4394042,8420,3466,1038,2428,359,206,1817,1999,2499,865,1634,293,110,1191,1286
439,TARRANT,439,2148,4392148,8088,8712,1268,7444,355,1679,5416,7010,6220,1110,5110,303,1239,3549,4758
453,TRAVIS,453,0154A,4530154A,8752,5155,2686,2469,593,762,1030,1735,3480,1919,1561,351,503,614,1092
465,VAL VERDE,465,0011,4650011,9084,3456,134,3322,3,35,3291,3309,2530,102,2428,3,26,2402,2418
213,HENDERSON,213,2GBS,2132GBS,5549,3747,3132,615,25,74,397,466,3004,2574,430,23,54,250,300
225,HOUSTON,225,0005,2250005,5881,1881,1544,337,24,173,94,264,1513,1267,246,16,130,66,193
255,KARNES,255,0007,2550007,6213,787,585,202,0,8,173,180,575,442,133,0,2,113,115
303,LUBBOCK,303,0031,3030031,6545,2497,1653,844,36,42,706,737,1915,1317,598,21,26,485,506
321,MATAGORDA,321,0009,3210009,6760,183,99,84,1,42,36,77,142,82,60,1,36,20,56
351,NEWTON,351,0009,3510009,7092,268,193,75,2,68,0,68,227,157,70,2,64,0,64
85,COLLIN,85,0199,850199,1828,3775,2777,998,326,286,286,564,2373,1790,583,195,171,152,322
113,DALLAS,113,3055,1133055,2492,2479,209,2270,19,1842,418,2236,2041,189,1852,12,1580,258,1827
113,DALLAS,113,4531,1134531,2824,1276,343,933,21,92,833,903,899,282,617,14,54,555,599
113,DALLAS,113,1702,1131702,2160,6252,1290,4962,1068,704,3155,3816,4652,1125,3527,846,516,2104,2595
121,DENTON,121,9202,1219202,3156,0,0,0,0,0,0,0,0,0,0,0,0,0,0
141,EL PASO,141,0175,1410175,3488,447,36,411,2,14,400,411,344,36,308,0,9,299,308
161,FREESTONE,161,0013,1610013,3820,1028,848,180,9,105,56,158,849,703,146,9,89,38,126
189,HALE,189,0213,1890213,4152,696,216,480,7,23,430,446,477,172,305,6,10,268,276
453,TRAVIS,453,0247,4530247,8821,4008,1505,2503,587,574,1335,1854,3423,1405,2018,486,476,1021,1464
469,VICTORIA,469,0033,4690033,9153,6503,3955,2548,242,373,1909,2203,5006,3298,1708,182,229,1240,1447
491,WILLIAMSON,491,0345,4910345,9485,1233,927,306,64,58,169,221,1001,784,217,47,36,119,152
113,DALLAS,113,4607,1134607,2847,5573,807,4766,178,209,4352,4531,4012,685,3327,152,154,2999,3135
113,DALLAS,113,3078,1133078,2515,4922,431,4491,89,2454,1984,4378,3567,385,3182,67,1794,1327,3099
125,DICKENS,125,0006,1250006,3179,326,264,62,0,2,54,56,258,216,42,0,0,37,37
141,EL PASO,141,0198,1410198,3511,6524,651,5873,114,465,5358,5694,4145,466,3679,65,240,3361,3564
167,GALVESTON,167,0148,1670148,3843,6353,3035,3318,75,862,2287,3069,4786,2530,2256,51,557,1536,2070
193,HAMILTON,193,0001,1930001,4175,1490,1245,245,6,12,197,209,1179,1015,164,3,11,122,133
491,WILLIAMSON,491,0307,4910307,9462,956,811,145,24,18,86,95,806,713,93,12,8,51,58
201,HARRIS,201,0290,2010290,4507,1841,1239,602,33,86,424,493,1505,1064,441,26,60,307,355
201,HARRIS,201,0622,2010622,4839,8455,2228,6227,1360,833,4025,4799,6443,1874,4569,1126,583,2812,3361
439,TARRANT,439,4144,4394144,8466,2585,1514,1071,86,178,725,880,2056,1306,750,64,113,494,603
439,TARRANT,439,2313,4392313,8134,3006,2018,988,167,297,475,759,2384,1673,711,132,230,308,530
453,TRAVIS,453,0220,4530220,8798,3187,2565,622,148,65,338,383,2341,1951,390,93,40,221,250
469,VICTORIA,469,0010,4690010,9130,1993,957,1036,76,187,769,938,1555,827,728,57,128,535,660
15,AUSTIN,15,0101,150101,116,2253,1321,932,21,277,616,881,1677,1047,630,17,188,405,591
29,BEXAR,29,2042,292042,454,3268,147,3121,27,222,2912,3088,2246,105,2141,22,117,2010,2115
39,BRAZORIA,39,0005,390005,1118,3574,1895,1679,22,262,1310,1551,2713,1517,1196,15,213,909,1111
85,COLLIN,85,0153,850153,1782,7377,3672,3705,1778,1025,760,1763,5116,2619,2497,1177,696,522,1212
113,DALLAS,113,3009,1133009,2446,0,0,0,0,0,0,0,0,0,0,0,0,0,0
113,DALLAS,113,2403,1132403,2369,40,7,33,10,8,18,24,20,3,17,6,5,8,11
453,TRAVIS,453,0404,4530404,8944,1110,105,1005,11,392,614,995,674,74,600,6,224,378,593
501,YOAKUM,501,0101,5010101,9608,1917,612,1305,9,23,1258,1277,1403,514,889,5,15,854,869
263,KENT,263,0101,2630101,6282,283,259,24,2,2,20,21,227,205,22,1,1,19,20
277,LAMAR,277,003I,277003I,6359,1960,1669,291,6,46,110,156,1540,1358,182,5,29,73,102
339,MONTGOMERY,339,0048,3390048,6946,3140,2395,745,233,61,394,448,2577,2070,507,150,43,264,307
401,RUSK,401,0404,4010404,7610,2350,1664,686,25,265,364,619,1826,1356,470,20,203,228,422
439,TARRANT,439,3176,4393176,8274,6482,3415,3067,276,966,1640,2565,5050,2930,2120,198,668,1078,1729
439,TARRANT,439,3193,4393193,8280,4009,3092,917,388,121,309,416,3132,2478,654,281,90,203,287
121,DENTON,121,2109,1212109,3033,6245,2109,4136,1310,842,1921,2703,4923,1828,3095,1052,580,1368,1927
157,FORT BEND,157,3027,1573027,3697,35,5,30,1,21,6,27,31,5,26,0,21,5,26
201,HARRIS,201,0144,2010144,4361,1616,33,1583,37,1038,539,1542,1217,27,1190,19,832,336,1159
201,HARRIS,201,0150,2010150,4367,3059,39,3020,4,2042,992,3010,2089,34,2055,4,1406,654,2046
201,HARRIS,201,0813,2010813,5031,9086,1796,7290,796,1797,4703,6368,6432,1415,5017,592,1193,3200,4327
215,HIDALGO,215,0143,2150143,5695,6200,340,5860,187,84,5601,5658,4115,249,3866,133,55,3688,3730
19,BANDERA,19,0204,190204,139,2316,1672,644,28,27,505,529,1944,1452,492,20,17,380,396
29,BEXAR,29,3197,293197,803,0,0,0,0,0,0,0,0,0,0,0,0,0,0
39,BRAZORIA,39,0028,390028,1141,6216,2634,3582,1015,740,1763,2476,4349,1955,2394,695,508,1134,1629
85,COLLIN,85,0053,850053,1682,2790,1981,809,196,138,387,516,2237,1668,569,146,78,263,338
85,COLLIN,85,0176,850176,1805,7726,3614,4112,1741,1163,1073,2178,6831,3371,3460,1460,962,883,1815
113,DALLAS,113,3032,1133032,2469,3209,332,2877,28,547,2308,2808,2402,315,2087,14,430,1623,2037
507,ZAVALA,507,0003,5070003,9631,2512,64,2448,5,39,2405,2428,1839,35,1804,5,22,1779,1794
201,HARRIS,201,0127,2010127,4344,4354,2732,1622,87,495,952,1416,3521,2361,1160,63,346,669,1000
215,HIDALGO,215,0120,2150120,5672,4503,203,4300,3,12,4278,4282,3046,168,2878,0,3,2865,2866
405,SAN AUGUSTINE,405,0011,4050011,7633,591,33,558,6,522,32,553,435,27,408,5,383,21,403
439,TARRANT,439,3283,4393283,8297,2166,1514,652,168,80,351,417,1762,1305,457,130,55,230,277
453,TRAVIS,453,0426,4530426,8961,4192,1537,2655,164,596,1881,2413,3397,1451,1946,146,410,1347,1722
505,ZAPATA,505,0004,5050004,9625,3512,79,3433,10,12,3415,3420,2346,59,2287,5,11,2274,2279
113,DALLAS,113,2222,1132222,2346,3969,3401,568,235,37,180,206,2577,2254,323,130,19,93,104
121,DENTON,121,4207,1214207,3133,1712,1386,326,34,16,240,248,1324,1116,208,28,8,145,148
121,DENTON,121,2086,1212086,3010,4196,2441,1755,388,415,849,1238,3294,2039,1255,294,282,595,860
157,FORT BEND,157,2115,1572115,3680,2866,403,2463,152,1523,814,2285,2170,366,1804,112,1131,562,1668
157,FORT BEND,157,2091,1572091,3674,1018,257,761,34,458,271,709,765,225,540,27,333,175,504
201,HARRIS,201,0790,2010790,5008,7350,1264,6086,731,1784,3646,5278,5094,984,4110,537,1187,2417,3505
21,BASTROP,21,3017,213017,162,4301,2359,1942,47,441,1358,1765,3340,1997,1343,31,338,881,1208
401,RUSK,401,0315,4010315,7605,1269,1028,241,1,63,144,206,988,819,169,1,51,83,134
99,CORYELL,99,0414,990414,1986,539,475,64,2,7,33,38,402,362,40,0,4,21,24
121,DENTON,121,1058,1211058,2982,4796,2560,2236,212,747,1146,1848,3713,2140,1573,161,502,776,1260
201,HARRIS,201,0768,2010768,4986,3719,2482,1237,167,253,724,962,2776,1949,827,124,172,470,633
233,HUTCHINSON,233,0033,2330033,5982,2807,1538,1269,24,144,993,1097,2099,1251,848,14,81,656,726
245,JEFFERSON,245,0040,2450040,6068,4584,3524,1060,114,107,701,797,3441,2768,673,83,59,431,483
261,KENEDY,261,0002,2610002,6277,74,17,57,0,1,57,57,55,13,42,0,0,42,42
27,BELL,27,0213,270213,217,5215,4292,923,89,109,592,679,4025,3407,618,58,69,369,434
29,BEXAR,29,2054,292054,466,2957,748,2209,68,114,2008,2104,2465,693,1772,56,83,1616,1682
69,CASTRO,69,0408,690408,1551,792,695,97,5,6,83,85,566,507,59,5,3,48,50
85,COLLIN,85,0171,850171,1800,4122,1604,2518,1626,449,408,825,3098,1343,1755,1095,311,302,602
113,DALLAS,113,4644,1134644,2879,58,14,44,14,26,4,27,40,13,27,7,19,1,20
121,DENTON,121,4203,1214203,3128,4759,3511,1248,449,209,447,646,3307,2542,765,302,127,251,371
309,MCLENNAN,309,0076,3090076,6709,3857,2816,1041,44,105,749,837,2999,2278,721,31,64,497,559
379,RAINS,379,0407,3790407,7456,1524,1334,190,13,29,97,123,1209,1079,130,12,17,57,72
439,TARRANT,439,1674,4391674,8043,0,0,0,0,0,0,0,0,0,0,0,0,0,0
439,TARRANT,439,3248,4393248,8292,5125,3990,1135,352,182,457,627,4004,3203,801,244,137,310,439
489,WILLACY,489,0006,4890006,9371,665,58,607,9,16,599,602,494,48,446,9,10,438,441
503,YOUNG,503,0023,5030023,9620,3549,2489,1060,39,121,806,918,2709,2017,692,22,81,506,584
141,EL PASO,141,0153,1410153,3466,3860,105,3755,27,57,3687,3722,3097,80,3017,15,36,2968,2994
157,FORT BEND,157,3079,1573079,3715,670,241,429,381,7,35,42,493,176,317,287,7,20,27
201,HARRIS,201,0825,2010825,5043,5495,1406,4089,227,1250,2632,3810,3766,1040,2726,172,877,1660,2507
201,HARRIS,201,0577,2010577,4794,3368,1614,1754,532,114,1098,1188,2418,1191,1227,363,73,771,834
201,HARRIS,201,1163,2011163,5381,0,0,0,0,0,0,0,0,0,0,0,0,0,0
245,JEFFERSON,245,0100,2450100,6128,4277,2071,2206,882,930,348,1268,3304,1712,1592,628,693,227,918
29,BEXAR,29,4053,294053,864,3931,1096,2835,252,643,1990,2548,2976,949,2027,185,467,1366,1793
39,BRAZORIA,39,0040,390040,1153,3637,1912,1725,65,172,1388,1542,2831,1618,1213,47,119,962,1071
113,DALLAS,113,3050,1133050,2487,4062,101,3961,10,1632,2378,3941,2845,79,2766,1,1303,1498,2757
113,DALLAS,113,1734,1131734,2192,2235,1017,1218,281,324,582,896,1867,915,952,224,264,427,689
121,DENTON,121,2104,1212104,3028,6226,2179,4047,607,584,2801,3339,4883,1898,2985,493,416,1998,2394
161,FREESTONE,161,0009C,1610009C,3815,16,10,6,0,1,5,6,8,6,2,0,0,2,2
367,PARKER,367,0245,3670245,7356,1992,1507,485,19,22,367,388,1579,1244,335,8,12,249,261
439,TARRANT,439,2349,4392349,8143,2692,605,2087,635,842,587,1408,1999,500,1499,465,593,414,996
451,TOM GREEN,451,0228,4510228,8684,4899,3084,1815,160,319,1257,1527,4005,2631,1374,109,253,935,1151
453,TRAVIS,453,0451,4530451,8979,2797,1200,1597,187,222,1175,1365,2350,1069,1281,155,177,924,1081
455,TRINITY,455,0018,4550018,9022,140,47,93,1,74,14,88,117,34,83,0,66,13,79
189,HALE,189,0214,1890214,4153,1154,380,774,12,18,741,752,867,311,556,9,10,532,539
201,HARRIS,201,0139,2010139,4356,5786,3712,2074,813,368,817,1162,5274,3482,1792,677,321,709,1017
201,HARRIS,201,0477,2010477,4694,8819,3963,4856,1254,1215,2277,3423,6400,3101,3299,871,809,1503,2272
209,HAYS,209,0339,2090339,5481,1460,1126,334,16,9,249,257,1228,966,262,12,7,188,195
241,JASPER,241,0020,2410020,6022,1905,725,1180,17,970,162,1130,1525,597,928,12,763,127,888
329,MIDLAND,329,0107,3290107,6815,5268,2823,2445,339,501,1479,1948,4070,2373,1697,215,341,1035,1363
113,DALLAS,113,1128,1131128,2092,773,662,111,12,22,57,78,622,542,80,9,14,35,49
121,DENTON,121,1001,1211001,2925,2463,1791,672,25,77,478,554,1837,1410,427,14,47,296,342
125,DICKENS,125,0001,1250001,3174,134,90,44,2,4,40,40,100,70,30,2,4,26,26
141,EL PASO,141,0107,1410107,3420,3146,360,2786,33,120,2648,2749,2519,326,2193,27,104,2066,2158
181,GRAYSON,181,0302,1810302,4007,6807,3575,3232,106,1038,1862,2837,5250,3066,2184,83,744,1157,1882
201,HARRIS,201,1117,2011117,5335,4524,1875,2649,212,901,1489,2344,3270,1461,1809,150,609,985,1579
439,TARRANT,439,3409,4393409,8335,201,50,151,6,11,130,140,144,45,99,2,6,85,90
453,TRAVIS,453,0261,4530261,8830,3288,1996,1292,239,301,708,992,2773,1732,1041,180,246,563,802
491,WILLIAMSON,491,0192,4910192,9417,919,401,518,78,165,258,411,733,335,398,64,120,203,316
201,HARRIS,201,0871,2010871,5089,90,42,48,0,14,36,48,71,33,38,0,10,28,38
201,HARRIS,201,0285,2010285,4502,5334,148,5186,38,1979,3188,5126,3985,121,3864,28,1627,2215,3818
201,HARRIS,201,0037,2010037,4253,3626,2371,1255,407,203,587,772,3295,2233,1062,335,171,499,655
287,LEE,287,0302,2870302,6417,1749,1370,379,8,126,159,282,1331,1084,247,3,84,88,171
387,RED RIVER,387,0011B,3870011B,7502,0,0,0,0,0,0,0,0,0,0,0,0,0,0
439,TARRANT,439,4687,4394687,8584,717,147,570,3,11,557,563,514,114,400,2,3,392,394
113,DALLAS,113,4129,1134129,2779,2108,1906,202,58,15,99,112,1636,1486,150,44,7,67,74
113,DALLAS,113,2031,1132031,2238,6644,3704,2940,911,828,1133,1898,6023,3489,2534,807,686,960,1613
141,EL PASO,141,0007,1410007,3320,4153,1053,3100,92,96,2915,2989,3244,913,2331,58,66,2201,2257
145,FALLS,145,0303,1450303,3566,533,476,57,0,11,43,54,442,401,41,0,10,28,38
167,GALVESTON,167,0204,1670204,3861,1320,1049,271,11,20,194,207,1168,966,202,10,16,138,151
187,GUADALUPE,187,0223,1870223,4107,479,235,244,3,28,210,229,372,198,174,2,18,154,168
453,TRAVIS,453,0130,4530130,8730,10378,1918,8460,405,1416,6659,7948,7936,1776,6160,313,1133,4700,5751
453,TRAVIS,453,0448,4530448,8976,4794,1863,2931,181,554,2169,2662,4044,1709,2335,165,414,1708,2082
479,WEBB,479,0341,4790341,9271,2287,142,2145,39,14,2097,2101,1795,120,1675,34,8,1634,1638
491,WILLIAMSON,491,0418,4910418,9517,21,7,14,2,0,12,12,15,7,8,1,0,7,7
201,HARRIS,201,0185,2010185,4402,4525,357,4168,137,442,3603,4015,3361,320,3041,118,374,2550,2908
201,HARRIS,201,0431,2010431,4648,22307,1213,21094,1930,4456,14800,18990,15519,975,14544,1309,3207,10085,13116
201,HARRIS,201,0971,2010971,5189,904,221,683,40,113,523,628,624,176,448,33,86,319,400
215,HIDALGO,215,0178,2150178,5730,44,12,32,0,1,30,30,36,11,25,0,0,24,24
409,SAN PATRICIO,409,0104,4090104,7648,2666,729,1937,8,54,1854,1886,1949,608,1341,6,31,1280,1305
439,TARRANT,439,2523,4392523,8189,5407,1251,4156,661,1517,1947,3405,4080,1056,3024,529,1068,1380,2426
29,BEXAR,29,1047,291047,297,3189,205,2984,17,46,2935,2959,2383,162,2221,16,33,2187,2206
113,DALLAS,113,4058,1134058,2716,2375,159,2216,17,131,2067,2190,1751,144,1607,15,112,1473,1584
113,DALLAS,113,2007,1132007,2218,3820,3111,709,238,101,279,375,2819,2371,448,149,73,164,235
113,DALLAS,113,4649,1134649,2882,744,30,714,12,18,684,700,465,23,442,8,10,422,432
135,ECTOR,135,0108,1350108,3214,4426,2086,2340,35,117,2065,2166,3217,1637,1580,31,69,1367,1434
141,EL PASO,141,0067,1410067,3380,5164,523,4641,94,260,4303,4515,3977,408,3569,74,211,3288,3463
363,PALO PINTO,363,0004,3630004,7293,786,675,111,5,6,89,95,615,525,90,4,4,71,75
381,RANDALL,381,0110,3810110,7459,3596,2455,1141,45,54,951,995,2742,1983,759,29,27,617,637
423,SMITH,423,0081,4230081,7791,503,105,398,3,139,256,395,358,89,269,2,108,159,267
439,TARRANT,439,4123,4394123,8455,5406,290,5116,27,86,5013,5079,3798,242,3556,17,61,3477,3525
439,TARRANT,439,1366,4391366,7957,15,7,8,1,5,3,7,12,7,5,0,3,1,4
157,FORT BEND,157,3065B,1573065B,3712,0,0,0,0,0,0,0,0,0,0,0,0,0,0
167,GALVESTON,167,0276,1670276,3878,3095,2168,927,145,209,514,712,2743,1964,779,125,180,417,594
201,HARRIS,201,0159,2010159,4376,2484,401,2083,138,1424,540,1928,1805,388,1417,130,906,387,1271
265,KERR,265,0220,2650220,6297,2740,2384,356,46,20,228,242,2477,2207,270,29,15,162,175
325,MEDINA,325,003B,325003B,6795,812,396,416,5,10,391,394,648,329,319,3,6,301,304
339,MONTGOMERY,339,0063A,3390063A,6961,5660,4713,947,74,123,550,664,4354,3706,648,58,73,375,441
113,DALLAS,113,4082,1134082,2739,2718,882,1836,171,840,850,1648,2505,861,1644,164,771,729,1463
121,DENTON,121,3147,1213147,3071,5918,4046,1872,883,246,569,794,4419,3160,1259,577,175,367,533
135,ECTOR,135,0311,1350311,3237,2242,608,1634,57,114,1434,1537,1622,510,1112,41,67,971,1037
157,FORT BEND,157,3129,1573129,3735,12368,2913,9455,7614,922,858,1755,8620,2279,6341,5116,608,568,1171
201,HARRIS,201,0679,2010679,4897,2136,1072,1064,126,75,832,897,1747,930,817,117,65,602,663
201,HARRIS,201,0017,2010017,4233,2055,513,1542,269,412,868,1261,1625,457,1168,223,291,650,931
291,LIBERTY,291,0002,2910002,6440,1758,1431,327,13,88,176,261,1282,1073,209,8,59,112,168
339,MONTGOMERY,339,0043A,3390043A,6938,4905,3629,1276,118,312,718,1002,3806,2930,876,92,199,464,655
375,POTTER,375,0327,3750327,7436,8247,3217,5030,131,2033,2771,4776,7442,2845,4597,93,1991,2444,4408
401,RUSK,401,0303,4010303,7602,3400,1170,2230,37,1178,972,2134,2525,944,1581,20,885,650,1522
201,HARRIS,201,1011,2011011,5229,110,4,106,17,17,75,89,91,4,87,12,13,65,75
201,HARRIS,201,1060,2011060,5278,7422,287,7135,66,5296,1861,6993,5031,232,4799,48,3542,1219,4696
201,HARRIS,201,0514,2010514,4731,7771,3600,4171,756,1320,2051,3300,5818,2956,2862,550,904,1337,2207
209,HAYS,209,0141,2090141,5444,1130,703,427,35,63,304,359,1024,642,382,32,53,277,326
215,HIDALGO,215,0224,2150224,5776,241,71,170,21,1,146,146,196,61,135,19,0,112,112
231,HUNT,231,0102,2310102,5942,708,571,137,1,17,88,105,568,468,100,0,13,61,74
25,BEE,25,0002,250002,177,619,275,344,10,7,310,315,508,240,268,10,5,239,243
29,BEXAR,29,4033,294033,844,6659,927,5732,74,1362,4401,5630,4872,829,4043,38,967,3055,3962
29,BEXAR,29,2096,292096,509,5208,1481,3727,633,690,2462,3064,4286,1344,2942,495,512,1948,2420
39,BRAZORIA,39,0060,390060,1173,7611,3125,4486,1245,1083,2105,3132,5412,2305,3107,848,766,1421,2165
61,CAMERON,61,0096,610096,1508,6270,947,5323,58,96,5166,5217,4473,863,3610,31,64,3480,3527
85,COLLIN,85,0211,850211,1840,5209,3105,2104,700,701,596,1261,3554,2224,1330,440,444,349,778
491,WILLIAMSON,491,0392,4910392,9500,4879,3838,1041,153,166,609,753,3647,3010,637,101,85,373,454
215,HIDALGO,215,0198,2150198,5750,1056,20,1036,0,6,1033,1034,719,16,703,0,3,700,701
227,HOWARD,227,012A,227012A,5919,407,147,260,12,32,209,237,318,120,198,11,19,158,175
303,LUBBOCK,303,0103,3030103,6583,712,495,217,5,11,187,192,525,376,149,3,6,127,130
439,TARRANT,439,2449,4392449,8169,2846,577,2269,332,886,1074,1927,2079,474,1605,257,608,742,1333
453,TRAVIS,453,0264,4530264,8833,4285,2834,1451,387,248,721,945,3337,2263,1074,284,191,525,695
471,WALKER,471,0205,4710205,9165,5171,3926,1245,93,411,646,1049,4526,3460,1066,66,368,549,912
113,DALLAS,113,3067,1133067,2504,7015,209,6806,56,6170,667,6717,4673,181,4492,45,4054,422,4425
187,GUADALUPE,187,0206,1870206,4090,5895,1099,4796,44,112,4610,4690,4353,906,3447,32,74,3297,3361
201,HARRIS,201,0705,2010705,4923,3221,96,3125,10,2577,596,3113,2016,90,1926,8,1560,386,1919
201,HARRIS,201,0537,2010537,4754,4386,2454,1932,605,319,958,1249,3618,2197,1421,447,233,677,897
201,HARRIS,201,0868,2010868,5086,4692,341,4351,143,605,3622,4175,3390,300,3090,120,448,2517,2950
215,HIDALGO,215,0035,2150035,5587,7037,365,6672,43,52,6597,6616,5067,297,4770,34,29,4711,4723
21,BASTROP,21,1009,211009,154,4538,1945,2593,88,343,2072,2384,3366,1638,1728,51,237,1346,1565
29,BEXAR,29,4007,294007,818,7421,3701,3720,643,1432,1593,2916,5904,3005,2899,503,1158,1205,2292
39,BRAZORIA,39,0037,390037,1150,5770,2686,3084,379,775,1841,2578,3958,1951,2007,267,497,1161,1650
41,BRAZOS,41,0008,410008,1199,3921,1859,2062,454,765,815,1528,3144,1619,1525,404,480,592,1051
85,COLLIN,85,0234,850234,1863,3409,1262,2147,1754,177,182,350,2222,887,1335,1077,106,130,230
113,DALLAS,113,4619,1134619,2859,2267,880,1387,70,104,1149,1242,1722,756,966,43,68,795,859
453,TRAVIS,453,0235,4530235,8810,4495,3548,947,286,103,440,530,3524,2869,655,187,58,308,359
491,WILLIAMSON,491,0425,4910425,9523,1203,453,750,5,129,606,724,922,378,544,4,105,419,519
245,JEFFERSON,245,0077,2450077,6105,2802,98,2704,9,2531,151,2673,1803,89,1714,7,1602,91,1692
257,KAUFMAN,257,0007,2570007,6228,5100,2480,2620,279,1219,1055,2221,3562,1885,1677,189,782,640,1401
321,MATAGORDA,321,001F,321001F,6769,1748,442,1306,26,115,1151,1251,1287,381,906,21,67,801,864
329,MIDLAND,329,0108C,3290108C,6818,0,0,0,0,0,0,0,0,0,0,0,0,0,0
355,NUECES,355,0035,3550035,7150,1335,52,1283,7,18,1259,1274,984,50,934,4,15,913,928
429,STEPHENS,429,0003,4290003,7814,2683,1610,1073,27,182,822,999,2126,1330,796,16,158,580,734
141,EL PASO,141,0209B,1410209B,3523,0,0,0,0,0,0,0,0,0,0,0,0,0,0
167,GALVESTON,167,0419,1670419,3904,4833,2097,2736,212,1184,1327,2439,3489,1597,1892,159,814,876,1655
201,HARRIS,201,0351,2010351,4568,4607,3155,1452,215,317,777,1063,3518,2513,1005,148,243,508,733
201,HARRIS,201,0228,2010228,4445,1483,137,1346,77,1182,77,1251,1284,124,1160,63,1025,57,1075
201,HARRIS,201,0891,2010891,5109,2924,1268,1656,656,557,444,973,2502,1177,1325,558,429,339,744
215,HIDALGO,215,0012,2150012,5564,287,5,282,1,0,277,277,215,4,211,1,0,207,207
17,BAILEY,17,0004A,170004A,134,1544,134,1410,7,31,1364,1387,1033,105,928,3,13,903,914
29,BEXAR,29,3028,293028,632,3132,1172,1960,189,280,1459,1707,2460,968,1492,154,205,1107,1289
55,CALDWELL,55,0302,550302,1385,2046,547,1499,30,86,1366,1432,1517,459,1058,19,60,959,1012
87,COLLINGSWORTH,87,0401,870401,1883,533,275,258,10,20,217,236,416,234,182,9,18,145,163
113,DALLAS,113,1076,1131076,2049,108,6,102,0,39,62,100,78,6,72,0,28,44,72
113,DALLAS,113,3105,1133105,2547,3597,758,2839,150,1674,1002,2639,2740,669,2071,108,1269,682,1925
307,MCCULLOCH,307,0201,3070201,6626,1794,791,1003,29,82,877,947,1393,655,738,22,59,643,694
355,NUECES,355,0009,3550009,7124,3220,1241,1979,26,64,1877,1911,2469,1024,1445,13,47,1364,1396
439,TARRANT,439,2303,4392303,8126,3668,1872,1796,148,423,1164,1571,2838,1623,1215,110,306,741,1038
441,TAYLOR,441,0308,4410308,8624,2384,2033,351,29,50,214,255,1779,1548,231,21,27,132,157
453,TRAVIS,453,0207,4530207,8790,4347,2877,1470,436,148,801,930,3913,2622,1291,387,124,696,804
479,WEBB,479,0406,4790406,9288,1974,44,1930,5,7,1908,1909,1429,32,1397,4,4,1380,1381
143,ERATH,143,0032,1430032,3549,3473,2354,1119,69,71,906,957,2570,1865,705,43,42,535,575
183,GREGG,183,0020,1830020,4047,6986,1155,5831,55,3108,2631,5679,5025,990,4035,47,2322,1620,3919
199,HARDIN,199,0016,1990016,4213,3982,3409,573,50,51,329,380,2984,2620,364,28,33,192,225
201,HARRIS,201,0494,2010494,4711,7787,251,7536,253,2194,5188,7267,5335,196,5139,201,1558,3411,4919
231,HUNT,231,0324,2310324,5962,4036,2876,1160,98,272,543,799,3079,2303,776,74,188,351,531
291,LIBERTY,291,0031,2910031,6460,6392,1624,4768,33,81,4569,4620,4128,1304,2824,21,51,2692,2726
29,BEXAR,29,2119,292119,532,598,160,438,39,104,289,392,478,142,336,37,66,227,292
61,CAMERON,61,0073,610073,1485,6388,655,5733,146,62,5550,5586,4889,541,4348,129,36,4192,4210
99,CORYELL,99,0311,990311,1983,9898,4986,4912,564,1962,2212,3967,7381,3870,3511,449,1306,1609,2800
113,DALLAS,113,4036,1134036,2696,2046,64,1982,31,509,1463,1948,1471,59,1412,21,389,1015,1387
113,DALLAS,113,1044,1131044,2026,4358,2470,1888,171,1007,690,1677,3340,1964,1376,122,753,479,1216
113,DALLAS,113,4028,1134028,2690,2107,58,2049,27,648,1358,1992,1566,42,1524,21,544,933,1472
447,THROCKMORTON,447,0001,4470001,8647,348,318,30,0,0,23,23,284,264,20,0,0,15,15
451,TOM GREEN,451,0318,4510318,8690,4342,2912,1430,32,132,1114,1227,3311,2354,957,20,92,708,799
473,WALLER,473,0313,4730313,9188,2417,1447,970,27,141,745,876,1909,1246,663,27,105,475,576
235,IRION,235,0100,2350100,5985,378,244,134,6,8,128,132,274,177,97,2,2,94,95
295,LIPSCOMB,295,0202,2950202,6483,197,129,68,2,2,53,54,155,107,48,2,2,37,38
439,TARRANT,439,1430,4391430,7977,28,4,24,3,7,14,21,21,2,19,1,7,11,18
439,TARRANT,439,1440,4391440,7983,4802,612,4190,258,1706,2254,3903,3363,536,2827,187,1176,1455,2608
439,TARRANT,439,2358,4392358,8149,3388,2174,1214,123,501,529,1004,2640,1789,851,86,353,360,703
439,TARRANT,439,4429,4394429,8524,4290,2171,2119,245,763,1085,1785,2837,1524,1313,167,480,629,1088
113,DALLAS,113,3087,1133087,2524,0,0,0,0,0,0,0,0,0,0,0,0,0,0
113,DALLAS,113,1404,1131404,2149,1333,208,1125,33,542,562,1084,996,185,811,31,411,368,772
113,DALLAS,113,1740,1131740,2198,7752,2014,5738,1413,1457,2819,4224,5813,1696,4117,1092,1024,1922,2928
195,HANSFORD,195,0005,1950005,4190,962,397,565,3,6,550,556,664,323,341,1,2,332,334
201,HARRIS,201,0471,2010471,4688,4403,2319,2084,58,174,1746,1892,3327,1890,1437,46,118,1180,1280
217,HILL,217,0008,2170008,5819,3204,2722,482,11,74,269,335,2648,2311,337,9,46,170,216
1,ANDERSON,1,0011,10011,11,8669,3272,5397,43,3195,2130,5305,8373,3078,5295,38,3155,2088,5223
29,BEXAR,29,3071,293071,675,4087,1350,2737,234,305,2218,2445,3357,1216,2141,199,225,1726,1900
51,BURLESON,51,0211,510211,1342,1518,994,524,3,193,302,472,1213,838,375,1,136,210,339
109,CULBERSON,109,0002,1090002,2006,553,117,436,9,7,424,425,433,103,330,2,6,324,325
113,DALLAS,113,1717,1131717,2175,6886,1595,5291,263,1583,3383,4913,4849,1371,3478,207,993,2217,3184
113,DALLAS,113,4559,1134559,2839,0,0,0,0,0,0,0,0,0,0,0,0,0,0
319,MASON,319,0302,3190302,6752,1027,849,178,6,9,155,164,851,727,124,2,3,109,112
373,POLK,373,0020,3730020,7416,1172,1021,151,4,16,80,95,958,861,97,2,11,45,56
437,SWISHER,437,0001,4370001,7834,1485,553,932,3,176,753,912,1222,488,734,2,155,563,714
439,TARRANT,439,4272,4394272,8498,969,683,286,62,46,158,197,826,599,227,51,39,110,147
449,TITUS,449,0017,4490017,8667,1520,216,1304,25,203,1090,1268,1061,191,870,15,136,724,849
485,WICHITA,485,0202,4850202,9331,8783,3707,5076,167,2350,2394,4678,7369,3138,4231,129,1991,1952,3913
139,ELLIS,139,1003,1391003,3257,3133,1642,1491,28,312,1051,1347,2164,1213,951,19,200,653,845
167,GALVESTON,167,0480,1670480,3921,2823,1210,1613,167,557,880,1394,2027,950,1077,133,373,543,906
201,HARRIS,201,0371,2010371,4588,842,11,831,1,569,268,830,642,9,633,1,463,171,633
201,HARRIS,201,1034,2011034,5252,3271,366,2905,345,888,1708,2528,2358,303,2055,292,587,1188,1738
207,HASKELL,207,0006,2070006,5421,500,343,157,2,16,122,137,386,282,104,1,13,74,86
245,JEFFERSON,245,0057,2450057,6085,1013,22,991,8,909,74,976,811,20,791,5,739,50,784
13,ATASCOSA,13,0018,130018,111,2503,673,1830,13,30,1755,1781,1883,545,1338,6,20,1287,1306
29,BEXAR,29,3048,293048,652,2117,1375,742,109,114,501,600,1780,1193,587,85,84,392,470
29,BEXAR,29,4013,294013,824,1576,150,1426,8,35,1372,1393,1253,123,1130,5,32,1082,1100
41,BRAZOS,41,0002,410002,1193,3839,2426,1413,166,219,939,1130,2987,2015,972,131,140,633,761
53,BURNET,53,0016,530016,1365,749,613,136,13,7,94,99,602,512,90,10,6,60,64
91,COMAL,91,0201,910201,1906,6522,3857,2665,236,322,1998,2277,4821,2979,1842,147,226,1356,1561
491,WILLIAMSON,491,0340,4910340,9480,2818,1805,1013,367,127,437,557,2045,1382,663,240,75,299,372
303,LUBBOCK,303,0129,3030129,6603,5145,3133,2012,321,359,1268,1589,4011,2580,1431,234,251,883,1116
323,MAVERICK,323,001D,323001D,6775,2364,32,2332,2,5,2305,2306,1528,22,1506,2,5,1494,1495
363,PALO PINTO,363,0029,3630029,7316,1773,1109,664,20,80,535,614,1285,825,460,16,55,361,415
439,TARRANT,439,1024,4391024,7857,6522,3363,3159,148,1034,1833,2813,4657,2666,1991,94,642,1126,1747
453,TRAVIS,453,0175,4530175,8767,32,3,29,2,12,22,27,18,3,15,0,5,15,15
481,WHARTON,481,0201,4810201,9308,3472,2508,964,20,137,779,895,2674,2021,653,10,91,514,598
113,DALLAS,113,4521,1134521,2816,7016,1835,5181,528,1392,3143,4463,5359,1622,3737,419,1045,2180,3186
141,EL PASO,141,0044,1410044,3357,6423,1545,4878,384,1039,3557,4398,4583,1215,3368,280,721,2370,3002
167,GALVESTON,167,0390,1670390,3898,6074,3820,2254,313,641,1219,1835,4440,2928,1512,228,406,800,1202
187,GUADALUPE,187,0112,1870112,4070,675,284,391,7,92,277,368,663,282,381,7,89,271,360
201,HARRIS,201,0394,2010394,4611,3064,428,2636,28,138,2469,2576,2235,346,1889,23,94,1766,1842
245,JEFFERSON,245,0034,2450034,6062,1998,130,1868,52,1602,212,1790,1581,92,1489,27,1316,130,1435
5,ANGELINA,5,0027,50027,54,572,441,131,2,34,76,106,434,352,82,2,10,48,58
29,BEXAR,29,2139,292139,552,2663,819,1844,122,187,1554,1699,2072,663,1409,87,147,1174,1293
29,BEXAR,29,1053,291053,303,499,60,439,16,30,402,423,345,42,303,10,21,276,293
61,CAMERON,61,0053,610053,1465,9135,190,8945,6,41,8899,8913,6258,120,6138,2,29,6113,6123
85,COLLIN,85,0085,850085,1714,4474,2285,2189,805,582,705,1266,3638,1962,1676,709,384,504,877
97,COOKE,97,0010,970010,1963,2461,2137,324,18,18,177,189,1978,1761,217,11,9,121,128
453,TRAVIS,453,0104,4530104,8710,3739,2648,1091,239,221,562,759,3224,2335,889,190,195,461,635
453,TRAVIS,453,0424,4530424,8959,8665,1498,7167,335,761,6077,6746,6343,1391,4952,262,552,4119,4626
477,WASHINGTON,477,0117,4770117,9208,228,49,179,7,99,70,166,174,42,132,5,81,44,123
215,HIDALGO,215,0241,2150241,5793,3886,67,3819,2,10,3811,3811,2299,43,2256,0,7,2255,2255
245,JEFFERSON,245,0014,2450014,6042,2845,95,2750,136,1521,1094,2602,2092,83,2009,106,1183,714,1890
265,KERR,265,0113,2650113,6291,1797,1424,373,29,20,281,296,1483,1218,265,20,15,193,206
303,LUBBOCK,303,0026,3030026,6540,5749,750,4999,36,704,4300,4904,4195,650,3545,22,452,3054,3477
439,TARRANT,439,4135,4394135,8461,2410,1229,1181,57,232,840,1053,1905,1053,852,40,170,577,738
439,TARRANT,439,2616,4392616,8212,15,1,14,1,11,1,12,13,1,12,1,10,1,11
113,DALLAS,113,2001,1132001,2212,65,7,58,0,4,55,58,57,7,50,0,3,47,50
113,DALLAS,113,3024,1133024,2461,3345,51,3294,11,2114,1202,3270,2221,36,2185,7,1456,729,2167
187,GUADALUPE,187,0410,1870410,4133,206,90,116,5,6,91,96,164,81,83,1,4,68,71
201,HARRIS,201,0414,2010414,4631,5085,2566,2519,71,569,1798,2323,3847,2132,1715,48,375,1209,1563
201,HARRIS,201,0165,2010165,4382,5294,1928,3366,291,315,2727,2990,3985,1612,2373,229,218,1900,2078
201,HARRIS,201,0663,2010663,4880,930,589,341,68,38,208,242,695,461,234,44,34,139,172
29,BEXAR,29,2034,292034,446,3012,938,2074,10,328,1750,2049,2630,919,1711,7,294,1410,1693
29,BEXAR,29,4133,294133,944,71,30,41,0,14,25,38,60,30,30,0,9,20,28
37,BOWIE,37,0016,370016,1073,1889,1652,237,12,100,58,156,1432,1271,161,6,74,36,109
73,CHEROKEE,73,0013,730013,1571,1857,1412,445,10,72,317,386,1399,1115,284,7,41,189,229
113,DALLAS,113,1096,1131096,2069,4038,174,3864,20,296,3541,3816,2844,150,2694,16,252,2416,2655
113,DALLAS,113,3204,1133204,2567,5108,949,4159,60,1488,2617,4043,3718,849,2869,47,1127,1679,2779
283,LA SALLE,283,0005,2830005,6397,1829,357,1472,6,172,1293,1461,1494,318,1176,4,170,1003,1170
339,MONTGOMERY,339,0002,3390002,6895,4423,2029,2394,112,381,1830,2183,3256,1661,1595,80,266,1190,1438
439,TARRANT,439,2224,4392224,8106,3874,1130,2744,244,1805,674,2436,3211,1009,2202,218,1414,551,1936
441,TAYLOR,441,0105,4410105,8604,7824,4089,3735,562,1328,1769,2940,6062,3406,2656,424,891,1188,2025
465,VAL VERDE,465,0043,4650043,9102,73,53,20,3,2,14,15,61,46,15,1,1,11,12
499,WOOD,499,02-3,49902-3,9600,4600,3438,1162,54,331,655,970,3698,2892,806,35,252,414,659
157,FORT BEND,157,4101,1574101,3778,7563,636,6927,901,2015,4053,5978,5601,518,5083,709,1442,2933,4319
201,HARRIS,201,0557,2010557,4774,6156,301,5855,1252,800,3736,4456,4698,272,4426,1077,594,2689,3236
201,HARRIS,201,1054,2011054,5272,5947,3037,2910,468,568,1801,2317,4582,2519,2063,355,372,1255,1601
201,HARRIS,201,0059,2010059,4276,3564,2538,1026,159,160,647,793,3076,2216,860,122,146,530,667
203,HARRISON,203,0018,2030018,5401,2653,1665,988,12,445,485,917,2092,1421,671,2,336,288,618
227,HOWARD,227,0012,2270012,5899,1544,319,1225,15,103,1088,1174,1093,239,854,9,68,755,815
11,ARMSTRONG,11,0301,110301,91,392,346,46,6,5,21,22,288,257,31,5,1,14,15
29,BEXAR,29,1090,291090,340,0,0,0,0,0,0,0,0,0,0,0,0,0,0
85,COLLIN,85,0048,850048,1677,5805,3492,2313,951,593,645,1214,4798,2967,1831,767,470,492,947
91,COMAL,91,0401,910401,1926,4435,3404,1031,51,104,776,864,3660,2911,749,32,73,560,622
113,DALLAS,113,4101,1134101,2759,264,3,261,3,30,229,255,196,1,195,1,17,177,192
121,DENTON,121,2084,1212084,3008,5748,2814,2934,248,672,1902,2541,4438,2388,2050,193,436,1307,1726
351,NEWTON,351,0006,3510006,7087,1329,721,608,5,543,44,582,1005,574,431,5,382,28,410
365,PANOLA,365,0029,3650029,7336,436,396,40,0,7,25,32,331,313,18,0,2,14,16
409,SAN PATRICIO,409,0121,4090121,7665,4045,1833,2212,137,149,1900,2004,3085,1475,1610,97,103,1381,1454
439,TARRANT,439,1197,4391197,7914,6495,3238,3257,979,1023,1117,2094,4714,2432,2282,706,721,741,1437
453,TRAVIS,453,0473,4530473,8996,3448,1172,2276,242,331,1719,1992,2517,961,1556,173,226,1163,1358
453,TRAVIS,453,0150B,4530150B,8747,97,38,59,26,9,24,29,53,20,33,15,5,15,16
141,EL PASO,141,0024,1410024,3337,4725,1426,3299,172,160,2969,3089,3801,1244,2557,139,96,2308,2387
147,FANNIN,147,0019,1470019,3586,3168,2320,848,32,303,389,677,2363,1816,547,18,205,228,424
201,HARRIS,201,0202,2010202,4419,2868,96,2772,16,1866,956,2741,1941,86,1855,15,1240,637,1832
201,HARRIS,201,0451,2010451,4668,3690,2459,1231,174,447,568,967,3099,2239,860,126,310,373,661
241,JASPER,241,0002,2410002,6005,774,720,54,1,12,16,26,667,623,44,1,7,13,20
257,KAUFMAN,257,0033,2570033,6254,963,485,478,19,231,183,406,813,421,392,15,180,151,325
29,BEXAR,29,3091,293091,695,979,713,266,31,14,213,225,801,605,196,17,6,167,173
49,BROWN,49,0113,490113,1322,3926,2606,1320,24,327,908,1225,3236,2214,1022,20,278,667,940
113,DALLAS,113,2603,1132603,2404,8233,1352,6881,5323,825,676,1468,5974,1205,4769,3635,606,483,1068
113,DALLAS,113,2132,1132132,2318,2833,427,2406,139,261,1987,2231,1987,383,1604,110,202,1283,1470
121,DENTON,121,1021,1211021,2945,5284,3157,2127,953,503,543,1020,3783,2328,1455,624,387,352,727
141,EL PASO,141,0087,1410087,3400,1254,388,866,87,115,616,719,928,227,701,50,66,546,605
361,ORANGE,361,0018,3610018,7273,3107,2747,360,57,16,184,197,2363,2143,220,32,8,100,108
423,SMITH,423,0007,4230007,7728,3588,2084,1504,45,588,792,1366,2645,1709,936,31,356,483,832
439,TARRANT,439,3157,4393157,8269,4688,2342,2346,152,797,1273,2017,3469,1918,1551,105,519,829,1323
439,TARRANT,439,3517,4393517,8355,4753,2345,2408,328,1199,837,1987,3956,2159,1797,265,858,607,1441
485,WICHITA,485,0401,4850401,9351,3525,2476,1049,132,197,624,804,2894,2165,729,101,128,412,533
171,GILLESPIE,171,0002,1710002,3941,1963,1260,703,16,19,634,642,1605,1115,490,12,13,436,443
181,GRAYSON,181,0412,1810412,4027,1834,1450,384,28,121,124,240,1437,1192,245,24,68,67,133
201,HARRIS,201,0805,2010805,5023,3613,2633,980,115,246,542,768,2902,2222,680,78,164,372,525
215,HIDALGO,215,0098,2150098,5650,6842,257,6585,23,58,6523,6538,5008,222,4786,20,36,4746,4761
309,MCLENNAN,309,0014,3090014,6646,3555,781,2774,52,1942,797,2680,3058,747,2311,48,1625,637,2226
313,MADISON,313,0303,3130303,6732,2869,1200,1669,25,913,666,1571,2092,949,1143,16,655,431,1084
29,BEXAR,29,4076,294076,887,7911,1226,6685,518,1503,4848,6118,5474,961,4513,377,955,3201,4064
29,BEXAR,29,4070,294070,881,5366,770,4596,125,1289,3239,4410,3877,604,3273,99,1006,2160,3116
39,BRAZORIA,39,0023,390023,1136,7727,4058,3669,180,577,2769,3261,5731,3253,2478,128,379,1831,2182
39,BRAZORIA,39,0017,390017,1130,5939,1559,4380,65,677,3666,4240,4336,1279,3057,32,464,2544,2960
55,CALDWELL,55,0203,550203,1379,2316,1130,1186,15,138,994,1108,1705,935,770,12,99,616,708
121,DENTON,121,3121,1213121,3045,6262,1705,4557,150,444,3886,4285,4468,1472,2996,116,301,2492,2780
479,WEBB,479,0417,4790417,9294,1441,48,1393,5,5,1387,1388,1034,34,1000,5,1,996,996
491,WILLIAMSON,491,0487,4910487,9543,172,133,39,4,9,24,28,135,107,28,3,9,16,20
491,WILLIAMSON,491,0472,4910472,9537,774,619,155,9,14,89,100,660,543,117,8,10,64,71
209,HAYS,209,0253,2090253,5464,4941,1815,3126,186,409,2483,2846,3608,1413,2195,129,306,1712,1990
355,NUECES,355,0015,3550015,7130,2084,399,1685,20,84,1565,1621,1428,325,1103,12,42,1022,1059
367,PARKER,367,0445,3670445,7379,2733,2403,330,37,40,180,215,1892,1685,207,32,31,102,129
367,PARKER,367,0410,3670410,7373,2994,2564,430,47,56,252,301,2286,2004,282,21,33,161,192
403,SABINE,403,0008,4030008,7622,463,391,72,1,40,17,55,353,308,45,1,23,11,33
405,SAN AUGUSTINE,405,0006,4050006,7628,372,325,47,0,20,19,39,291,259,32,0,11,14,25
121,DENTON,121,3127,1213127,3051,10511,2798,7713,663,3622,3362,6855,8140,2492,5648,524,2694,2342,4952
139,ELLIS,139,1046,1391046,3300,394,304,90,3,14,63,77,290,235,55,2,14,35,49
139,ELLIS,139,1040,1391040,3294,399,335,64,0,11,35,43,323,279,44,0,8,20,28
201,HARRIS,201,0991,2010991,5209,6717,1745,4972,534,1804,2605,4320,4550,1310,3240,383,1166,1637,2767
201,HARRIS,201,0997,2010997,5215,5313,506,4807,113,3680,1040,4636,3879,462,3417,99,2621,717,3293
209,HAYS,209,0223,2090223,5458,4391,1551,2840,136,274,2359,2576,3225,1250,1975,82,168,1639,1785
29,BEXAR,29,4176,294176,987,1397,737,660,54,60,547,592,1167,655,512,45,47,412,448
29,BEXAR,29,2076,292076,489,3491,1100,2391,120,241,2011,2212,2640,913,1727,95,158,1443,1584
29,BEXAR,29,4219,294219,1030,4,0,4,0,0,4,4,0,0,0,0,0,0,0
67,CASS,67,0004,670004,1528,1041,787,254,7,182,49,222,815,628,187,4,139,33,165
113,DALLAS,113,3968,1133968,2653,5570,2670,2900,293,1209,1298,2466,4250,2231,2019,219,805,882,1673
121,DENTON,121,9100,1219100,3151,0,0,0,0,0,0,0,0,0,0,0,0,0,0
339,MONTGOMERY,339,0081,3390081,6981,5528,3835,1693,396,229,902,1108,4330,3169,1161,249,155,624,765
381,RANDALL,381,0317,3810317,7479,309,194,115,4,11,95,102,271,176,95,4,10,76,83
389,REEVES,389,0008,3890008,7522,1059,127,932,10,23,899,913,792,114,678,4,15,653,664
439,TARRANT,439,1594,4391594,8020,0,0,0,0,0,0,0,0,0,0,0,0,0,0
469,VICTORIA,469,0025,4690025,9145,7016,3304,3712,278,654,2774,3341,5360,2810,2550,215,400,1897,2260
131,DUVAL,131,0003,1310003,3194,455,23,432,1,1,426,427,386,23,363,1,0,358,358
157,FORT BEND,157,2171,1572171,3692,4822,1012,3810,2091,1205,537,1688,3447,765,2682,1417,896,356,1228
201,HARRIS,201,1140,2011140,5358,358,111,247,8,155,86,234,270,101,169,8,102,58,156
201,HARRIS,201,0600,2010600,4817,8181,1264,6917,1178,1798,3971,5663,6379,1104,5275,975,1343,2968,4224
201,HARRIS,201,1097,2011097,5315,2863,524,2339,215,1235,950,2110,2141,471,1670,175,853,671,1483
223,HOPKINS,223,0001,2230001,5856,3583,2561,1022,65,367,510,868,2696,2011,685,43,261,320,578
29,BEXAR,29,4027,294027,838,2556,354,2202,24,202,1982,2163,2059,327,1732,19,173,1533,1694
29,BEXAR,29,2176,292176,589,1670,565,1105,214,109,759,859,1262,450,812,154,82,552,630
61,CAMERON,61,0016,610016,1428,1299,262,1037,7,5,1017,1017,952,255,697,7,1,680,680
85,COLLIN,85,0042,850042,1671,3106,1927,1179,64,177,852,1013,2176,1388,788,50,111,557,665
91,COMAL,91,0303,910303,1920,1402,561,841,15,47,743,780,1143,486,657,12,34,578,608
113,DALLAS,113,4097,1134097,2753,2198,374,1824,43,122,1638,1755,1652,343,1309,31,106,1159,1261
411,SAN SABA,411,002A,411002A,7671,715,591,124,0,10,80,90,584,507,77,0,3,51,54
439,TARRANT,439,1211,4391211,7920,4839,247,4592,61,2668,1895,4507,3241,186,3055,38,1926,1093,2996
439,TARRANT,439,2426,4392426,8163,3468,2159,1309,201,489,520,987,2588,1685,903,127,336,344,673
453,TRAVIS,453,0483,4530483,9002,10048,1118,8930,346,753,7877,8525,6913,955,5958,254,517,5171,5638
453,TRAVIS,453,0154B,4530154B,8753,85,40,45,6,18,23,38,48,21,27,4,6,18,23
209,HAYS,209,0444,2090444,5507,3453,2769,684,87,52,418,467,2635,2194,441,52,33,269,302
215,HIDALGO,215,0204,2150204,5756,1673,185,1488,12,14,1460,1465,1187,166,1021,12,5,1001,1002
239,JACKSON,239,0005,2390005,5999,943,610,333,19,35,256,284,700,466,234,8,27,183,206
303,LUBBOCK,303,0112,3030112,6589,2736,1712,1024,208,148,623,755,2153,1461,692,154,95,396,489
329,MIDLAND,329,0309,3290309,6838,1732,305,1427,15,235,1160,1382,1147,227,920,10,131,771,895
349,NAVARRO,349,0406,3490406,7081,385,315,70,2,7,50,55,301,256,45,2,5,30,33
113,DALLAS,113,3073,1133073,2510,261,3,258,13,164,81,245,186,3,183,5,136,42,178
121,DENTON,121,2078,1212078,3002,2987,1575,1412,482,407,482,875,2288,1252,1036,373,282,341,617
149,FAYETTE,149,0316,1490316,3592,2936,1729,1207,20,124,1024,1137,2293,1462,831,11,91,691,776
165,GAINES,165,0006,1650006,3835,961,301,660,1,6,644,649,679,232,447,1,5,435,439
201,HARRIS,201,0457,2010457,4674,0,0,0,0,0,0,0,0,0,0,0,0,0,0
201,HARRIS,201,0699,2010699,4917,3071,1699,1372,647,130,544,669,2435,1403,1032,498,98,394,490
27,BELL,27,0109,270109,197,5373,1421,3952,270,2424,1342,3542,4096,1236,2860,215,1723,920,2532
29,BEXAR,29,3134,293134,738,4147,1268,2879,253,482,2151,2565,3462,1091,2371,208,398,1750,2105
41,BRAZOS,41,0089A,410089A,1279,18,9,9,0,1,7,8,13,9,4,0,1,2,3
85,COLLIN,85,0191,850191,1820,1136,520,616,17,12,554,565,826,440,386,13,7,333,339
113,DALLAS,113,2311,1132311,2361,2432,175,2257,38,142,2070,2208,1644,144,1500,36,98,1358,1454
113,DALLAS,113,4677,1134677,2902,2049,85,1964,1877,52,30,78,1263,56,1207,1160,26,18,43
309,MCLENNAN,309,0056,3090056,6689,1878,437,1441,19,267,1168,1397,1339,376,963,10,159,785,937
355,NUECES,355,0114,3550114,7230,1312,136,1176,41,51,1076,1117,984,111,873,32,31,795,825
423,SMITH,423,0050,4230050,7771,3105,2268,837,42,350,372,717,2455,1889,566,27,242,238,477
439,TARRANT,439,3333,4393333,8312,6048,4004,2044,319,584,921,1471,4813,3365,1448,229,398,626,1006
453,TRAVIS,453,0301,4530301,8853,3451,2158,1293,222,487,515,988,3321,2092,1229,198,470,487,948
491,WILLIAMSON,491,0143,4910143,9394,1121,371,750,75,227,410,620,809,280,529,49,165,286,440
141,EL PASO,141,0130,1410130,3443,7151,544,6607,186,330,6193,6411,5253,434,4819,123,219,4504,4673
179,GRAY,179,0005,1790005,3984,4532,3255,1277,78,131,944,1061,3368,2581,787,57,76,556,632
201,HARRIS,201,0308,2010308,4525,4531,305,4226,91,1043,3127,4114,3305,273,3032,70,768,2216,2943
201,HARRIS,201,0848,2010848,5066,3123,522,2601,89,988,1521,2460,2404,473,1931,60,778,1063,1822
215,HIDALGO,215,0055,2150055,5607,4225,177,4048,17,33,4008,4018,2925,142,2783,13,16,2753,2761
249,JIM WELLS,249,0011,2490011,6148,1238,110,1128,13,11,1106,1114,910,99,811,8,7,797,801
27,BELL,27,0210,270210,214,6491,1660,4831,434,3012,1492,4225,4492,1236,3256,274,1997,961,2831
113,DALLAS,113,4504,1134504,2799,2490,485,2005,133,423,1430,1815,1826,431,1395,99,314,958,1260
113,DALLAS,113,3030,1133030,2467,40,10,30,0,9,18,26,24,8,16,0,8,5,13
113,DALLAS,113,1313,1131313,2135,583,39,544,29,269,245,512,431,30,401,28,196,178,372
121,DENTON,121,4205B,1214205B,3131,413,166,247,202,27,18,43,265,117,148,116,16,16,30
141,EL PASO,141,0150,1410150,3463,3361,124,3237,12,40,3199,3219,2638,108,2530,4,21,2495,2512
347,NACOGDOCHES,347,0034,3470034,7044,7066,3942,3124,124,1656,1231,2861,6514,3848,2666,103,1292,1168,2441
367,PARKER,367,0430,3670430,7376,4566,3718,848,105,85,544,615,3023,2521,502,69,36,314,348
419,SHELBY,419,001N,419001N,7708,2478,1298,1180,41,274,853,1111,1830,1051,779,23,190,544,731
439,TARRANT,439,1651,4391651,8040,0,0,0,0,0,0,0,0,0,0,0,0,0,0
79,COCHRAN,79,0101,790101,1615,631,212,419,2,23,387,406,451,170,281,2,19,252,271
113,DALLAS,113,3028,1133028,2465,1700,30,1670,6,1145,517,1652,1272,28,1244,1,915,327,1234
215,HIDALGO,215,0082,2150082,5634,17,1,16,0,0,15,15,10,1,9,0,0,9,9
201,HARRIS,201,0057,2010057,4274,4536,3319,1217,212,109,772,862,3714,2775,939,147,67,600,661
455,TRINITY,455,0016,4550016,9020,904,647,257,4,167,75,240,689,505,184,1,122,54,175
279,LAMB,279,0006,2790006,6378,743,226,517,2,32,481,508,564,200,364,2,24,334,357
439,TARRANT,439,3433,4393433,8339,839,648,191,51,37,83,118,709,553,156,32,36,65,99
29,BEXAR,29,3176,293176,782,76,25,51,20,5,21,26,48,19,29,11,3,13,16
387,RED RIVER,387,02-1A,38702-1A,7506,219,47,172,3,150,16,164,179,39,140,0,129,7,134
113,DALLAS,113,3315,1133315,2591,4385,828,3557,98,1501,1940,3400,3038,704,2334,70,1000,1232,2212
355,NUECES,355,0095,3550095,7211,1284,153,1131,10,35,1102,1121,986,118,868,10,17,846,858
397,ROCKWALL,397,002F,397002F,7569,1596,896,700,27,292,353,631,1282,771,511,16,221,240,454
489,WILLACY,489,001A,489001A,9378,2234,58,2176,2,18,2153,2168,1561,43,1518,2,12,1498,1510
141,EL PASO,141,0048,1410048,3361,3324,422,2902,63,248,2623,2821,2575,370,2205,49,184,1968,2134
29,BEXAR,29,3115,293115,719,2107,1204,903,107,47,736,770,1761,1075,686,76,34,560,583
465,VAL VERDE,465,0010,4650010,9083,5102,441,4661,43,84,4536,4585,3667,384,3283,30,59,3191,3230
291,LIBERTY,291,0003,2910003,6441,4001,3081,920,36,177,617,781,2976,2386,590,24,119,386,498
201,HARRIS,201,0183,2010183,4400,3386,2531,855,479,25,296,316,2380,1846,534,293,14,189,202
203,HARRISON,203,0019,2030019,5402,5558,3873,1685,30,556,847,1387,4026,2954,1072,25,361,479,835
481,WHARTON,481,0402,4810402,9315,3528,1183,2345,15,269,2052,2289,2557,984,1573,11,165,1375,1531
29,BEXAR,29,2074,292074,487,1976,98,1878,14,24,1843,1857,1463,71,1392,8,13,1369,1377
71,CHAMBERS,71,0001,710001,1552,697,519,178,6,75,79,149,530,402,128,6,56,44,100
439,TARRANT,439,3032,4393032,8250,2230,1265,965,69,196,637,821,1758,1091,667,46,130,435,559
439,TARRANT,439,3334,4393334,8313,3559,2030,1529,212,617,615,1195,2893,1773,1120,148,442,452,869
485,WICHITA,485,0206,4850206,9335,5292,4170,1122,80,304,608,870,4008,3277,731,46,168,387,540
439,TARRANT,439,3698,4393698,8399,5856,3171,2685,731,743,1124,1814,3982,2235,1747,498,459,704,1144
201,HARRIS,201,0352,2010352,4569,8771,4210,4561,335,562,3559,4047,6590,3434,3156,242,385,2412,2759
113,DALLAS,113,3969,1133969,2654,3564,2251,1313,271,467,511,946,2919,1938,981,233,349,353,684
295,LIPSCOMB,295,0207A,2950207A,6484,569,302,267,5,1,255,256,411,248,163,2,1,154,155
303,LUBBOCK,303,0011,3030011,6527,378,47,331,6,123,218,324,265,42,223,4,90,134,217
113,DALLAS,113,4037,1134037,2697,358,28,330,0,37,295,328,276,26,250,0,32,221,249
287,LEE,287,0405,2870405,6424,1216,956,260,7,92,126,211,868,723,145,4,52,67,118
85,COLLIN,85,0029,850029,1658,4679,3303,1376,354,414,515,914,2798,1988,810,213,244,294,530
491,WILLIAMSON,491,0203,4910203,9421,194,159,35,11,3,21,22,144,121,23,7,1,15,16
215,HIDALGO,215,0039,2150039,5591,4890,100,4790,7,44,4753,4780,3313,68,3245,3,26,3223,3237
157,FORT BEND,157,1145,1571145,3633,5747,2213,3534,1391,653,1407,2037,4027,1621,2406,957,439,953,1375
367,PARKER,367,0265,3670265,7360,2044,1547,497,16,36,352,382,1575,1254,321,9,24,214,237
29,BEXAR,29,3118,293118,722,1629,651,978,69,275,620,851,1304,602,702,53,185,441,603
439,TARRANT,439,4233,4394233,8485,3542,699,2843,73,246,2510,2717,2689,629,2060,54,171,1813,1969
201,HARRIS,201,0438,2010438,4655,6032,3859,2173,497,555,1040,1544,4124,2754,1370,319,345,647,975
29,BEXAR,29,4014,294014,825,820,61,759,11,19,727,742,663,58,605,5,18,576,591
201,HARRIS,201,0335,2010335,4552,11171,552,10619,586,1141,8893,9940,7525,434,7091,428,767,5908,6619
113,DALLAS,113,3109,1133109,2551,4751,1944,2807,312,1533,910,2399,3845,1714,2131,253,1190,618,1783
375,POTTER,375,0122,3750122,7420,5624,3241,2383,213,776,1276,1989,4539,2811,1728,178,519,910,1401
381,RANDALL,381,0123,3810123,7463,914,818,96,7,11,66,72,676,615,61,2,2,41,43
113,DALLAS,113,3318,1133318,2594,2327,566,1761,104,829,823,1630,1738,505,1233,73,622,524,1135
363,PALO PINTO,363,0030,3630030,7317,1700,822,878,21,154,669,816,1224,631,593,17,114,438,549
201,HARRIS,201,0206,2010206,4423,5080,1761,3319,200,152,2924,3054,4166,1545,2621,148,111,2311,2408
479,WEBB,479,0415,4790415,9292,3370,100,3270,5,16,3246,3253,2417,65,2352,3,13,2334,2340
141,EL PASO,141,0174,1410174,3487,87,15,72,0,1,70,71,78,15,63,0,1,61,62
29,BEXAR,29,2180A,292180A,593,5976,1296,4680,310,566,3904,4346,4128,931,3197,223,341,2639,2933
439,TARRANT,439,3526,4393526,8356,1642,1194,448,246,39,109,148,1225,924,301,152,37,73,110
85,COLLIN,85,0132,850132,1761,4176,2392,1784,469,639,616,1215,3425,2066,1359,389,474,443,899
439,TARRANT,439,3037,4393037,8253,3747,2706,1041,206,249,505,730,3029,2331,698,142,153,331,472
209,HAYS,209,0371,2090371,5488,3343,1698,1645,162,201,1262,1422,2538,1352,1186,117,149,884,1014
439,TARRANT,439,2442,4392442,8167,4423,2000,2423,1173,703,519,1179,3468,1659,1809,875,524,378,872
257,KAUFMAN,257,0031,2570031,6252,2109,852,1257,38,546,647,1177,1386,628,758,25,320,397,710
355,NUECES,355,0115,3550115,7231,3279,1094,2185,155,260,1745,1957,2622,957,1665,123,183,1312,1476
201,HARRIS,201,1098,2011098,5316,3778,127,3651,328,1174,2153,3286,2775,89,2686,271,896,1494,2372
141,EL PASO,141,0131,1410131,3444,6485,473,6012,161,335,5544,5820,4255,312,3943,98,207,3638,3816
201,HARRIS,201,1141,2011141,5359,0,0,0,0,0,0,0,0,0,0,0,0,0,0
201,HARRIS,201,1035,2011035,5253,121,61,60,19,19,24,42,87,46,41,11,12,18,30
439,TARRANT,439,2221,4392221,8104,2541,1231,1310,295,673,331,981,1802,911,891,205,456,205,655
85,COLLIN,85,0175,850175,1804,2771,1570,1201,560,259,313,562,1949,1177,772,365,169,183,347
279,LAMB,279,0010,2790010,6381,841,282,559,1,44,504,545,655,247,408,1,32,365,397
457,TYLER,457,0016,4570016,9040,960,877,83,11,20,19,37,723,670,53,8,9,13,22
29,BEXAR,29,4057,294057,868,1950,1144,806,148,180,451,615,1613,996,617,110,137,332,462
439,TARRANT,439,3282,4393282,8296,2456,1726,730,68,174,412,576,1956,1421,535,52,130,286,408
265,KERR,265,0211,2650211,6295,2444,1460,984,65,103,768,859,2152,1326,826,52,91,640,724
201,HARRIS,201,0163,2010163,4380,7048,634,6414,38,142,6245,6331,5181,550,4631,35,107,4482,4555
209,HAYS,209,0142,2090142,5445,5153,1334,3819,1901,392,1487,1874,5093,1312,3781,1896,373,1470,1840
251,JOHNSON,251,0030,2510030,6189,3809,3032,777,30,112,497,590,2699,2198,501,25,75,295,358
395,ROBERTSON,395,0016,3950016,7549,373,303,70,17,12,32,42,291,246,45,12,9,16,23
61,CAMERON,61,0097,610097,1509,795,66,729,2,4,716,718,645,65,580,2,3,568,569
147,FANNIN,147,0004,1470004,3573,2610,1827,783,33,300,382,671,1982,1470,512,27,214,221,430
85,COLLIN,85,0238,850238,1867,7051,2794,4257,1775,1507,956,2381,4900,2102,2798,1142,1022,592,1576
213,HENDERSON,213,2GBN,2132GBN,5548,4057,3369,688,54,94,395,479,3168,2692,476,31,64,264,320
359,OLDHAM,359,0403,3590403,7254,214,166,48,4,5,38,43,162,129,33,2,3,27,30
113,DALLAS,113,4508,1134508,2803,2294,373,1921,16,239,1651,1879,1541,293,1248,14,146,1070,1211
113,DALLAS,113,3900,1133900,2637,6382,702,5680,44,3560,2090,5581,4435,565,3870,31,2485,1335,3795
201,HARRIS,201,0395,2010395,4612,2422,1644,778,194,160,392,539,1935,1370,565,139,102,280,375
157,FORT BEND,157,3137,1573137,3739,1469,127,1342,235,347,766,1092,1002,99,903,183,239,479,710
29,BEXAR,29,3032,293032,636,25,13,12,0,1,9,9,24,13,11,0,0,8,8
85,COLLIN,85,0072,850072,1701,2706,1308,1398,578,257,520,767,2191,1139,1052,461,172,374,542
113,DALLAS,113,3008,1133008,2445,1624,704,920,106,550,261,783,1452,684,768,98,445,219,638
479,WEBB,479,0135,4790135,9232,2540,53,2487,0,9,2480,2483,1758,25,1733,0,3,1726,1729
201,HARRIS,201,0292,2010292,4509,3262,96,3166,28,818,2337,3126,2340,80,2260,23,621,1626,2224
29,BEXAR,29,4120,294120,931,599,163,436,91,120,212,330,525,158,367,80,100,178,276
269,KING,269,0004,2690004,6318,64,62,2,0,0,2,2,39,39,0,0,0,0,0
113,DALLAS,113,4083,1134083,2740,2460,624,1836,122,497,1229,1686,2102,613,1489,110,448,934,1351
113,DALLAS,113,3071,1133071,2508,3306,65,3241,33,2468,769,3198,2502,58,2444,29,1976,456,2412
201,HARRIS,201,0100,2010100,4317,4220,816,3404,34,509,2870,3330,3036,695,2341,25,351,1962,2286
73,CHEROKEE,73,0014,730014,1572,2095,1578,517,18,67,402,464,1612,1270,342,12,44,253,295
201,HARRIS,201,0229,2010229,4446,2209,151,2058,8,71,1974,2034,1632,142,1490,6,50,1426,1469
141,EL PASO,141,0068,1410068,3381,1661,434,1227,69,187,960,1124,1387,410,977,58,150,752,884
157,FORT BEND,157,2097,1572097,3676,7699,3711,3988,1132,1547,1233,2704,5174,2557,2617,788,994,753,1725
201,HARRIS,201,1164,2011164,5382,0,0,0,0,0,0,0,0,0,0,0,0,0,0
491,WILLIAMSON,491,0147,4910147,9398,8913,4580,4333,1073,1078,2098,3067,7446,4078,3368,857,795,1607,2339
467,VAN ZANDT,467,001A,467001A,9103,3345,2786,559,34,41,373,409,2649,2283,366,17,21,230,248
51,BURLESON,51,0204,510204,1340,730,539,191,3,79,108,179,585,460,125,1,54,65,118
439,TARRANT,439,4136,4394136,8462,6096,2240,3856,73,422,3260,3657,4477,1931,2546,61,282,2101,2373
85,COLLIN,85,0009,850009,1638,5686,2768,2918,211,1021,1592,2552,4006,2144,1862,157,634,976,1588
439,TARRANT,439,4328,4394328,8505,4316,1540,2776,210,326,2136,2445,3200,1304,1896,165,243,1411,1642
303,LUBBOCK,303,0113,3030113,6590,5069,2127,2942,432,744,1783,2435,3673,1714,1959,330,404,1186,1567
141,EL PASO,141,0197,1410197,3510,7750,419,7331,153,258,7017,7173,5418,319,5099,99,162,4874,4990
195,HANSFORD,195,0006,1950006,4191,1110,538,572,0,6,550,554,820,439,381,0,3,362,365
29,BEXAR,29,3055,293055,659,4759,2999,1760,218,132,1376,1474,3454,2307,1147,127,71,905,966
29,BEXAR,29,3029,293029,633,1605,606,999,116,62,791,847,1324,538,786,94,51,614,663
471,WALKER,471,0303,4710303,9169,1124,527,597,4,214,361,574,864,427,437,2,170,252,422
201,HARRIS,201,0143,2010143,4360,6777,2666,4111,1571,1236,1268,2453,4754,2062,2692,1003,783,834,1597
209,HAYS,209,0136,2090136,5442,8714,897,7817,47,164,7612,7717,5833,751,5082,30,102,4930,5008
77,CLAY,77,0026,770026,1612,238,220,18,2,1,11,12,192,178,14,1,1,7,8
29,BEXAR,29,2160,292160,573,463,145,318,35,77,209,278,310,100,210,26,49,138,181
439,TARRANT,439,2524,4392524,8190,2744,2230,514,95,136,215,342,2246,1862,384,73,89,171,255
479,WEBB,479,0132,4790132,9229,10691,972,9719,36,86,9603,9659,7622,888,6734,23,68,6641,6694
203,HARRISON,203,0016,2030016,5399,886,770,116,1,52,43,95,678,591,87,1,48,22,70
201,HARRIS,201,0186,2010186,4403,1637,33,1604,7,355,1256,1597,1226,14,1212,4,274,941,1208
29,BEXAR,29,3179,293179,785,0,0,0,0,0,0,0,0,0,0,0,0,0,0
361,ORANGE,361,0016,3610016,7271,3563,3081,482,14,34,294,328,2729,2388,341,8,21,194,215
113,DALLAS,113,3094,1133094,2531,42,15,27,3,17,4,20,28,14,14,3,7,0,7
439,TARRANT,439,3417,4393417,8336,4562,2437,2125,429,673,890,1520,3149,1765,1384,282,427,588,994
291,LIBERTY,291,0007,2910007,6444,3001,1564,1437,42,411,931,1332,2181,1235,946,26,266,599,864
363,PALO PINTO,363,0008,3630008,7297,2166,1836,330,21,18,218,228,1713,1475,238,15,15,148,158
113,DALLAS,113,3610,1133610,2614,789,167,622,4,374,232,602,622,154,468,2,283,173,455
201,HARRIS,201,0501,2010501,4718,3115,2090,1025,272,191,512,695,2546,1748,798,197,160,397,553
257,KAUFMAN,257,0011,2570011,6232,3514,2193,1321,66,471,692,1130,2493,1689,804,40,284,397,667
61,CAMERON,61,0054,610054,1466,6965,305,6660,72,59,6524,6562,5271,261,5010,62,32,4895,4921
147,FANNIN,147,0001,1470001,3570,5164,3149,2015,37,966,935,1889,4558,2758,1800,31,914,789,1696
355,NUECES,355,0073,3550073,7188,2370,221,2149,17,77,2064,2118,1815,182,1633,17,44,1572,1604
113,DALLAS,113,4062,1134062,2720,4929,191,4738,11,62,4670,4705,3543,168,3375,11,38,3328,3356
439,TARRANT,439,3359,4393359,8316,2930,2162,768,398,76,196,267,2068,1605,463,249,56,108,160
141,EL PASO,141,0088,1410088,3401,7440,3171,4269,768,1382,1958,3123,5242,2181,3061,616,951,1341,2129
61,CAMERON,61,0074,610074,1486,10708,230,10478,40,42,10416,10425,7218,161,7057,25,25,7013,7020
73,CHEROKEE,73,0046,730046,1592,1091,820,271,3,81,164,245,851,669,182,2,66,95,161
439,TARRANT,439,2613,4392613,8210,4307,616,3691,637,1899,1149,2996,2981,461,2520,468,1276,762,2019
285,LAVACA,285,0119,2850119,6401,1037,817,220,6,47,136,181,823,660,163,2,36,100,134
299,LLANO,299,0109,2990109,6507,3328,2966,362,29,28,216,238,3105,2826,279,28,19,154,172
201,HARRIS,201,0375,2010375,4592,12491,1162,11329,99,507,10768,11200,8298,969,7329,77,361,6911,7233
67,CASS,67,0005,670005,1529,1019,816,203,6,109,57,161,836,695,141,6,81,37,113
485,WICHITA,485,0209,4850209,9338,263,82,181,8,127,55,171,187,63,124,7,82,37,118
439,TARRANT,439,3172,4393172,8273,5120,2753,2367,144,720,1356,2038,3840,2268,1572,110,446,905,1326
439,TARRANT,439,3585,4393585,8379,31,8,23,2,7,9,15,28,7,21,2,6,8,14
293,LIMESTONE,293,0104,2930104,6464,902,800,102,15,23,39,61,794,704,90,14,17,32,49
29,BEXAR,29,3138,293138,742,182,77,105,4,20,81,97,71,36,35,3,6,26,29
61,CAMERON,61,0011,610011,1423,3929,105,3824,10,14,3789,3796,2861,92,2769,8,7,2745,2749
113,DALLAS,113,4141,1134141,2783,180,113,67,14,16,31,47,147,99,48,14,15,16,31
141,EL PASO,141,0025,1410025,3338,5514,1154,4360,284,304,3781,4024,4563,1043,3520,236,221,3059,3239
201,HARRIS,201,1118,2011118,5336,6496,535,5961,425,3657,1854,5391,4853,454,4399,354,2634,1376,3930
201,HARRIS,201,0249,2010249,4466,6363,2352,4011,106,1141,2696,3740,4749,2017,2732,84,757,1802,2522
359,OLDHAM,359,0202,3590202,7251,222,169,53,3,10,29,39,168,134,34,2,6,19,25
113,DALLAS,113,3980,1133980,2657,6032,2517,3515,1504,839,1070,1887,4405,1966,2439,1080,543,719,1261
29,BEXAR,29,4037,294037,848,3584,155,3429,35,1178,2282,3378,2613,128,2485,25,962,1519,2444
29,BEXAR,29,3075,293075,679,3430,2214,1216,235,62,915,960,2804,1903,901,156,34,681,710
439,TARRANT,439,4093,4394093,8442,5273,317,4956,22,122,4816,4896,3667,273,3394,13,75,3296,3347
439,TARRANT,439,2134,4392134,8084,3565,461,3104,746,1408,976,2330,2678,356,2322,610,1044,679,1692
141,EL PASO,141,0212,1410212,3527,3275,319,2956,105,310,2580,2840,2058,235,1823,79,174,1585,1741
259,KENDALL,259,4100,2594100,6275,3317,2610,707,27,13,598,608,2722,2190,532,24,4,443,447
479,WEBB,479,0345,4790345,9275,2910,137,2773,28,15,2721,2729,2199,106,2093,19,11,2054,2059
85,COLLIN,85,0089,850089,1718,4633,2115,2518,1873,293,285,569,3593,1730,1863,1405,211,196,402
303,LUBBOCK,303,0059,3030059,6570,5600,2519,3081,173,648,2192,2764,4259,2107,2152,150,396,1515,1894
113,DALLAS,113,3051,1133051,2488,1261,34,1227,3,772,457,1219,945,31,914,1,641,277,910
363,PALO PINTO,363,0027,3630027,7314,2708,2090,618,27,80,442,502,2080,1665,415,23,53,289,331
209,HAYS,209,0442,2090442,5505,4019,3084,935,247,85,501,581,3116,2470,646,183,50,343,390
469,VICTORIA,469,0003,4690003,9123,1920,855,1065,17,99,940,1024,1536,752,784,12,66,688,752
29,BEXAR,29,3012,293012,616,1616,895,721,94,78,537,600,1220,714,506,57,47,372,415
473,WALLER,473,0311,4730311,9186,6106,41,6065,23,5472,450,5911,5955,37,5918,13,5369,415,5774
367,PARKER,367,0435,3670435,7377,4320,3542,778,76,45,520,558,2978,2522,456,41,19,299,317
309,MCLENNAN,309,0001,3090001,6633,804,328,476,49,230,204,413,658,291,367,43,164,154,310
201,HARRIS,201,1055,2011055,5273,5346,1899,3447,1162,1191,1036,2185,3822,1466,2356,786,834,701,1509
85,COLLIN,85,0026,850026,1655,2589,952,1637,177,373,1028,1388,1935,801,1134,141,229,710,931
113,DALLAS,113,2809,1132809,2425,5466,2059,3407,1292,1070,1015,2021,4373,1834,2539,943,814,740,1523
439,TARRANT,439,2356,4392356,8147,5009,2196,2813,490,1223,1058,2214,4004,1897,2107,389,907,755,1632
141,EL PASO,141,0151,1410151,3464,4729,75,4654,17,53,4584,4606,3539,60,3479,8,37,3423,3445
273,KLEBERG,273,0043,2730043,6338,2334,182,2152,22,29,2117,2125,1792,148,1644,17,17,1617,1623
373,POLK,373,0007,3730007,7403,1402,772,630,41,270,293,551,1050,605,445,37,182,205,383
201,HARRIS,201,0312,2010312,4529,10494,3492,7002,2031,2121,2876,4844,8525,3000,5525,1526,1747,2259,3885
491,WILLIAMSON,491,0396,4910396,9504,1965,1840,125,9,15,63,77,1948,1834,114,8,7,61,68
215,HIDALGO,215,0122,2150122,5674,6630,111,6519,15,21,6490,6500,4341,59,4282,6,2,4278,4279
85,COLLIN,85,0215,850215,1844,4145,2334,1811,81,254,1364,1591,2942,1789,1153,52,164,844,995
309,MCLENNAN,309,0021,3090021,6653,2334,1356,978,213,284,317,599,2071,1206,865,191,223,295,516
157,FORT BEND,157,4026,1574026,3759,4068,1700,2368,1681,241,396,626,3154,1368,1786,1269,193,280,469
201,HARRIS,201,0521,2010521,4738,5526,1450,4076,458,1156,2509,3600,4130,1177,2953,352,820,1793,2572
29,BEXAR,29,4097,294097,908,4251,1536,2715,292,685,1788,2395,3068,1215,1853,215,462,1179,1601
215,HIDALGO,215,0165,2150165,5717,1372,98,1274,5,7,1253,1257,1024,88,936,2,4,921,924
113,DALLAS,113,4530,1134530,2823,2038,102,1936,33,520,1385,1895,1258,79,1179,25,310,842,1147
161,FREESTONE,161,0003,1610003,3802,246,190,56,5,15,25,40,179,144,35,3,12,9,21
439,TARRANT,439,4432,4394432,8525,280,153,127,2,63,66,126,251,151,100,1,51,49,99
29,BEXAR,29,4054,294054,865,5553,1802,3751,471,1043,2269,3206,4268,1486,2782,358,769,1622,2343
89,COLORADO,89,0103,890103,1887,915,594,321,5,72,236,303,675,466,209,2,49,148,196
303,LUBBOCK,303,0151,3030151,6610,1345,929,416,6,10,344,350,1003,694,309,5,7,248,251
439,TARRANT,439,4604,4394604,8568,22,4,18,2,6,7,13,15,0,15,2,3,7,10
29,BEXAR,29,4011,294011,822,2450,141,2309,18,656,1672,2274,1739,118,1621,14,493,1126,1599
113,DALLAS,113,4130,1134130,2780,2137,1708,429,88,52,253,303,1714,1405,309,59,26,188,214
201,HARRIS,201,0478,2010478,4695,6872,2801,4071,670,1453,1947,3307,5358,2432,2926,506,1019,1362,2340
91,COMAL,91,0405,910405,1930,7195,4904,2291,113,138,1770,1866,5556,3985,1571,67,79,1181,1238
1,ANDERSON,1,0017,10017,15,1371,841,530,8,207,292,495,1082,698,384,4,168,191,358
113,DALLAS,113,4080,1134080,2737,845,588,257,39,36,165,193,694,498,196,31,24,120,142
439,TARRANT,439,4230,4394230,8482,5205,3775,1430,267,426,697,1093,4569,3417,1152,224,328,549,857
201,HARRIS,201,0435,2010435,4652,5052,3330,1722,606,296,747,1020,4596,3153,1443,479,254,638,877
491,WILLIAMSON,491,0306,4910306,9461,5158,4220,938,156,129,539,649,4096,3416,680,115,101,368,462
303,LUBBOCK,303,0056,3030056,6567,1785,1017,768,14,59,669,717,1314,824,490,7,32,424,455
395,ROBERTSON,395,0008,3950008,7546,284,271,13,1,0,10,10,252,242,10,0,0,8,8
405,SAN AUGUSTINE,405,0010,4050010,7632,519,457,62,4,26,29,53,404,360,44,2,19,18,36
157,FORT BEND,157,3080,1573080,3716,2422,691,1731,1366,206,130,336,1916,601,1315,1033,153,105,258
215,HIDALGO,215,0079,2150079,5631,4300,91,4209,11,23,4185,4192,2728,52,2676,1,12,2665,2669
201,HARRIS,201,0564,2010564,4781,7897,2066,5831,2857,1991,946,2871,7164,1923,5241,2588,1766,846,2563
201,HARRIS,201,0349,2010349,4566,3177,1409,1768,167,564,1014,1524,2496,1157,1339,143,435,720,1135
113,DALLAS,113,4626,1134626,2866,4702,1792,2910,506,299,2021,2305,3647,1559,2088,402,203,1399,1592
113,DALLAS,113,3966,1133966,2651,6149,2460,3689,866,1283,1448,2690,4547,2029,2518,621,829,967,1780
29,BEXAR,29,4140,294140,951,0,0,0,0,0,0,0,0,0,0,0,0,0,0
85,COLLIN,85,0172,850172,1801,7985,4759,3226,259,1038,1661,2654,5577,3514,2063,181,668,1008,1653
485,WICHITA,485,0203,4850203,9332,4194,2554,1640,190,691,650,1303,3431,2169,1262,144,523,492,998
209,HAYS,209,0438,2090438,5502,777,474,303,178,6,105,110,470,286,184,110,5,62,66
293,LIMESTONE,293,0406,2930406,6481,197,189,8,0,2,4,4,184,178,6,0,0,2,2
489,WILLACY,489,0010,4890010,9375,335,240,95,0,1,86,87,299,223,76,0,1,67,68
85,COLLIN,85,0086,850086,1715,4082,2222,1860,851,546,392,911,3250,1871,1379,641,393,277,652
213,HENDERSON,213,04LP,21304LP,5545,3710,2911,799,43,322,315,619,2993,2461,532,27,233,180,404
387,RED RIVER,387,0017,3870017,7503,550,462,88,7,24,26,48,449,376,73,5,19,22,39
439,TARRANT,439,4498,4394498,8542,660,587,73,13,13,40,52,518,463,55,10,8,30,38
157,FORT BEND,157,2090,1572090,3673,885,396,489,52,297,139,426,730,358,372,43,227,89,315
29,BEXAR,29,3173,293173,779,5264,2047,3217,663,358,2226,2525,3855,1588,2267,435,227,1574,1782
491,WILLIAMSON,491,0333,4910333,9478,1004,584,420,224,55,145,192,712,441,271,128,42,95,133
201,HARRIS,201,0392,2010392,4609,1816,27,1789,10,1459,348,1774,1369,17,1352,9,1141,213,1340
439,TARRANT,439,4087,4394087,8439,1503,106,1397,6,34,1358,1383,1087,88,999,4,28,966,990
121,DENTON,121,2108,1212108,3032,3758,960,2798,560,549,1661,2195,2730,829,1901,409,388,1076,1460
441,TAYLOR,441,0404,4410404,8628,3947,2217,1730,55,306,1317,1563,3039,1855,1184,41,201,879,1068
215,HIDALGO,215,0225,2150225,5777,682,28,654,6,1,647,647,480,23,457,4,1,451,451
29,BEXAR,29,4157,294157,968,2514,526,1988,37,65,1883,1930,2052,483,1569,22,54,1480,1525
113,DALLAS,113,4651,1134651,2883,373,23,350,5,10,337,344,251,14,237,1,5,233,235
201,HARRIS,201,0729,2010729,4947,560,388,172,45,19,98,116,506,362,144,34,16,82,97
177,GONZALES,177,0003,1770003,3968,2830,923,1907,15,146,1744,1867,2127,797,1330,13,119,1186,1293
417,SHACKELFORD,417,0101A,4170101A,7692,284,232,52,3,11,34,45,188,159,29,0,2,24,26
161,FREESTONE,161,0011C,1610011C,3819,0,0,0,0,0,0,0,0,0,0,0,0,0,0
225,HOUSTON,225,0007,2250007,5883,1276,948,328,14,153,127,275,977,762,215,10,104,71,172
39,BRAZORIA,39,0047,390047,1160,4860,2011,2849,228,608,1952,2529,3476,1567,1909,136,402,1286,1675
321,MATAGORDA,321,0005,3210005,6756,3008,1751,1257,21,320,872,1168,2251,1342,909,16,240,604,836
495,WINKLER,495,0301,4950301,9564,1956,800,1156,24,56,1074,1109,1414,642,772,18,42,703,735
215,HIDALGO,215,0139,2150139,5691,1121,74,1047,1,4,1031,1033,895,63,832,1,2,816,818
201,HARRIS,201,0624,2010624,4841,2313,1128,1185,117,353,689,1011,1570,828,742,82,215,418,616
423,SMITH,423,0034,4230034,7755,2239,376,1863,31,1029,807,1811,1632,340,1292,19,771,498,1256
201,HARRIS,201,0667,2010667,4884,2976,1643,1333,205,297,831,1097,2399,1411,988,167,231,570,781
451,TOM GREEN,451,0319,4510319,8691,5241,3253,1988,172,277,1481,1717,4090,2699,1391,128,179,1015,1182
121,DENTON,121,1045,1211045,2969,4911,3131,1780,154,452,998,1430,3774,2532,1242,99,305,683,972
505,ZAPATA,505,001B,505001B,9627,134,4,130,1,4,126,127,85,4,81,0,4,80,81
167,GALVESTON,167,0420,1670420,3905,5179,2652,2527,284,714,1433,2119,3745,2035,1710,228,459,941,1389
201,HARRIS,201,0538,2010538,4755,3785,181,3604,46,2642,948,3528,2926,162,2764,38,2108,620,2697
113,DALLAS,113,1135,1131135,2096,3733,125,3608,11,788,2799,3574,2668,113,2555,8,636,1895,2526
217,HILL,217,0009,2170009,5820,2122,1307,815,12,119,618,727,1730,1108,622,12,96,448,539
181,GRAYSON,181,0306,1810306,4011,6222,5038,1184,73,72,695,760,4675,3964,711,46,32,390,420
439,TARRANT,439,3671,4393671,8396,1251,983,268,42,48,137,183,997,807,190,29,34,95,129
381,RANDALL,381,0111,3810111,7460,9444,3290,6154,605,640,4796,5340,6707,2747,3960,416,357,3042,3368
21,BASTROP,21,2016,212016,161,3710,2816,894,46,132,635,751,2886,2262,624,24,102,425,519
479,WEBB,479,0312,4790312,9269,2544,38,2506,6,17,2473,2479,1732,29,1703,3,9,1678,1681
215,HIDALGO,215,0036,2150036,5588,5669,175,5494,27,34,5439,5451,4182,127,4055,17,21,4017,4027
439,TARRANT,439,3398,4393398,8333,2566,1668,898,130,181,509,680,1963,1339,624,107,115,342,452
307,MCCULLOCH,307,0202,3070202,6627,122,108,14,0,1,10,10,105,93,12,0,1,8,8
113,DALLAS,113,1051,1131051,2033,325,197,128,15,24,79,100,282,192,90,9,13,52,64
373,POLK,373,0001,3730001,7397,597,517,80,0,12,48,60,476,413,63,0,10,37,47
329,MIDLAND,329,0109,3290109,6819,1867,448,1419,45,114,1247,1334,1290,350,940,27,73,810,878
303,LUBBOCK,303,0008,3030008,6524,4579,2494,2085,460,498,1035,1497,4182,2300,1882,405,461,928,1357
5,ANGELINA,5,0006,50006,32,1554,925,629,5,153,498,599,1273,763,510,2,130,415,493
37,BOWIE,37,004D,37004D,1097,139,53,86,6,43,34,76,100,44,56,4,23,26,49
399,RUNNELS,399,0008,3990008,7589,845,626,219,4,24,177,200,696,531,165,1,21,131,152
201,HARRIS,201,0372,2010372,4589,2315,102,2213,190,1147,916,2019,1708,93,1615,169,855,614,1445
85,COLLIN,85,0066,850066,1695,3398,1784,1614,223,359,952,1300,2651,1517,1134,180,239,653,889
121,DENTON,121,1005,1211005,2929,15,1,14,1,1,8,8,8,1,7,1,0,5,5
29,BEXAR,29,4203,294203,1014,363,166,197,21,27,147,173,347,164,183,21,27,133,159
439,TARRANT,439,3582,4393582,8376,108,46,62,12,10,32,38,85,41,44,9,4,26,28
85,COLLIN,85,0109,850109,1738,6069,3372,2697,1570,456,593,1039,4733,2767,1966,1148,341,416,754
293,LIMESTONE,293,0101,2930101,6461,2988,1796,1192,30,527,616,1113,2304,1475,829,18,370,399,765
201,HARRIS,201,0584,2010584,4801,4449,54,4395,13,3015,1364,4341,3359,48,3311,6,2444,852,3273
29,BEXAR,29,4160,294160,971,4335,585,3750,126,1233,2501,3602,2914,442,2472,93,781,1633,2353
113,DALLAS,113,4654,1134654,2886,4491,511,3980,57,188,3739,3905,3156,427,2729,41,136,2545,2671
439,TARRANT,439,4020,4394020,8419,3962,2013,1949,133,348,1341,1676,2976,1673,1303,103,243,862,1095
299,LLANO,299,0101,2990101,6504,295,245,50,3,2,35,36,235,197,38,2,1,24,25
497,WISE,497,0002,4970002,9567,4861,3114,1747,67,106,1483,1571,3578,2435,1143,45,55,966,1012
29,BEXAR,29,4034,294034,845,2968,443,2525,33,512,2008,2475,2292,394,1898,25,422,1463,1858
309,MCLENNAN,309,0041,3090041,6673,2770,1541,1229,43,503,651,1120,2353,1407,946,38,410,459,855
113,DALLAS,113,4603,1134603,2843,224,29,195,0,4,191,195,151,22,129,0,4,125,129
201,HARRIS,201,0541,2010541,4758,4803,257,4546,263,3855,479,4245,3884,230,3654,239,3056,392,3385
439,TARRANT,439,4703,4394703,8588,5706,2215,3491,378,936,2125,2975,3852,1590,2262,273,561,1365,1891
155,FOARD,155,0301,1550301,3610,272,215,57,2,3,47,48,224,181,43,2,1,35,35
201,HARRIS,201,0458,2010458,4675,4304,154,4150,70,1583,2541,4073,3081,134,2947,58,1229,1678,2882
113,DALLAS,113,4107,1134107,2760,322,3,319,3,52,263,314,236,3,233,2,42,188,229
157,FORT BEND,157,3131A,1573131A,3736,2293,874,1419,618,323,460,769,1874,763,1111,477,259,350,599
439,TARRANT,439,4288,4394288,8502,1054,40,1014,4,228,777,995,709,27,682,3,147,523,668
29,BEXAR,29,4077,294077,888,8541,1269,7272,154,1299,5928,7053,5803,1030,4773,106,858,3823,4608
157,FORT BEND,157,3011,1573011,3693,2054,1010,1044,636,137,257,385,1613,805,808,514,95,176,266
85,COLLIN,85,0235,850235,1864,3269,1103,2166,1582,273,261,523,2381,897,1484,1084,176,184,354
367,PARKER,367,0235,3670235,7354,1488,1175,313,19,25,186,211,1183,961,222,9,14,132,146
491,WILLIAMSON,491,0144,4910144,9395,1213,526,687,46,135,493,618,904,412,492,37,87,353,436
215,HIDALGO,215,0013,2150013,5565,8781,690,8091,365,186,7556,7682,6650,590,6060,301,135,5609,5712
15,AUSTIN,15,0103,150103,118,1960,1486,474,10,138,279,406,1577,1250,327,8,95,188,276
29,BEXAR,29,3193,293193,799,239,126,113,13,7,87,94,176,108,68,7,7,53,60
303,LUBBOCK,303,0033,3030033,6547,4907,3160,1747,40,52,1537,1576,3534,2333,1201,20,29,1053,1078
209,HAYS,209,0340,2090340,5482,3261,2067,1194,78,152,928,1058,2811,1833,978,68,126,751,866
453,TRAVIS,453,0134,4530134,8734,4065,1540,2525,504,620,1384,1959,3357,1414,1943,411,477,1022,1470
121,DENTON,121,2088,1212088,3012,3659,1811,1848,144,407,1190,1576,2838,1501,1337,107,259,874,1122
85,COLLIN,85,0023,850023,1652,7236,1740,5496,1056,1634,2735,4313,5638,1569,4069,855,1244,1909,3113
113,DALLAS,113,4059,1134059,2717,1155,66,1089,47,332,713,1039,735,38,697,43,214,443,653
307,MCCULLOCH,307,0401,3070401,6630,1264,802,462,8,27,411,432,950,629,321,7,15,285,300
93,COMANCHE,93,0016,930016,1947,118,105,13,0,2,5,7,89,80,9,0,1,2,3
331,MILAM,331,0212,3310212,6862,3617,1626,1991,22,783,1166,1911,2827,1385,1442,17,591,797,1376
395,ROBERTSON,395,0004,3950004,7543,875,698,177,22,48,103,147,680,544,136,19,37,72,109
167,GALVESTON,167,0206,1670206,3862,6426,3316,3110,660,950,1404,2301,5571,3038,2533,587,752,1074,1798
491,WILLIAMSON,491,0302,4910302,9458,1309,694,615,457,21,116,137,892,519,373,275,16,70,86
25,BEE,25,0006,250006,181,1619,663,956,11,28,882,899,1250,537,713,10,13,651,663
113,DALLAS,113,4077,1134077,2734,1592,526,1066,49,107,907,1004,1257,457,800,42,89,660,744
485,WICHITA,485,0402,4850402,9352,1301,851,450,31,112,270,377,970,704,266,19,59,155,213
491,WILLIAMSON,491,0189,4910189,9415,6652,3198,3454,1872,300,1185,1439,4501,2275,2226,1221,193,717,886
451,TOM GREEN,451,0106,4510106,8671,3369,838,2531,25,136,2336,2451,2401,679,1722,14,88,1577,1657
215,HIDALGO,215,0182,2150182,5734,6482,112,6370,15,13,6347,6349,3645,68,3577,8,6,3562,3564
409,SAN PATRICIO,409,0105,4090105,7649,2729,334,2395,6,39,2338,2371,1931,284,1647,5,29,1600,1626
221,HOOD,221,0103,2210103,5840,4383,3519,864,50,55,604,652,3509,2922,587,43,26,388,409
453,TRAVIS,453,0110,4530110,8714,4509,1307,3202,151,1649,1420,3022,3612,1184,2428,124,1258,1041,2272
29,BEXAR,29,4051,294051,862,2169,1128,1041,97,220,703,905,1875,1037,838,80,183,546,720
159,FRANKLIN,159,0402,1590402,3799,1061,822,239,16,20,137,153,868,712,156,6,9,88,95
491,WILLIAMSON,491,0422,4910422,9521,7077,3262,3815,523,1164,2088,3165,5198,2525,2673,359,804,1427,2190
325,MEDINA,325,004A,325004A,6799,2712,1305,1407,8,32,1324,1346,2044,1052,992,1,21,929,943
401,RUSK,401,0316,4010316,7606,766,605,161,2,95,44,138,603,489,114,1,74,24,98
419,SHELBY,419,009S,419009S,7712,1374,1007,367,6,175,130,303,1065,802,263,2,136,77,213
9,ARCHER,9,0001,90001,75,1984,1746,238,16,21,115,131,1507,1355,152,9,12,71,80
87,COLLINGSWORTH,87,0402,870402,1884,124,100,24,1,5,19,23,101,86,15,1,3,11,14
215,HIDALGO,215,0056,2150056,5608,4444,136,4308,14,23,4268,4278,3112,99,3013,6,13,2988,2996
101,COTTLE,101,0201,1010201,1990,349,256,93,3,26,62,85,266,221,45,1,11,30,39
85,COLLIN,85,0192,850192,1821,3887,2578,1309,66,230,849,1078,2753,1922,831,44,132,536,668
315,MARION,315,0003,3150003,6736,933,665,268,8,148,59,205,724,539,185,8,107,38,143
373,POLK,373,0021,3730021,7417,3736,2701,1035,38,291,602,881,2988,2228,760,34,215,413,625
157,FORT BEND,157,1142,1571142,3630,8001,3197,4804,2666,445,1598,2008,5262,2153,3109,1712,279,1043,1306
441,TAYLOR,441,0109,4410109,8608,421,357,64,1,13,31,43,326,285,41,1,9,18,26
1,ANDERSON,1,0013,10013,12,3109,1711,1398,42,588,724,1294,2276,1399,877,29,371,424,787
381,RANDALL,381,0324,3810324,7480,6652,5012,1640,116,217,1113,1305,5118,4001,1117,79,130,730,853
85,COLLIN,85,0129,850129,1758,7174,3868,3306,599,1562,1042,2551,5293,3022,2271,430,1048,688,1705
201,HARRIS,201,0415,2010415,4632,3223,2100,1123,309,247,519,740,2742,1841,901,260,201,394,578
215,HIDALGO,215,0119,2150119,5671,2150,35,2115,2,8,2107,2111,1551,25,1526,1,8,1518,1522
145,FALLS,145,0401,1450401,3567,893,740,153,5,25,101,124,666,561,105,4,5,76,81
113,DALLAS,113,1080,1131080,2053,2463,219,2244,13,1249,977,2207,1815,193,1622,10,952,653,1589
439,TARRANT,439,4508,4394508,8545,7370,3305,4065,900,1130,1876,2929,5523,2728,2795,636,739,1257,1963
439,TARRANT,439,3160,4393160,8270,6317,2065,4252,915,1104,1714,2768,4685,1735,2950,671,730,1168,1871
201,HARRIS,201,0266,2010266,4483,7246,897,6349,71,547,5761,6253,5076,785,4291,61,333,3896,4208
283,LA SALLE,283,0006,2830006,6398,621,108,513,2,4,506,506,462,85,377,0,2,372,372
167,GALVESTON,167,2321,1672321,3928,0,0,0,0,0,0,0,0,0,0,0,0,0,0
113,DALLAS,113,3205,1133205,2568,2967,148,2819,65,1792,996,2755,2182,125,2057,42,1324,702,2011
29,BEXAR,29,3049,293049,653,2700,1825,875,71,98,639,722,2120,1469,651,55,74,465,534
29,BEXAR,29,3135,293135,739,1422,567,855,55,144,650,785,1211,540,671,53,89,519,606
111,DALLAM,111,0004,1110004,2013,85,74,11,0,0,11,11,62,52,10,0,0,10,10
141,EL PASO,141,0191,1410191,3504,946,62,884,12,36,836,862,633,55,578,10,24,541,561
201,HARRIS,201,0647,2010647,4864,13289,457,12832,4620,4996,3338,8188,9721,364,9357,3815,3310,2288,5527
13,ATASCOSA,13,0004,130004,98,2141,518,1623,13,27,1576,1596,1527,413,1114,9,23,1073,1091
479,WEBB,479,0239,4790239,9249,3906,114,3792,33,19,3736,3747,2999,94,2905,25,12,2868,2875
323,MAVERICK,323,002D,323002D,6779,211,10,201,3,6,194,195,155,10,145,1,3,141,141
207,HASKELL,207,0004,2070004,5419,414,279,135,3,22,105,119,341,225,116,2,16,87,100
365,PANOLA,365,0027,3650027,7334,2220,1054,1166,35,746,369,1106,1672,836,836,20,564,234,794
421,SHERMAN,421,0101,4210101,7715,150,73,77,1,7,67,72,117,66,51,1,4,46,48
167,GALVESTON,167,0354,1670354,3885,7221,4046,3175,574,716,1737,2412,5411,3154,2257,423,520,1163,1669
5,ANGELINA,5,0028,50028,55,1582,1122,460,12,87,342,427,1217,896,321,8,66,229,294
447,THROCKMORTON,447,4006,4474006,8651,236,191,45,3,4,34,37,178,150,28,2,1,19,20
121,DENTON,121,1025,1211025,2949,3393,1475,1918,1342,205,315,509,2181,1028,1153,790,140,183,321
215,HIDALGO,215,0205,2150205,5757,1050,17,1033,0,6,1030,1030,686,9,677,0,4,674,674
91,COMAL,91,0402,910402,1927,6292,4896,1396,110,79,934,996,5234,4248,986,68,51,649,692
439,TARRANT,439,1059,4391059,7861,1572,175,1397,195,539,676,1197,1091,155,936,98,403,437,832
149,FAYETTE,149,0207,1490207,3590,2257,1861,396,3,75,268,336,1914,1635,279,1,48,181,229
201,HARRIS,201,0309,2010309,4526,6030,4472,1558,702,183,555,732,4029,3012,1017,437,142,367,507
85,COLLIN,85,0003,850003,1632,6624,1070,5554,117,1478,3960,5350,4774,940,3834,75,1006,2701,3675
113,DALLAS,113,4527,1134527,2820,4876,643,4233,42,110,4061,4150,3440,563,2877,34,71,2745,2804
209,HAYS,209,0231,2090231,5462,6508,2234,4274,221,520,3574,4003,4419,1692,2727,142,352,2229,2537
497,WISE,497,0023,4970023,9587,3226,2524,702,14,45,463,498,2410,1944,466,13,19,292,307
399,RUNNELS,399,0005,3990005,7586,224,181,43,2,1,35,36,186,160,26,2,1,19,20
201,HARRIS,201,0604,2010604,4821,5707,4118,1589,74,198,1090,1270,4340,3319,1021,45,121,674,790
29,BEXAR,29,4180,294180,991,8,0,8,1,4,7,7,4,0,4,1,0,3,3
157,FORT BEND,157,4015,1574015,3756,2490,1082,1408,43,128,1219,1333,1843,892,951,22,100,809,901
29,BEXAR,29,3092,293092,696,3079,2212,867,85,40,680,711,2492,1856,636,56,29,498,519
157,FORT BEND,157,3071,1573071,3713,1258,146,1112,747,206,152,356,837,106,731,515,117,90,206
303,LUBBOCK,303,0052,3030052,6564,4817,3009,1808,189,239,1301,1503,3405,2246,1159,122,141,800,933
201,HARRIS,201,0432,2010432,4649,9341,948,8393,293,923,7168,8014,6840,795,6045,232,722,5067,5751
215,HIDALGO,215,0076,2150076,5628,98,13,85,0,1,82,83,61,12,49,0,1,46,47
201,HARRIS,201,0475,2010475,4692,2408,422,1986,380,293,1320,1591,1780,342,1438,285,205,944,1143
297,LIVE OAK,297,0012,2970012,6501,169,125,44,0,1,34,34,136,102,34,0,1,25,25
439,TARRANT,439,4596,4394596,8565,295,32,263,77,3,177,180,211,28,183,65,1,114,115
113,DALLAS,113,4127,1134127,2777,598,504,94,34,9,42,50,478,410,68,19,9,26,34
309,MCLENNAN,309,0018,3090018,6650,1905,1065,840,164,305,347,630,1702,994,708,151,243,284,517
387,RED RIVER,387,0005,3870005,7500,2253,1975,278,10,60,117,173,1731,1546,185,8,34,67,99
405,SAN AUGUSTINE,405,0007,4050007,7629,443,357,86,3,37,42,76,353,294,59,1,27,27,52
215,HIDALGO,215,0162,2150162,5714,1002,219,783,78,21,687,703,801,193,608,57,12,537,547
113,DALLAS,113,3206,1133206,2569,3354,1176,2178,98,730,1326,2030,2605,1053,1552,77,563,866,1420
21,BASTROP,21,4025,214025,170,4469,1201,3268,25,707,2551,3189,3295,1001,2294,20,499,1744,2227
201,HARRIS,201,0821,2010821,5039,6952,209,6743,103,1495,5281,6614,4573,146,4427,80,1025,3401,4327
285,LAVACA,285,0101,2850101,6399,2004,1613,391,14,210,167,366,1572,1322,250,7,135,104,234
201,HARRIS,201,0036,2010036,4252,8983,529,8454,1090,1575,5926,7344,6465,490,5975,879,1238,3954,5088
251,JOHNSON,251,0009,2510009,6167,1654,1336,318,14,25,199,219,1278,1077,201,5,15,118,133
113,DALLAS,113,1730,1131730,2188,0,0,0,0,0,0,0,0,0,0,0,0,0,0
339,MONTGOMERY,339,0097,3390097,6997,4297,3560,737,81,99,480,574,3216,2684,532,67,63,336,397
141,EL PASO,141,0003,1410003,3316,5733,513,5220,58,94,5048,5125,4228,453,3775,38,67,3652,3709
201,HARRIS,201,1013,2011013,5231,0,0,0,0,0,0,0,0,0,0,0,0,0,0
41,BRAZOS,41,0061,410061,1252,58,48,10,0,5,1,6,41,33,8,0,4,0,4
245,JEFFERSON,245,0033,2450033,6061,5299,2236,3063,74,1205,1691,2863,4289,2010,2279,58,957,1163,2099
29,BEXAR,29,1128,291128,379,5399,1089,4310,78,747,3513,4194,4347,977,3370,67,630,2662,3267
245,JEFFERSON,245,0096,2450096,6124,1158,100,1058,60,416,584,992,829,90,739,47,307,380,686
439,TARRANT,439,1642,4391642,8039,4490,943,3547,268,2102,1179,3210,3180,754,2426,202,1448,762,2180
439,TARRANT,439,1427,4391427,7976,16,10,6,0,1,5,6,13,10,3,0,1,2,3
201,HARRIS,201,0907,2010907,5125,584,84,500,14,395,87,478,347,66,281,10,219,52,267
61,CAMERON,61,0032,610032,1444,5523,906,4617,81,96,4436,4488,4056,775,3281,67,59,3145,3180
355,NUECES,355,0074,3550074,7189,2850,139,2711,20,70,2651,2694,2096,107,1989,13,28,1951,1973
439,TARRANT,439,1271,4391271,7933,4666,3205,1461,129,415,798,1179,3407,2496,911,81,232,492,712
439,TARRANT,439,2448,4392448,8168,5309,1289,4020,877,1696,1440,3086,4031,1071,2960,684,1268,970,2220
29,BEXAR,29,2095,292095,508,3353,1032,2321,96,186,2059,2201,2611,905,1706,66,122,1522,1614
257,KAUFMAN,257,0032,2570032,6253,4012,2154,1858,159,770,814,1549,2676,1527,1149,110,464,481,937
467,VAN ZANDT,467,001B,467001B,9104,5286,4068,1218,13,81,954,1031,3974,3205,769,9,37,594,629
129,DONLEY,129,0101,1290101,3187,820,654,166,2,38,91,127,708,577,131,2,30,69,97
201,HARRIS,201,1099,2011099,5317,27,6,21,0,2,17,18,12,2,10,0,1,9,10
201,HARRIS,201,0884,2010884,5102,1723,72,1651,76,788,795,1567,1257,69,1188,60,580,547,1120
113,DALLAS,113,2131,1132131,2317,3737,1050,2687,259,1312,1082,2348,3237,991,2246,232,1101,865,1942
245,JEFFERSON,245,0010,2450010,6038,1624,280,1344,29,687,630,1298,1226,255,971,21,505,437,936
29,BEXAR,29,1066,291066,316,1723,212,1511,10,22,1477,1491,1294,168,1126,8,13,1102,1112
439,TARRANT,439,1740,4391740,8062,0,0,0,0,0,0,0,0,0,0,0,0,0,0
55,CALDWELL,55,0205,550205,1381,433,341,92,3,19,66,80,342,284,58,2,8,42,49
201,HARRIS,201,0970,2010970,5188,4793,175,4618,122,1306,3224,4453,3383,151,3232,88,1014,2141,3113
351,NEWTON,351,0020,3510020,7103,203,47,156,0,153,0,153,160,32,128,0,125,0,125
453,TRAVIS,453,0371,4530371,8912,3642,2572,1070,267,105,616,703,2790,2037,753,189,56,431,484
143,ERATH,143,0031,1430031,3548,1777,1402,375,13,8,295,301,1437,1177,260,7,4,197,201
251,JOHNSON,251,0031,2510031,6190,2762,1953,809,33,95,546,634,2065,1553,512,16,51,342,389
355,NUECES,355,0011,3550011,7126,989,230,759,5,17,743,750,718,190,528,3,6,518,523
201,HARRIS,201,0101,2010101,4318,3625,197,3428,31,1005,2436,3379,2509,166,2343,24,739,1610,2310
207,HASKELL,207,0005,2070005,5420,584,388,196,1,19,147,163,448,310,138,0,13,99,111
113,DALLAS,113,2046,1132046,2251,2383,1910,473,146,53,209,255,1730,1412,318,107,36,135,165
137,EDWARDS,137,0003,1370003,3253,363,212,151,8,4,134,136,277,182,95,3,2,81,83
453,TRAVIS,453,0447,4530447,8975,2223,1025,1198,99,114,934,1031,1773,899,874,73,95,657,742
113,DALLAS,113,2500,1132500,2380,2472,1618,854,205,116,492,600,2001,1361,640,181,77,343,415
47,BROOKS,47,0002,470002,1315,1883,369,1514,6,8,1487,1493,1541,356,1185,3,6,1165,1171
201,HARRIS,201,0267,2010267,4484,3639,415,3224,27,83,3104,3167,2568,364,2204,19,60,2109,2159
201,HARRIS,201,1036,2011036,5254,63,35,28,18,2,7,9,49,28,21,13,0,7,7
195,HANSFORD,195,0004,1950004,4189,1080,575,505,1,7,488,494,761,430,331,0,6,316,322
41,BRAZOS,41,0064,410064,1255,4452,3417,1035,580,83,284,357,3299,2590,709,416,58,167,220
439,TARRANT,439,2052,4392052,8079,7856,2849,5007,2019,1620,1256,2844,7241,2671,4570,1878,1495,1091,2560
113,DALLAS,113,1403,1131403,2148,99,24,75,1,6,64,70,77,24,53,0,5,45,50
27,BELL,27,0313,270313,233,6413,4350,2063,218,665,1066,1663,5312,3832,1480,165,470,712,1155
61,CAMERON,61,0055,610055,1467,5787,706,5081,36,42,5008,5014,4316,629,3687,23,22,3634,3638
201,HARRIS,201,0781,2010781,4999,8601,527,8074,1631,653,5770,6338,6431,473,5958,1368,441,4104,4500
257,KAUFMAN,257,0029,2570029,6250,4850,1528,3322,115,1922,1281,3113,3165,1086,2079,81,1206,761,1924
439,TARRANT,439,2435,4392435,8165,4458,2058,2400,424,1195,710,1862,3403,1702,1701,287,846,496,1324
339,MONTGOMERY,339,0021,3390021,6914,7592,4120,3472,259,937,2111,2997,6071,3559,2512,191,689,1467,2130
201,HARRIS,201,0118,2010118,4335,4150,1917,2233,647,776,729,1475,2733,1276,1457,435,522,446,953
113,DALLAS,113,2804,1132804,2420,3613,1992,1621,908,163,469,624,2614,1570,1044,591,96,297,386
469,VICTORIA,469,0024,4690024,9144,1924,1400,524,8,60,427,475,1488,1115,373,5,41,300,339
201,HARRIS,201,0161,2010161,4378,1842,93,1749,19,1077,684,1717,1393,77,1316,12,871,462,1297
453,TRAVIS,453,0203,4530203,8786,3650,2465,1185,501,84,545,617,3438,2306,1132,477,79,523,590
29,BEXAR,29,2135,292135,548,1648,313,1335,53,96,1186,1259,1214,265,949,31,77,835,900
439,TARRANT,439,2223,4392223,8105,2293,1625,668,154,236,229,454,1851,1387,464,107,156,156,306
201,HARRIS,201,0993,2010993,5211,0,0,0,0,0,0,0,0,0,0,0,0,0,0
29,BEXAR,29,1151,291151,402,4508,1320,3188,452,708,2049,2670,3024,940,2084,306,431,1306,1714
113,DALLAS,113,3069,1133069,2506,2441,61,2380,21,1879,486,2339,1816,49,1767,14,1467,284,1741
361,ORANGE,361,0017,3610017,7272,3033,2774,259,25,28,132,159,2341,2164,177,17,15,96,111
181,GRAYSON,181,0405,1810405,4020,1503,837,666,106,253,239,482,1092,682,410,62,160,140,297
453,TRAVIS,453,0475,4530475,8998,2768,612,2156,24,92,2035,2114,2007,529,1478,13,77,1367,1440
201,HARRIS,201,0950,2010950,5168,4,0,4,2,1,3,3,4,0,4,2,1,3,3
27,BELL,27,0102,270102,190,7127,4355,2772,202,999,1523,2420,5894,3710,2184,150,865,1102,1904
189,HALE,189,0419,1890419,4166,460,296,164,1,0,151,151,322,204,118,1,0,111,111
439,TARRANT,439,1479,4391479,7996,507,69,438,10,87,341,420,368,62,306,10,77,217,289
121,DENTON,121,4202,1214202,3127,5038,3798,1240,333,274,516,779,3445,2657,788,210,188,300,481
113,DALLAS,113,2086,1132086,2274,3483,2480,1003,188,195,536,718,3053,2207,846,154,149,460,602
347,NACOGDOCHES,347,0026,3470026,7040,7264,2476,4788,92,1828,2789,4582,5193,2041,3152,70,1295,1713,2990
255,KARNES,255,0001,2550001,6207,2504,748,1756,21,105,1644,1712,1862,613,1249,19,72,1159,1209
141,EL PASO,141,0026,1410026,3339,2504,580,1924,65,70,1793,1835,1991,518,1473,49,50,1361,1397
29,BEXAR,29,2010,292010,422,4015,770,3245,125,377,2748,3073,3084,687,2397,94,267,2023,2270
113,DALLAS,113,2153,1132153,2337,2775,1036,1739,140,582,999,1557,2296,943,1353,127,458,743,1188
241,JASPER,241,0015,2410015,6018,3733,3285,448,14,228,111,333,2879,2549,330,12,160,74,231
187,GUADALUPE,187,0219,1870219,4103,149,80,69,0,7,63,67,118,61,57,0,2,53,55
359,OLDHAM,359,0203,3590203,7252,207,178,29,0,1,26,26,177,154,23,0,0,21,21
459,UPSHUR,459,0018,4590018,9061,1221,808,413,7,254,127,372,974,694,280,5,176,77,253
355,NUECES,355,0031,3550031,7146,1309,164,1145,15,57,1058,1104,1035,153,882,13,42,811,847
201,HARRIS,201,1119,2011119,5337,32,0,32,9,2,26,28,18,0,18,8,1,13,14
29,BEXAR,29,2115,292115,528,7602,2454,5148,443,982,3769,4631,5108,1802,3306,259,596,2391,2954
199,HARDIN,199,0012,1990012,4209,1972,1719,253,10,89,113,200,1558,1390,168,9,67,64,129
113,DALLAS,113,2108,1132108,2294,2046,643,1403,63,348,960,1305,1357,491,866,42,208,599,805
439,TARRANT,439,1109,4391109,7890,3437,668,2769,117,185,2431,2609,2598,608,1990,92,147,1716,1857
141,EL PASO,141,0046,1410046,3359,2515,416,2099,90,244,1834,2008,1889,358,1531,67,167,1318,1455
201,HARRIS,201,1056,2011056,5274,5544,2017,3527,1323,849,1311,2128,3697,1410,2287,891,542,818,1339
113,DALLAS,113,2521,1132521,2400,4109,1992,2117,282,454,1325,1759,3045,1598,1447,212,308,889,1183
69,CASTRO,69,0401,690401,1550,1026,139,887,10,22,840,857,701,118,583,10,15,545,558
183,GREGG,183,0013,1830013,4040,5398,3670,1728,56,1035,498,1502,4081,2937,1144,43,682,318,978
203,HARRISON,203,0017,2030017,5400,2314,1059,1255,21,817,355,1160,1863,876,987,16,673,243,909
231,HUNT,231,0217,2310217,5955,2103,1735,368,16,35,260,286,1726,1446,280,15,20,195,209
141,EL PASO,141,0089,1410089,3402,5892,576,5316,118,319,4914,5170,4600,484,4116,86,232,3789,3992
61,CAMERON,61,0075,610075,1487,6763,137,6626,13,29,6595,6602,4705,90,4615,4,17,4600,4605
439,TARRANT,439,1347,4391347,7953,5182,1882,3300,604,1656,1011,2593,3868,1485,2383,455,1209,660,1840
189,HALE,189,0112,1890112,4146,2221,903,1318,9,342,959,1286,2051,827,1224,9,336,874,1197
469,VICTORIA,469,0004,4690004,9124,3389,438,2951,26,366,2591,2896,2365,351,2014,22,237,1750,1968
113,DALLAS,113,2023,1132023,2231,1861,1455,406,82,108,197,291,1662,1323,339,63,88,163,243
455,TRINITY,455,0014,4550014,9018,864,743,121,6,20,58,74,714,629,85,3,8,33,41
355,NUECES,355,0093,3550093,7209,5086,356,4730,90,276,4403,4622,3636,294,3342,58,193,3114,3278
249,JIM WELLS,249,0007,2490007,6144,4001,904,3097,67,35,2969,2983,3002,780,2222,56,18,2118,2128
201,HARRIS,201,0887,2010887,5105,747,489,258,69,59,127,183,726,477,249,67,53,124,176
29,BEXAR,29,1046,291046,296,4164,248,3916,20,90,3814,3872,2996,220,2776,13,41,2714,2749
139,ELLIS,139,1042,1391042,3296,582,394,188,3,59,97,155,446,303,143,1,43,73,115
113,DALLAS,113,3026,1133026,2463,1428,19,1409,7,1024,379,1390,1090,19,1071,6,830,232,1055
479,WEBB,479,0250A,4790250A,9250,5606,177,5429,24,30,5381,5392,3534,114,3420,16,17,3391,3398
473,WALLER,473,0312,4730312,9187,2309,286,2023,13,1327,668,1982,1790,220,1570,10,1098,447,1539
49,BROWN,49,0411,490411,1335,2617,1336,1281,21,151,1068,1194,1950,1072,878,14,100,724,818
113,DALLAS,113,1146,1131146,2105,3199,2615,584,110,91,296,380,2458,2060,398,69,63,195,256
453,TRAVIS,453,0348B,4530348B,8892,627,307,320,172,18,116,134,431,213,218,122,10,73,83
29,BEXAR,29,2178,292178,591,1420,274,1146,24,39,1097,1119,1182,250,932,16,25,901,915
351,NEWTON,351,0002,3510002,7083,515,377,138,0,110,11,121,431,325,106,0,87,3,90
245,JEFFERSON,245,0053,2450053,6081,2263,96,2167,31,1481,666,2134,1706,90,1616,18,1143,464,1600
439,TARRANT,439,2280,4392280,8122,2115,1290,825,85,403,337,710,1803,1185,618,76,298,237,521
201,HARRIS,201,0824,2010824,5042,5336,329,5007,162,1957,2968,4820,3989,277,3712,145,1489,2119,3539
29,BEXAR,29,1109,291109,359,44,7,37,6,2,31,33,19,0,19,1,0,18,18
453,TRAVIS,453,0420,4530420,8955,9155,3061,6094,784,882,4329,5103,7726,2862,4864,618,696,3428,4051
201,HARRIS,201,0055,2010055,4272,4158,2270,1888,650,371,819,1173,3843,2178,1665,570,323,716,1034
113,DALLAS,113,1710,1131710,2168,4135,163,3972,59,751,3168,3886,2918,127,2791,52,593,2149,2729
135,ECTOR,135,0307,1350307,3233,5518,1365,4153,70,355,3714,3997,3842,1067,2775,44,222,2483,2662
61,CAMERON,61,0012,610012,1424,4506,329,4177,38,27,4112,4120,3493,284,3209,32,23,3155,3163
29,BEXAR,29,2056,292056,468,2438,278,2160,21,34,2103,2127,1878,240,1638,15,18,1597,1611
57,CALHOUN,57,0011,570011,1404,985,816,169,4,3,139,141,889,748,141,3,2,114,115
53,BURNET,53,0012,530012,1361,2787,2034,753,23,58,561,611,2157,1625,532,19,30,382,408
139,ELLIS,139,1022,1391022,3276,5580,2912,2668,71,731,1706,2387,4149,2341,1808,46,493,1118,1593
113,DALLAS,113,2200,1132200,2340,2208,1917,291,100,32,104,133,1665,1484,181,55,20,65,84
29,BEXAR,29,2013,292013,425,2175,113,2062,29,46,1999,2029,1664,97,1567,21,33,1518,1539
41,BRAZOS,41,0084,410084,1275,10,3,7,0,0,7,7,10,3,7,0,0,7,7
439,TARRANT,439,1734,4391734,8059,6181,972,5209,288,3304,1647,4832,4137,784,3353,210,2075,1052,3079
129,DONLEY,129,0303,1290303,3190,399,309,90,4,14,52,62,316,256,60,3,11,34,41
113,DALLAS,113,2000,1132000,2211,53,9,44,0,1,42,42,44,8,36,0,0,34,34
113,DALLAS,113,2128,1132128,2314,3224,1592,1632,134,674,787,1449,2779,1452,1327,118,599,567,1161
349,NAVARRO,349,0405,3490405,7080,1255,955,300,12,59,177,232,977,754,223,8,40,131,170
139,ELLIS,139,1039,1391039,3293,5787,3914,1873,97,671,972,1597,4281,3045,1236,54,415,622,1028
121,DENTON,121,4221,1214221,3147,311,224,87,0,5,68,73,232,173,59,0,2,46,48
245,JEFFERSON,245,0013,2450013,6041,461,8,453,3,422,33,448,360,7,353,0,332,21,352
343,MORRIS,343,0102,3430102,7020,483,211,272,2,237,31,264,389,169,220,2,200,12,212
439,TARRANT,439,1577,4391577,8016,3833,294,3539,34,951,2550,3465,2435,217,2218,21,641,1555,2174
113,DALLAS,113,2307,1132307,2357,1247,507,740,116,135,479,605,992,437,555,83,100,352,448
245,JEFFERSON,245,0056,2450056,6084,4803,3458,1345,183,178,897,1064,3651,2748,903,131,111,575,684
339,MONTGOMERY,339,0078,3390078,6977,7079,4690,2389,881,197,1115,1297,5213,3615,1598,578,135,758,884
355,NUECES,355,0008,3550008,7123,8900,3141,5759,688,506,4543,4961,6699,2586,4113,503,373,3164,3481
201,HARRIS,201,0801,2010801,5019,1003,69,934,55,111,784,878,734,58,676,48,88,549,624
113,DALLAS,113,2049,1132049,2254,2256,1427,829,177,261,353,598,1818,1194,624,132,204,252,450
135,ECTOR,135,0412,1350412,3250,2074,484,1590,29,190,1369,1535,1591,428,1163,24,138,989,1117
29,BEXAR,29,2072,292072,485,4933,1231,3702,190,368,3183,3476,3656,1039,2617,120,242,2235,2452
453,TRAVIS,453,0292,4530292,8849,5477,3789,1688,740,188,626,791,3807,2710,1097,452,144,425,551
199,HARDIN,199,0015,1990015,4212,2973,2443,530,44,144,218,353,2264,1886,378,30,104,137,238
463,UVALDE,463,0013,4630013,9081,4635,594,4041,21,41,3959,3976,3352,448,2904,14,26,2843,2856
201,HARRIS,201,1033,2011033,5251,1200,615,585,150,202,215,408,1009,557,452,113,154,160,312
29,BEXAR,29,1003,291003,253,3399,693,2706,92,89,2520,2595,2888,669,2219,81,72,2052,2116
29,BEXAR,29,1131,291131,382,0,0,0,0,0,0,0,0,0,0,0,0,0,0
251,JOHNSON,251,0028,2510028,6187,2947,2238,709,26,89,502,577,2336,1873,463,20,55,304,355
187,GUADALUPE,187,0128,1870128,4083,5078,3318,1760,139,144,1364,1484,3644,2507,1137,70,100,896,984
47,BROOKS,47,003S,47003S,1318,379,29,350,4,5,337,341,325,24,301,1,4,290,294
453,TRAVIS,453,0416,4530416,8952,3743,2155,1588,158,204,1180,1358,3253,1990,1263,141,158,899,1045
195,HANSFORD,195,0001,1950001,4186,1384,596,788,9,16,749,760,970,463,507,8,12,470,481
61,CAMERON,61,0009,610009,1421,7653,279,7374,18,48,7298,7324,5589,238,5351,8,32,5291,5313
201,HARRIS,201,0930,2010930,5148,1395,24,1371,14,315,1040,1349,1006,17,989,10,260,715,973
439,TARRANT,439,1189,4391189,7913,3788,1354,2434,271,661,1468,2105,2923,1198,1725,192,487,996,1476
29,BEXAR,29,2158,292158,571,0,0,0,0,0,0,0,0,0,0,0,0,0,0
61,CAMERON,61,0095,610095,1507,892,20,872,4,2,867,869,559,15,544,1,1,543,544
141,EL PASO,141,0109,1410109,3422,2518,358,2160,58,129,2020,2104,2024,322,1702,47,84,1596,1653
269,KING,269,0002,2690002,6316,67,53,14,1,3,11,13,41,31,10,1,1,9,9
113,DALLAS,113,3006,1133006,2443,5861,4204,1657,495,431,617,1032,5667,4104,1563,469,413,567,968
201,HARRIS,201,0141,2010141,4358,860,162,698,6,33,646,675,602,134,468,5,16,435,449
201,HARRIS,201,0098,2010098,4315,5428,3927,1501,107,313,896,1186,3937,2981,956,81,188,535,711
29,BEXAR,29,3030,293030,634,2782,1781,1001,160,78,772,837,2202,1477,725,113,61,547,601
39,BRAZORIA,39,0076,390076,1189,2328,1384,944,27,67,753,812,1755,1139,616,16,45,465,510
113,DALLAS,113,3107,1133107,2549,3857,349,3508,52,2622,876,3444,2846,295,2551,39,1940,590,2505
257,KAUFMAN,257,0009,2570009,6230,2814,1792,1022,26,268,609,873,2197,1494,703,12,208,378,582
439,TARRANT,439,1078,4391078,7870,1851,93,1758,21,847,912,1739,1262,74,1188,13,644,537,1171
453,TRAVIS,453,0231,4530231,8806,4862,4163,699,186,54,350,397,3613,3156,457,106,36,232,265
141,EL PASO,141,0066,1410066,3379,4065,295,3770,49,207,3540,3689,3185,257,2928,39,166,2741,2871
141,EL PASO,141,0172,1410172,3485,7918,196,7722,18,35,7683,7699,5747,153,5594,15,28,5567,5581
73,CHEROKEE,73,0012,730012,1570,2121,1496,625,20,213,352,560,1575,1155,420,13,162,214,372
201,HARRIS,201,1076,2011076,5294,6102,1182,4920,829,1934,2200,4041,4156,866,3290,602,1236,1432,2637
201,HARRIS,201,0013,2010013,4229,7254,2339,4915,166,1279,3420,4591,5315,1967,3348,119,876,2250,3068
333,MILLS,333,0006,3330006,6871,272,208,64,1,0,42,42,220,176,44,1,0,28,28
265,KERR,265,0119,2650119,6293,3106,2268,838,77,39,659,690,2548,1940,608,59,26,472,493
229,HUDSPETH,229,0004,2290004,5935,403,159,244,1,5,226,229,344,136,208,1,3,192,195
453,TRAVIS,453,0392,4530392,8935,2876,2207,669,176,64,353,403,2342,1871,471,128,41,252,279
187,GUADALUPE,187,0401,1870401,4126,3395,1741,1654,114,171,1304,1452,2567,1404,1163,73,118,903,1013
201,HARRIS,201,1139,2011139,5357,7149,435,6714,196,2598,3944,6475,4987,358,4629,158,1774,2716,4456
55,CALDWELL,55,0202,550202,1378,2093,978,1115,28,131,927,1032,1571,811,760,17,83,621,695
439,TARRANT,439,1489,4391489,7999,3904,854,3050,385,1907,774,2613,2958,735,2223,309,1377,525,1871
201,HARRIS,201,0204,2010204,4421,5497,3435,2062,298,382,1314,1654,4581,2919,1662,239,322,1023,1319
201,HARRIS,201,0844,2010844,5062,5858,3788,2070,493,524,951,1450,3823,2572,1251,302,331,552,870
29,BEXAR,29,1089,291089,339,96,4,92,0,0,91,91,82,3,79,0,0,78,78
29,BEXAR,29,2030,292030,442,3001,91,2910,24,73,2832,2878,2028,73,1955,16,42,1905,1935
201,HARRIS,201,0947,2010947,5165,1102,721,381,94,51,227,271,885,593,292,80,32,167,199
355,NUECES,355,0113,3550113,7229,1001,72,929,7,115,818,919,741,53,688,4,86,604,683
457,TYLER,457,0014,4570014,9038,2085,1855,230,19,51,90,140,1635,1465,170,11,39,58,96
245,JEFFERSON,245,0099,2450099,6127,1479,481,998,74,783,147,914,1255,459,796,65,620,108,723
339,MONTGOMERY,339,0039,3390039,6934,7280,5767,1513,110,161,960,1098,5363,4401,962,73,107,585,682
347,NACOGDOCHES,347,0016,3470016,7037,3514,2807,707,87,203,337,535,2737,2229,508,67,156,220,375
41,BRAZOS,41,0021,410021,1212,6050,3221,2829,1386,364,1030,1354,5679,3053,2626,1325,314,943,1221
355,NUECES,355,0051,3550051,7166,4659,833,3826,39,324,3458,3711,3363,736,2627,31,201,2357,2534
245,JEFFERSON,245,0073,2450073,6101,2973,1851,1122,183,566,309,861,2323,1555,768,138,379,211,577
439,TARRANT,439,2219,4392219,8102,3487,1999,1488,445,450,522,955,2663,1611,1052,318,330,329,653
29,BEXAR,29,1026,291026,276,2489,88,2401,12,30,2368,2382,1821,83,1738,7,16,1713,1720
471,WALKER,471,0301,4710301,9167,8628,2735,5893,112,2613,3030,5582,7106,2463,4643,85,2098,2318,4388
427,STARR,427,0010,4270010,7807,5492,66,5426,3,14,5399,5404,3653,31,3622,3,11,3604,3609
239,JACKSON,239,0004,2390004,5998,525,377,148,6,7,116,123,433,321,112,6,4,88,92
349,NAVARRO,349,0203,3490203,7063,3229,1935,1294,36,682,483,1156,2561,1640,921,31,481,332,810
465,VAL VERDE,465,0042,4650042,9101,41,22,19,0,0,19,19,28,19,9,0,0,9,9
355,NUECES,355,0071,3550071,7186,2870,255,2615,14,106,2486,2586,2204,222,1982,13,79,1886,1959
39,BRAZORIA,39,0056,390056,1169,7232,3881,3351,127,994,2134,3026,5319,3025,2294,104,657,1398,2033
29,BEXAR,29,1069,291069,319,1044,318,726,54,106,593,681,859,295,564,41,79,453,525
121,DENTON,121,3160,1213160,3084,4697,3216,1481,299,342,695,1015,3529,2528,1001,211,217,462,663
61,CAMERON,61,0072,610072,1484,6271,318,5953,135,63,5770,5809,4219,218,4001,104,38,3858,3885
201,HARRIS,201,0058,2010058,4275,3473,1888,1585,345,156,1042,1183,2872,1626,1246,263,124,802,921
355,NUECES,355,0054,3550054,7169,2040,152,1888,12,36,1845,1874,1543,136,1407,8,22,1375,1397
141,EL PASO,141,0129,1410129,3442,10082,1178,8904,319,844,7928,8550,6299,839,5460,181,522,4791,5218
201,HARRIS,201,0738,2010738,4956,1464,39,1425,10,1245,204,1410,1039,38,1001,9,862,143,990
439,TARRANT,439,1013,4391013,7850,4090,412,3678,64,1554,2085,3603,2966,374,2592,53,1221,1330,2530
201,HARRIS,201,1053,2011053,5271,2988,369,2619,111,1166,1364,2477,2250,329,1921,93,870,955,1803
457,TYLER,457,0017,4570017,9041,2798,1192,1606,24,938,631,1559,2572,1054,1518,22,883,603,1477
113,DALLAS,113,2602,1132602,2403,6349,1495,4854,2870,1245,696,1909,4986,1301,3685,2254,893,490,1370
453,TRAVIS,453,0387,4530387,8932,4015,2134,1881,580,409,837,1210,3074,1720,1354,397,294,604,881
453,TRAVIS,453,0346,4530346,8889,5889,3886,2003,872,124,875,985,3835,2635,1200,511,82,523,600
187,GUADALUPE,187,0103,1870103,4063,1117,616,501,4,47,418,455,902,555,347,3,31,286,312
201,HARRIS,201,1096,2011096,5314,5108,2788,2320,73,255,1891,2124,3857,2213,1644,48,182,1307,1483
29,BEXAR,29,2033,292033,445,4272,687,3585,10,596,3013,3555,4034,678,3356,10,585,2792,3331
29,BEXAR,29,1086,291086,336,4311,609,3702,124,362,3280,3556,3137,508,2629,94,246,2278,2491
245,JEFFERSON,245,0076,2450076,6104,3199,320,2879,172,1322,1403,2662,2158,260,1898,125,909,879,1749
355,NUECES,355,0028,3550028,7143,315,211,104,2,6,92,96,257,180,77,2,5,66,69
349,NAVARRO,349,0200,3490200,7060,2862,825,2037,35,868,1037,1881,2072,653,1419,23,657,673,1318
113,DALLAS,113,1733,1131733,2191,7391,1998,5393,1171,1098,3092,4123,5498,1703,3795,899,731,2094,2794
51,BURLESON,51,0114,510114,1338,3374,1783,1591,22,411,1108,1508,2525,1457,1068,19,288,712,996
135,ECTOR,135,0304,1350304,3230,1691,225,1466,10,116,1349,1448,1271,201,1070,9,89,976,1054
439,TARRANT,439,2609,4392609,8208,0,0,0,0,0,0,0,0,0,0,0,0,0,0
439,TARRANT,439,2100,4392100,8082,1128,392,736,41,56,627,675,845,351,494,33,41,405,441
201,HARRIS,201,0184,2010184,4401,2790,296,2494,29,389,2070,2437,2152,274,1878,21,340,1514,1842
113,DALLAS,113,3049,1133049,2486,2953,53,2900,16,1642,1255,2879,2224,41,2183,11,1406,778,2169
139,ELLIS,139,1019,1391019,3273,3920,2245,1675,57,205,1332,1502,2898,1797,1101,39,128,859,974
53,BURNET,53,0009,530009,1358,3366,2458,908,24,26,778,792,2745,2110,635,14,15,538,544
201,HARRIS,201,0864,2010864,5082,6740,260,6480,230,1198,5100,6237,4753,220,4533,180,783,3585,4337
123,DEWITT,123,0202,1230202,3167,2195,1179,1016,24,153,818,955,1728,1008,720,24,115,553,663
259,KENDALL,259,4070,2594070,6273,1924,1529,395,24,11,296,304,1596,1315,281,17,7,206,211
57,CALHOUN,57,0008,570008,1401,665,508,157,11,8,116,124,568,457,111,8,7,81,88
135,ECTOR,135,0101,1350101,3210,8181,1907,6274,42,147,6005,6109,5603,1514,4089,27,89,3899,3970
41,BRAZOS,41,0103,410103,1295,1078,815,263,11,23,190,210,750,589,161,6,13,114,125
439,TARRANT,439,2522,4392522,8188,5904,2751,3153,322,1520,1207,2666,4285,2203,2082,241,948,776,1709
201,HARRIS,201,0121,2010121,4338,2736,837,1899,22,267,1587,1845,1920,668,1252,15,169,1042,1209
113,DALLAS,113,2807,1132807,2423,3956,1964,1992,1408,144,378,515,2812,1511,1301,916,94,237,330
439,TARRANT,439,2354,4392354,8145,2778,659,2119,331,684,1095,1755,2029,559,1470,278,480,694,1163
341,MOORE,341,0401,3410401,7017,2127,1097,1030,9,26,953,976,1490,828,662,9,14,605,618
439,TARRANT,439,3035,4393035,8251,4674,3587,1087,368,108,454,544,3643,2899,744,246,75,294,363
273,KLEBERG,273,0041,2730041,6336,2601,358,2243,155,116,1974,2062,1912,298,1614,132,83,1384,1456
337,MONTAGUE,337,0014,3370014,6891,337,295,42,2,4,12,15,268,237,31,2,3,6,8
201,HARRIS,201,0016,2010016,4232,4819,2460,2359,532,815,963,1757,4642,2401,2241,509,773,918,1671
61,CAMERON,61,0052,610052,1464,2485,1563,922,71,67,743,798,2204,1456,748,68,42,600,637
249,JIM WELLS,249,0010,2490010,6147,3528,179,3349,13,54,3285,3321,2547,149,2398,4,30,2362,2381
121,DENTON,121,3117,1213117,3041,3077,500,2577,493,331,1757,2069,2125,432,1693,334,265,1091,1347
29,BEXAR,29,1148,291148,399,2211,344,1867,33,256,1610,1815,1453,266,1187,23,160,1019,1154
113,DALLAS,113,2310,1132310,2360,3186,1645,1541,231,103,1119,1211,2588,1425,1163,194,80,818,890
141,EL PASO,141,0086,1410086,3399,2236,1331,905,319,282,335,486,2199,1327,872,311,269,314,456
439,TARRANT,439,1352,4391352,7956,975,668,307,18,72,179,243,800,586,214,8,40,128,168
453,TRAVIS,453,0472,4530472,8995,6178,2478,3700,228,564,2886,3353,5023,2316,2707,189,426,2045,2415
41,BRAZOS,41,0041,410041,1232,1694,1401,293,88,41,139,174,1257,1084,173,52,17,83,100
29,BEXAR,29,2138,292138,551,2185,480,1705,69,212,1438,1626,1706,436,1270,51,165,1055,1204
29,BEXAR,29,2075,292075,488,2372,62,2310,21,101,2204,2280,1700,48,1652,10,71,1581,1638
201,HARRIS,201,0990,2010990,5208,278,5,273,46,5,227,227,200,5,195,41,5,153,153
121,DENTON,121,4179,1214179,3104,4905,3116,1789,287,487,934,1387,3775,2539,1236,213,328,619,927
191,HALL,191,0201,1910201,4169,95,60,35,3,5,32,35,76,58,18,1,1,17,18
233,HUTCHINSON,233,0014,2330014,5978,2393,1930,463,27,59,298,353,1764,1486,278,21,32,169,201
439,TARRANT,439,1589,4391589,8019,377,169,208,69,87,53,135,317,155,162,49,76,38,112
141,EL PASO,141,0023,1410023,3336,1931,632,1299,59,51,1193,1226,1564,585,979,41,39,901,929
113,DALLAS,113,2111,1132111,2297,41,31,10,4,2,7,9,41,31,10,4,2,7,9
255,KARNES,255,0004,2550004,6210,3901,1133,2768,52,762,1949,2696,3481,1053,2428,42,739,1630,2360
67,CASS,67,0002,670002,1527,527,395,132,4,77,25,101,416,314,102,3,64,14,78
201,HARRIS,201,0927,2010927,5145,5651,3198,2453,454,248,1665,1876,4304,2561,1743,301,166,1194,1346
339,MONTGOMERY,339,0056,3390056,6954,7980,4687,3293,788,686,1674,2303,5772,3549,2223,539,449,1113,1538
459,UPSHUR,459,0015B,4590015B,9058,0,0,0,0,0,0,0,0,0,0,0,0,0,0
141,EL PASO,141,0063,1410063,3376,5743,440,5303,60,318,5027,5239,4263,387,3876,46,219,3659,3826
355,NUECES,355,0091,3550091,7206,6687,2619,4068,390,694,2927,3546,5686,2393,3293,317,585,2320,2865
439,TARRANT,439,2519,4392519,8185,1886,511,1375,251,646,460,1087,1422,431,991,201,465,300,755
201,HARRIS,201,1073,2011073,5291,0,0,0,0,0,0,0,0,0,0,0,0,0,0
29,BEXAR,29,2112,292112,525,2384,658,1726,98,120,1516,1610,1997,598,1399,80,86,1223,1296
439,TARRANT,439,2341,4392341,8142,739,157,582,91,251,245,487,568,126,442,78,185,178,359
201,HARRIS,201,0095,2010095,4312,6213,3030,3183,775,1186,1174,2302,5101,2551,2550,624,947,915,1828
469,VICTORIA,469,0001,4690001,9121,1053,186,867,6,94,773,852,793,153,640,2,75,560,631
257,KAUFMAN,257,0006,2570006,6227,3375,2427,948,26,119,683,790,2654,2039,615,18,69,426,491
463,UVALDE,463,0010,4630010,9078,1755,314,1441,12,25,1396,1409,1314,261,1053,9,15,1017,1026
201,HARRIS,201,1030,2011030,5248,1029,91,938,17,35,886,919,734,85,649,11,24,612,634
113,DALLAS,113,2518,1132518,2397,2349,1380,969,357,329,232,548,1909,1204,705,246,245,159,403
267,KIMBLE,267,0007,2670007,6313,413,352,61,6,7,48,52,371,323,48,5,7,36,40
355,NUECES,355,0048,3550048,7163,2265,500,1765,33,82,1644,1701,1731,459,1272,18,48,1182,1220
29,BEXAR,29,2069,292069,482,6117,908,5209,292,612,4331,4865,4761,801,3960,219,491,3236,3682
113,DALLAS,113,3003,1133003,2440,3256,273,2983,43,1387,1551,2907,2367,230,2137,32,1097,992,2077
259,KENDALL,259,3050,2593050,6270,3223,2354,869,62,41,681,711,2457,1877,580,37,21,453,469
201,HARRIS,201,0138,2010138,4355,2859,69,2790,18,1471,1334,2767,2152,56,2096,11,1223,875,2084
141,EL PASO,141,0149,1410149,3462,4089,160,3929,22,42,3885,3905,3228,134,3094,11,20,3060,3074
201,HARRIS,201,0224,2010224,4441,4379,2160,2219,954,489,740,1194,3639,1797,1842,817,421,569,972
69,CASTRO,69,0206,690206,1547,263,164,99,3,2,91,92,201,133,68,3,2,61,62
201,HARRIS,201,1159,2011159,5377,0,0,0,0,0,0,0,0,0,0,0,0,0,0
113,DALLAS,113,3089,1133089,2526,116,79,37,6,5,15,20,104,72,32,6,5,10,15
29,BEXAR,29,3007,293007,611,5175,1866,3309,1132,418,1771,2133,3736,1455,2281,774,291,1202,1460
61,CAMERON,61,0049,610049,1461,4619,319,4300,25,25,4251,4260,3391,279,3112,18,8,3075,3079
457,TYLER,457,0010,4570010,9035,1570,1379,191,3,65,74,137,1221,1090,131,2,46,44,90
201,HARRIS,201,0052,2010052,4269,4246,2466,1780,611,286,850,1106,3832,2303,1529,495,235,757,968
215,HIDALGO,215,0077,2150077,5629,3828,345,3483,19,17,3450,3460,2692,323,2369,13,8,2345,2352
201,HARRIS,201,0181,2010181,4398,5135,302,4833,25,107,4690,4779,3834,288,3546,21,73,3430,3498
29,BEXAR,29,2155,292155,568,0,0,0,0,0,0,0,0,0,0,0,0,0,0
439,TARRANT,439,2569,4392569,8202,786,45,741,40,221,478,695,520,27,493,33,152,307,456
141,EL PASO,141,0020,1410020,3333,1744,426,1318,37,44,1241,1273,1377,374,1003,28,33,938,964
85,COLLIN,85,0170,850170,1799,2822,1653,1169,276,384,466,826,2014,1242,772,194,246,307,541
201,HARRIS,201,1116,2011116,5334,2823,601,2222,589,437,1206,1613,2021,481,1540,455,301,786,1073
61,CAMERON,61,0092,610092,1504,432,38,394,0,1,392,392,312,31,281,0,0,280,280
29,BEXAR,29,4052,294052,863,3596,1387,2209,176,692,1353,1982,2886,1224,1662,147,511,986,1471
439,TARRANT,439,2205,4392205,8099,3567,2380,1187,127,275,694,939,2807,1988,819,115,160,454,605
201,HARRIS,201,0347,2010347,4564,8019,2017,6002,343,260,5362,5565,5783,1721,4062,262,183,3571,3726
203,HARRISON,203,0011,2030011,5394,940,450,490,8,258,207,464,740,382,358,5,212,128,340
363,PALO PINTO,363,0022,3630022,7309,1382,1104,278,8,15,194,206,1080,905,175,8,6,115,119
489,WILLACY,489,0008,4890008,9373,464,51,413,3,1,407,408,348,45,303,3,1,297,298
85,COLLIN,85,0084,850084,1713,3625,2045,1580,277,686,543,1211,3059,1781,1278,226,566,416,973
381,RANDALL,381,0103,3810103,7458,2778,1525,1253,59,385,722,1093,2624,1460,1164,49,369,666,1023
201,HARRIS,201,0241,2010241,4458,8179,730,7449,153,335,6951,7245,5590,635,4955,138,249,4559,4790
279,LAMB,279,0001,2790001,6373,1717,522,1195,1,12,1174,1183,1217,416,801,1,6,784,790
113,DALLAS,113,3964,1133964,2649,3579,1563,2016,249,839,848,1661,2749,1309,1440,198,574,584,1154
439,TARRANT,439,4077,4394077,8437,339,233,106,1,7,90,96,277,207,70,1,6,57,62
303,LUBBOCK,303,0006,3030006,6522,2767,135,2632,10,1699,988,2608,1881,119,1762,4,1186,584,1752
473,WALLER,473,0106,4730106,9181,2596,930,1666,16,315,1324,1629,1947,818,1129,10,256,846,1097
361,ORANGE,361,0011,3610011,7266,1449,815,634,30,210,359,554,1093,682,411,21,134,233,355
147,FANNIN,147,0018,1470018,3585,5000,3612,1388,65,419,702,1109,3956,3000,956,49,307,451,755
209,HAYS,209,0435,2090435,5500,5347,3507,1840,151,115,1466,1548,3637,2470,1167,92,67,937,993
113,DALLAS,113,3310,1133310,2586,5680,1994,3686,95,955,2536,3461,4151,1671,2480,91,678,1614,2274
29,BEXAR,29,3171,293171,777,0,0,0,0,0,0,0,0,0,0,0,0,0,0
303,LUBBOCK,303,0053,3030053,6565,6597,2772,3825,268,603,2911,3426,5205,2436,2769,206,434,2052,2441
201,HARRIS,201,0433,2010433,4650,1606,269,1337,125,334,896,1207,1201,239,962,83,254,634,873
481,WHARTON,481,0203,4810203,9310,5817,1583,4234,48,1919,2281,4124,4412,1341,3071,34,1380,1644,3002
439,TARRANT,439,3392,4393392,8331,3062,2363,699,219,77,330,399,2244,1792,452,149,57,191,246
85,COLLIN,85,0021,850021,1650,6089,3292,2797,1296,564,795,1334,4895,2794,2101,1006,413,567,961
209,HAYS,209,0221,2090221,5457,5023,2387,2636,138,370,2089,2416,3842,1969,1873,80,266,1485,1726
367,PARKER,367,0400,3670400,7372,4413,3428,985,87,125,653,762,3379,2734,645,54,74,410,474
29,BEXAR,29,3110,293110,714,4322,1723,2599,194,312,2055,2320,3296,1396,1900,147,246,1473,1690
289,LEON,289,0012,2890012,6436,1013,702,311,9,209,61,268,806,562,244,7,169,46,213
387,RED RIVER,387,0011A,3870011A,7501,663,564,99,4,31,32,62,524,449,75,4,22,24,45
215,HIDALGO,215,0034,2150034,5586,1574,74,1500,42,9,1452,1455,1195,67,1128,33,8,1091,1093
439,TARRANT,439,2751,4392751,8245,0,0,0,0,0,0,0,0,0,0,0,0,0,0
273,KLEBERG,273,0024,2730024,6330,2902,583,2319,224,308,1782,2063,2583,527,2056,205,278,1560,1819
371,PECOS,371,0009,3710009,7395,349,144,205,5,3,189,191,229,102,127,5,1,113,114
201,HARRIS,201,0304,2010304,4521,3359,1788,1571,620,178,727,883,2650,1479,1171,472,129,528,646
201,HARRIS,201,0370,2010370,4587,4115,2418,1697,359,335,915,1219,3062,1893,1169,264,212,626,830
213,HENDERSON,213,0001,2130001,5523,1624,814,810,20,225,542,751,1179,668,511,12,147,330,472
291,LIBERTY,291,0030,2910030,6459,3429,1774,1655,35,405,1135,1530,2442,1360,1082,12,299,697,991
157,FORT BEND,157,2030,1572030,3651,3472,1844,1628,259,807,591,1334,2826,1618,1208,213,591,408,971
439,TARRANT,439,3329,4393329,8308,5374,2042,3332,1000,949,1186,2098,4143,1709,2434,753,690,831,1500
157,FORT BEND,157,3078,1573078,3714,1014,71,943,378,314,272,561,793,52,741,336,222,190,399
113,DALLAS,113,3046,1133046,2483,4465,496,3969,57,2169,1734,3854,3247,436,2811,40,1629,1111,2725
113,DALLAS,113,4128,1134128,2778,1520,1204,316,151,13,137,147,1179,967,212,95,5,95,98
61,CAMERON,61,0006,610006,1418,2327,88,2239,17,22,2202,2215,1831,73,1758,17,18,1722,1735
141,EL PASO,141,0209A,1410209A,3522,3238,1430,1808,238,587,895,1393,1808,847,961,150,321,444,730
141,EL PASO,141,0106,1410106,3419,4760,407,4353,65,146,4162,4275,3606,332,3274,44,99,3119,3209
479,WEBB,479,0226,4790226,9244,2005,71,1934,10,14,1913,1920,1507,47,1460,6,8,1443,1449
479,WEBB,479,0340,4790340,9270,3220,246,2974,60,20,2901,2909,2490,207,2283,48,13,2225,2231
77,CLAY,77,0020,770020,1610,589,552,37,1,7,19,26,472,444,28,1,5,13,18
453,TRAVIS,453,0439,4530439,8972,3543,1494,2049,241,342,1464,1763,3186,1406,1780,222,313,1234,1512
439,TARRANT,439,3247,4393247,8291,4387,1622,2765,145,1669,843,2449,3205,1321,1884,110,1099,594,1654
29,BEXAR,29,3070,293070,674,3044,1568,1476,154,167,1156,1281,2527,1391,1136,112,127,882,989
113,DALLAS,113,3313,1133313,2589,5421,1278,4143,247,2139,1734,3821,3845,1102,2743,174,1390,1145,2515
279,LAMB,279,0004,2790004,6376,181,68,113,1,4,106,110,118,50,68,1,0,67,67
201,HARRIS,201,0287,2010287,4504,2472,1455,1017,198,177,607,772,1975,1210,765,159,141,434,569
201,HARRIS,201,0244,2010244,4461,6291,1573,4718,806,1272,2642,3844,4795,1340,3455,653,895,1890,2743
287,LEE,287,0304,2870304,6419,2125,1583,542,23,54,399,443,1617,1256,361,17,32,255,283
201,HARRIS,201,0330,2010330,4547,7885,1506,6379,624,566,5170,5678,5992,1341,4651,533,449,3643,4059
113,DALLAS,113,3805,1133805,2632,7867,305,7562,45,6683,934,7498,5730,262,5468,38,4850,604,5407
273,KLEBERG,273,0033,2730033,6333,612,233,379,34,26,319,337,454,185,269,24,20,220,236
141,EL PASO,141,0169,1410169,3482,7921,185,7736,26,40,7660,7680,5351,134,5217,14,20,5160,5175
71,CHAMBERS,71,0016,710016,1567,3443,2129,1314,27,122,1109,1218,2341,1489,852,14,80,709,781
373,POLK,373,0002,3730002,7398,923,775,148,9,26,86,110,742,635,107,7,11,64,75
113,DALLAS,113,4057,1134057,2715,3320,186,3134,8,247,2864,3101,2427,174,2253,8,195,2034,2227
351,NEWTON,351,0017,3510017,7100,119,24,95,1,91,3,94,106,22,84,1,80,3,83
29,BEXAR,29,3113,293113,717,2176,732,1444,89,180,1142,1313,1860,666,1194,79,153,936,1080
113,DALLAS,113,2801,1132801,2417,4754,2843,1911,843,248,717,949,3601,2292,1309,583,163,477,633
439,TARRANT,439,2827A,4392827A,8248,0,0,0,0,0,0,0,0,0,0,0,0,0,0
139,ELLIS,139,1016,1391016,3270,4257,858,3399,25,999,2314,3271,2932,687,2245,12,679,1487,2160
29,BEXAR,29,4015,294015,826,2949,531,2418,37,102,2276,2353,2450,479,1971,31,73,1864,1922
29,BEXAR,29,1155,291155,408,2838,560,2278,131,364,1841,2143,1979,438,1541,96,237,1222,1436
29,BEXAR,29,4184,294184,995,26,0,26,1,0,25,25,26,0,26,1,0,25,25
37,BOWIE,37,0015,370015,1072,805,701,104,5,62,17,78,625,547,78,5,45,13,57
61,CAMERON,61,0078,610078,1490,6571,830,5741,51,89,5568,5625,4738,685,4053,26,53,3919,3962
215,HIDALGO,215,0189,2150189,5741,3404,85,3319,3,3,3292,3292,2090,65,2025,2,2,2006,2006
257,KAUFMAN,257,0015,2570015,6236,5055,3691,1364,44,200,908,1095,3842,2933,909,36,127,571,694
285,LAVACA,285,0309,2850309,6405,1865,1481,384,9,152,201,346,1402,1163,239,6,111,104,211
339,MONTGOMERY,339,0007,3390007,6900,3434,2146,1288,27,97,1018,1108,2585,1720,865,19,71,667,733
349,NAVARRO,349,0303,3490303,7069,1774,1314,460,17,167,212,376,1401,1070,331,13,132,136,265
423,SMITH,423,0012,4230012,7733,3384,258,3126,14,1508,1622,3093,2229,213,2016,14,1036,969,1989
85,COLLIN,85,0030,850030,1659,6965,4014,2951,523,748,1501,2215,5192,3136,2056,384,483,1037,1513
113,DALLAS,113,2139,1132139,2323,3031,247,2784,83,1043,1654,2678,2143,232,1911,60,780,1062,1829
113,DALLAS,113,1409,1131409,2154,1803,249,1554,31,196,1323,1504,1329,228,1101,24,178,890,1059
121,DENTON,121,1063,1211063,2987,2718,1672,1046,96,257,619,858,2091,1361,730,68,189,419,600
201,HARRIS,201,0690,2010690,4908,6714,3784,2930,680,390,1734,2079,4915,3023,1892,477,243,1068,1294
215,HIDALGO,215,0020,2150020,5572,6614,131,6483,6,15,6466,6469,4505,70,4435,3,12,4425,4428
29,BEXAR,29,4038,294038,849,3850,1928,1922,167,339,1374,1672,3093,1660,1433,124,234,1010,1235
29,BEXAR,29,4161,294161,972,1568,206,1362,100,670,639,1260,1191,173,1018,87,485,460,923
29,BEXAR,29,1058,291058,308,5275,947,4328,95,75,4142,4193,3869,791,3078,80,43,2927,2956
29,BEXAR,29,2019,292019,431,3209,125,3084,27,30,3037,3056,2424,89,2335,23,17,2299,2313
37,BOWIE,37,004B,37004B,1095,2006,1331,675,31,438,154,580,1567,1109,458,13,323,86,403
61,CAMERON,61,0101,610101,1513,2880,158,2722,28,31,2660,2681,1893,124,1769,26,11,1729,1736
399,RUNNELS,399,0006,3990006,7587,180,132,48,0,1,39,40,140,115,25,0,0,22,22
215,HIDALGO,215,0043,2150043,5595,5040,127,4913,59,10,4839,4842,3391,89,3302,45,6,3248,3249
215,HIDALGO,215,0166,2150166,5718,1496,120,1376,35,30,1313,1333,1004,97,907,19,12,864,876
259,KENDALL,259,1010,2591010,6259,3913,2394,1519,110,90,1256,1326,2928,1900,1028,69,57,853,900
279,LAMB,279,0011,2790011,6382,1073,550,523,4,33,476,504,749,426,323,4,16,290,306
339,MONTGOMERY,339,0028C,3390028C,6923,61,24,37,1,2,29,31,49,15,34,1,2,26,28
347,NACOGDOCHES,347,0042,3470042,7046,4500,1355,3145,28,337,2740,3071,3142,1143,1999,22,230,1711,1939
85,COLLIN,85,0007,850007,1636,2272,1236,1036,255,358,390,737,1809,1027,782,219,252,280,526
85,COLLIN,85,0130,850130,1759,5262,2685,2577,1653,395,450,831,3953,2107,1846,1202,279,298,565
113,DALLAS,113,2114,1132114,2300,2841,2402,439,116,62,196,249,2730,2336,394,104,52,169,215
113,DALLAS,113,4601,1134601,2841,7025,2192,4833,518,362,3846,4184,5413,1901,3512,441,282,2688,2957
113,DALLAS,113,1719,1131719,2177,6294,1274,5020,193,1153,3627,4735,4508,1104,3404,139,791,2404,3185
201,HARRIS,201,0836,2010836,5054,427,23,404,7,256,149,396,398,22,376,7,245,130,368
41,BRAZOS,41,0013,410013,1204,3032,1836,1196,61,277,790,1043,2418,1565,853,41,190,550,734
95,CONCHO,95,0204,950204,1951,156,88,68,2,1,56,57,130,81,49,1,0,40,40
113,DALLAS,113,2098,1132098,2283,1984,1531,453,110,104,222,317,1883,1468,415,106,84,203,284
113,DALLAS,113,3095,1133095,2532,3219,1630,1589,228,835,486,1296,3006,1569,1437,212,738,440,1162
113,DALLAS,113,1742,1131742,2200,9130,2320,6810,1298,3341,2181,5387,6849,1942,4907,1013,2350,1483,3772
139,ELLIS,139,1025,1391025,3279,4817,2897,1920,40,763,1007,1732,3726,2425,1301,30,507,656,1155
303,LUBBOCK,303,0012,3030012,6528,2718,1861,857,48,140,642,758,2023,1470,553,32,82,411,483
331,MILAM,331,0207,3310207,6860,1159,588,571,13,158,401,544,870,482,388,7,112,266,368
353,NOLAN,353,0003,3530003,7109,3172,1616,1556,61,244,1262,1441,2370,1308,1062,47,136,848,968
375,POTTER,375,0426,3750426,7441,2108,590,1518,76,272,1168,1401,1324,453,871,39,117,682,791
487,WILBARGER,487,0001B,4870001B,9362,184,164,20,4,2,6,8,143,128,15,2,1,6,7
141,EL PASO,141,0213,1410213,3528,497,18,479,1,3,476,477,337,8,329,0,1,326,327
155,FOARD,155,0401,1550401,3611,276,207,69,4,13,53,61,230,192,38,2,8,28,33
201,HARRIS,201,0982,2010982,5200,5713,3155,2558,742,358,1401,1729,3824,2212,1612,446,247,864,1096
213,HENDERSON,213,003B,213003B,5532,4182,3369,813,11,130,553,678,3203,2655,548,9,89,359,446
215,HIDALGO,215,0229,2150229,5781,3459,48,3411,13,9,3378,3381,2323,27,2296,13,8,2269,2272
245,JEFFERSON,245,0085,2450085,6113,1704,358,1346,30,1046,276,1308,1429,328,1101,22,883,195,1070
41,BRAZOS,41,0073,410073,1264,3757,2930,827,174,159,415,565,2668,2151,517,117,83,245,326
75,CHILDRESS,75,0201,750201,1596,1358,949,409,12,56,300,350,1033,763,270,6,29,195,221
89,COLORADO,89,0303,890303,1891,775,700,75,4,9,39,47,649,589,60,3,7,30,37
113,DALLAS,113,4655,1134655,2887,82,42,40,1,11,27,33,68,40,28,1,3,19,22
113,DALLAS,113,3316,1133316,2592,4503,1305,3198,226,1359,1586,2902,3357,1114,2243,195,926,1073,1986
121,DENTON,121,1000,1211000,2924,4478,3336,1142,46,65,849,904,3494,2721,773,25,52,546,590
321,MATAGORDA,321,0002,3210002,6754,769,639,130,6,17,92,106,691,600,91,4,12,59,69
355,NUECES,355,0099,3550099,7215,1264,115,1149,3,46,1102,1135,974,100,874,1,42,831,863
395,ROBERTSON,395,0011,3950011,7547,1988,1182,806,7,160,586,743,1542,981,561,2,125,380,504
439,TARRANT,439,4499,4394499,8543,8596,3011,5585,1051,1569,2901,4359,6234,2452,3782,758,989,1929,2877
491,WILLIAMSON,491,0204,4910204,9422,5970,3297,2673,1311,303,926,1203,4235,2428,1807,888,212,601,799
135,ECTOR,135,0202,1350202,3219,4398,2301,2097,94,268,1659,1880,3242,1852,1390,63,182,1085,1243
199,HARDIN,199,0018,1990018,4215,5897,5182,715,104,79,373,445,4503,4024,479,62,42,237,274
201,HARRIS,201,0876,2010876,5094,3822,1805,2017,456,538,998,1472,2661,1292,1369,323,351,658,989
209,HAYS,209,0100,2090100,5426,0,0,0,0,0,0,0,0,0,0,0,0,0,0
255,KARNES,255,0013,2550013,6219,64,27,37,3,1,28,29,51,25,26,2,1,20,21
287,LEE,287,0403,2870403,6422,380,297,83,0,23,55,76,315,250,65,0,19,42,60
29,BEXAR,29,3053,293053,657,3042,1843,1199,171,177,813,966,2626,1706,920,133,129,616,734
29,BEXAR,29,1075,291075,325,6333,530,5803,87,258,5495,5685,4260,413,3847,63,186,3599,3751
141,EL PASO,141,0012,1410012,3325,4715,1153,3562,263,279,3066,3274,3355,927,2428,190,190,2062,2217
147,FANNIN,147,0005,1470005,3574,841,771,70,4,3,21,23,659,607,52,2,1,14,15
157,FORT BEND,157,2051,1572051,3657,3807,62,3745,75,2932,779,3635,2735,50,2685,58,2142,491,2608
167,GALVESTON,167,0422,1670422,3906,2163,1284,879,159,272,431,698,1607,993,614,124,204,271,473
453,TRAVIS,453,0456,4530456,8984,4590,1787,2803,400,529,1838,2321,3994,1697,2297,328,450,1474,1892
453,TRAVIS,453,0135,4530135,8735,2074,748,1326,133,286,881,1151,1814,669,1145,119,255,742,985
461,UPTON,461,0005,4610005,9067,178,71,107,3,6,92,95,126,53,73,2,4,59,62
479,WEBB,479,0133,4790133,9230,4090,46,4044,10,6,4015,4016,2778,32,2746,6,6,2729,2730
481,WHARTON,481,0403,4810403,9316,1169,415,754,9,188,558,728,874,332,542,5,139,391,523
215,HIDALGO,215,0183,2150183,5735,8125,142,7983,3,30,7955,7967,5254,91,5163,2,20,5146,5157
245,JEFFERSON,245,0039,2450039,6067,2827,93,2734,17,2408,329,2712,2032,70,1962,13,1752,205,1943
339,MONTGOMERY,339,0013,3390013,6906,6926,4801,2125,112,195,1637,1811,5226,3852,1374,66,132,1037,1157
439,TARRANT,439,1457,4391457,7988,0,0,0,0,0,0,0,0,0,0,0,0,0,0
439,TARRANT,439,1150,4391150,7902,3485,486,2999,55,967,1931,2879,2476,439,2037,39,711,1252,1949
439,TARRANT,439,2721,4392721,8234,3405,1938,1467,240,566,567,1119,2607,1557,1050,171,416,378,787
201,HARRIS,201,0767,2010767,4985,268,51,217,9,23,184,201,204,40,164,8,17,136,150
201,HARRIS,201,1016,2011016,5234,5564,2922,2642,235,999,1328,2286,4272,2372,1900,180,719,937,1628
201,HARRIS,201,0190,2010190,4407,5485,448,5037,59,92,4883,4948,3856,364,3492,40,49,3386,3429
201,HARRIS,201,0436,2010436,4653,7015,3788,3227,1130,741,1234,1935,6080,3426,2654,885,633,1006,1613
201,HARRIS,201,0522,2010522,4739,5109,3148,1961,589,316,926,1211,3855,2465,1390,414,228,641,853
201,HARRIS,201,0684,2010684,4902,8698,3134,5564,1679,1190,2632,3727,5814,2228,3586,1158,711,1618,2300
113,DALLAS,113,3920,1133920,2638,7069,3080,3989,58,1165,2619,3758,5726,2785,2941,56,957,1802,2739
121,DENTON,121,1046,1211046,2970,1296,853,443,60,56,281,329,1021,724,297,41,40,175,209
157,FORT BEND,157,3093,1573093,3720,838,146,692,148,299,238,525,650,136,514,113,228,167,387
177,GONZALES,177,0001,1770001,3966,4271,1977,2294,28,288,1956,2199,3135,1611,1524,17,196,1278,1456
185,GRIMES,185,0004,1850004,4052,1602,1216,386,13,104,218,313,1219,986,233,6,67,119,184
201,HARRIS,201,0045A,2010045A,4261,7763,644,7119,39,2445,4655,7028,4938,533,4405,26,1475,2897,4352
453,TRAVIS,453,0381B,4530381B,8921,0,0,0,0,0,0,0,0,0,0,0,0,0,0
489,WILLACY,489,0011,4890011,9376,425,43,382,0,3,382,382,305,28,277,0,1,277,277
349,NAVARRO,349,0101,3490101,7052,2806,1237,1569,38,576,851,1402,2027,976,1051,27,427,520,933
401,RUSK,401,0112,4010112,7593,4107,2640,1467,28,620,700,1303,3200,2100,1100,24,472,504,967
439,TARRANT,439,1684,4391684,8048,633,411,222,17,14,189,197,506,370,136,13,5,116,119
439,TARRANT,439,3590,4393590,8380,0,0,0,0,0,0,0,0,0,0,0,0,0,0
439,TARRANT,439,4705,4394705,8589,5354,2134,3220,783,1063,1404,2375,3748,1576,2172,545,700,929,1578
451,TOM GREEN,451,0114,4510114,8675,1769,148,1621,28,87,1546,1598,1370,112,1258,20,57,1202,1241
201,HARRIS,201,0376,2010376,4593,3751,766,2985,59,242,2658,2873,2607,635,1972,49,176,1722,1882
201,HARRIS,201,0081,2010081,4298,5727,447,5280,24,66,5171,5216,3979,385,3594,14,39,3522,3555
201,HARRIS,201,0830,2010830,5048,110,41,69,29,23,18,41,97,41,56,22,23,12,35
201,HARRIS,201,1162,2011162,5380,0,0,0,0,0,0,0,0,0,0,0,0,0,0
215,HIDALGO,215,0037,2150037,5589,2098,164,1934,31,13,1901,1906,1577,134,1443,22,10,1419,1423
227,HOWARD,227,0207,2270207,5921,1518,1129,389,15,22,324,338,1175,913,262,10,10,212,222
15,AUSTIN,15,0207,150207,122,958,742,216,1,61,110,170,780,629,151,1,48,74,122
29,BEXAR,29,1121,291121,371,6074,1813,4261,568,999,2799,3658,4000,1245,2755,347,614,1824,2375
61,CAMERON,61,0038,610038,1450,779,147,632,0,3,624,626,650,137,513,0,1,509,509
85,COLLIN,85,0070,850070,1699,2399,1763,636,217,117,269,380,1902,1451,451,170,71,180,247
113,DALLAS,113,4143,1134143,2784,301,14,287,4,82,199,280,244,14,230,4,77,149,225
141,EL PASO,141,0052,1410052,3365,4038,543,3495,86,289,3178,3379,3042,470,2572,62,182,2339,2481
277,LAMAR,277,004GB,277004GB,6365,154,118,36,4,5,18,23,112,90,22,3,2,10,12
303,LUBBOCK,303,0155,3030155,6614,3094,2460,634,47,31,501,527,2252,1831,421,31,26,316,341
417,SHACKELFORD,417,0101B,4170101B,7693,499,408,91,3,3,76,77,391,332,59,2,0,48,48
439,TARRANT,439,1295,4391295,7942,2031,346,1685,13,336,1328,1645,1410,294,1116,8,245,845,1085
439,TARRANT,439,4458,4394458,8529,0,0,0,0,0,0,0,0,0,0,0,0,0,0
479,WEBB,479,0349,4790349,9276,6439,363,6076,147,64,5887,5938,4125,260,3865,100,44,3726,3765
187,GUADALUPE,187,0228,1870228,4112,1139,642,497,15,33,437,464,922,550,372,9,21,334,351
201,HARRIS,201,0476,2010476,4693,2128,422,1706,92,234,1374,1592,1542,358,1184,68,167,936,1094
201,HARRIS,201,0730,2010730,4948,3751,2325,1426,390,280,750,998,3261,2104,1157,309,240,600,812
201,HARRIS,201,0482,2010482,4699,6778,3309,3469,516,795,2091,2795,4993,2600,2393,375,548,1393,1899
243,JEFF DAVIS,243,0004,2430004,6027,274,148,126,12,11,91,96,240,133,107,11,10,74,79
261,KENEDY,261,0001,2610001,6276,85,20,65,2,3,58,59,58,15,43,0,2,41,41
29,BEXAR,29,4201,294201,1012,71,55,16,3,3,10,13,67,55,12,3,0,9,9
29,BEXAR,29,2059,292059,471,4858,508,4350,52,212,4109,4260,3775,459,3316,48,164,3108,3233
29,BEXAR,29,3203,293203,809,595,259,336,28,20,283,299,491,239,252,22,13,208,220
53,BURNET,53,0001,530001,1350,1933,1585,348,13,12,250,260,1570,1324,246,8,10,168,176
113,DALLAS,113,4016,1134016,2678,2449,688,1761,91,791,865,1644,2057,639,1418,73,679,649,1321
113,DALLAS,113,1315,1131315,2137,134,14,120,3,13,105,117,90,12,78,0,10,66,76
471,WALKER,471,0304,4710304,9170,10971,5733,5238,57,2520,2480,4957,9684,5013,4671,47,2337,2138,4438
215,HIDALGO,215,0126,2150126,5678,2983,555,2428,8,12,2397,2407,2224,533,1691,5,6,1668,1673
339,MONTGOMERY,339,0106,3390106,7006,3076,2400,676,69,79,382,453,2114,1659,455,41,67,248,309
339,MONTGOMERY,339,0064,3390064,6963,4880,2094,2786,43,104,2505,2584,3456,1683,1773,30,63,1585,1636
363,PALO PINTO,363,0013,3630013,7301,958,769,189,8,23,113,133,757,620,137,8,13,79,90
439,TARRANT,439,1001,4391001,7842,2240,1367,873,98,377,341,702,2026,1302,724,86,306,276,571
441,TAYLOR,441,0405,4410405,8629,3353,1857,1496,68,322,1071,1348,2454,1465,989,41,177,705,871
141,EL PASO,141,0152,1410152,3465,4428,113,4315,11,75,4268,4299,3271,82,3189,7,39,3161,3180
141,EL PASO,141,0158,1410158,3471,2321,348,1973,23,76,1888,1939,1765,302,1463,22,51,1400,1440
181,GRAYSON,181,0307,1810307,4012,3358,2751,607,13,60,407,453,2537,2168,369,6,28,236,260
201,HARRIS,201,0582,2010582,4799,3386,78,3308,18,1829,1486,3281,2326,70,2256,10,1290,962,2238
201,HARRIS,201,1122,2011122,5340,7252,282,6970,109,3169,3780,6830,4953,239,4714,71,2238,2466,4636
215,HIDALGO,215,0083,2150083,5635,6352,901,5451,190,74,5174,5221,4553,710,3843,137,53,3648,3681
9,ARCHER,9,0002,90002,76,1060,938,122,19,12,64,75,851,762,89,13,5,50,54
29,BEXAR,29,4098,294098,909,2894,952,1942,101,404,1483,1802,2181,796,1385,78,271,1032,1267
29,BEXAR,29,3059,293059,663,3522,1469,2053,246,357,1449,1755,2760,1216,1544,183,253,1076,1306
39,BRAZORIA,39,0045,390045,1158,5212,3079,2133,145,372,1520,1837,3893,2501,1392,97,222,981,1188
85,COLLIN,85,0116,850116,1745,6402,3599,2803,1769,437,497,915,4936,2872,2064,1285,344,336,666
101,COTTLE,101,0301,1010301,1991,338,175,163,5,59,99,153,267,146,121,5,42,73,113
439,TARRANT,439,4231,4394231,8483,4744,255,4489,47,288,4152,4410,3201,216,2985,20,161,2793,2938
497,WISE,497,0003,4970003,9568,1649,1398,251,16,16,162,177,1250,1083,167,8,8,105,113
271,KINNEY,271,0001,2710001,6319,702,376,326,12,9,283,288,577,334,243,9,4,209,213
271,KINNEY,271,0004,2710004,6322,1087,773,314,18,15,250,261,981,718,263,11,11,203,213
303,LUBBOCK,303,0057,3030057,6568,3779,1958,1821,132,268,1362,1603,3152,1740,1412,111,213,1019,1223
355,NUECES,355,0040,3550040,7155,5254,3983,1271,201,71,848,899,4260,3347,913,137,41,612,646
373,POLK,373,0005,3730005,7401,2073,1729,344,7,105,159,263,1822,1540,282,7,69,138,207
409,SAN PATRICIO,409,0106,4090106,7650,1233,715,518,16,41,437,472,980,610,370,12,33,307,336
121,DENTON,121,3149,1213149,3073,4214,2908,1306,425,259,503,748,3360,2377,983,311,206,383,579
189,HALE,189,0307,1890307,4158,628,201,427,0,64,359,409,466,170,296,0,45,241,279
201,HARRIS,201,0773,2010773,4991,5515,221,5294,2410,1506,1419,2881,4267,176,4091,1964,1122,1038,2124
201,HARRIS,201,1022,2011022,5240,3663,1983,1680,265,504,862,1346,2724,1547,1177,196,360,579,925
209,HAYS,209,0347,2090347,5486,3317,1973,1344,108,205,955,1125,2835,1730,1105,95,176,755,907
245,JEFFERSON,245,0045,2450045,6073,3119,439,2680,144,580,1985,2524,2206,370,1836,117,424,1305,1703
27,BELL,27,0302,270302,222,8267,4294,3973,266,1626,1998,3470,6519,3699,2820,201,1173,1339,2441
29,BEXAR,29,3157,293157,763,3313,1896,1417,114,162,1090,1242,2697,1611,1086,82,134,819,947
29,BEXAR,29,2104,292104,517,475,34,441,12,13,426,432,350,33,317,7,9,306,312
35,BOSQUE,35,0005,350005,1058,2374,2081,293,8,22,139,159,1956,1758,198,4,6,85,91
43,BREWSTER,43,0004,430004,1304,2320,1111,1209,32,72,1086,1135,1804,891,913,22,50,813,853
85,COLLIN,85,0216,850216,1845,7977,5160,2817,378,1000,1167,2138,5207,3472,1735,219,636,699,1320
439,TARRANT,439,3421,4393421,8337,1840,1471,369,136,38,154,192,1429,1183,246,87,26,99,125
251,JOHNSON,251,0014,2510014,6173,722,550,172,3,17,116,126,537,419,118,2,13,78,86
293,LIMESTONE,293,0204,2930204,6468,769,589,180,2,41,133,166,601,479,122,2,30,85,109
309,MCLENNAN,309,0080B,3090080B,6714,0,0,0,0,0,0,0,0,0,0,0,0,0,0
339,MONTGOMERY,339,0109,3390109,7009,1758,1153,605,152,130,296,417,1434,997,437,109,94,217,307
359,OLDHAM,359,0404,3590404,7255,222,198,24,2,2,20,22,160,146,14,2,1,11,12
425,SOMERVELL,425,0003,4250003,7796,2265,1664,601,45,25,478,496,1674,1291,383,29,18,297,310
113,DALLAS,113,2506,1132506,2386,3017,2087,930,121,149,579,720,2186,1589,597,84,84,370,453
201,HARRIS,201,0087,2010087,4304,3860,2823,1037,585,60,325,376,2775,2096,679,377,42,209,244
201,HARRIS,201,0628,2010628,4845,5957,516,5441,131,443,4872,5258,4281,456,3825,114,292,3393,3667
203,HARRISON,203,0003,2030003,5386,3700,632,3068,21,2397,618,2989,2855,573,2282,13,1847,379,2220
215,HIDALGO,215,0080,2150080,5632,2628,31,2597,2,5,2591,2591,1704,12,1692,2,1,1688,1688
227,HOWARD,227,0404,2270404,5927,1016,625,391,4,20,341,358,777,514,263,0,10,232,241
27,BELL,27,0115,270115,202,6656,4724,1932,379,500,962,1382,4649,3439,1210,245,305,570,850
29,BEXAR,29,4055,294055,866,2283,1026,1257,88,229,939,1141,1878,913,965,67,188,696,866
29,BEXAR,29,3096,293096,700,4450,2358,2092,367,196,1484,1659,3288,1843,1445,230,137,1022,1144
41,BRAZOS,41,0007,410007,1198,1423,1126,297,15,35,207,239,1126,933,193,12,24,125,147
53,BURNET,53,0015,530015,1364,1281,965,316,8,31,237,265,1008,802,206,5,16,148,161
139,ELLIS,139,1031,1391031,3285,1125,617,508,12,224,253,467,840,479,361,9,163,173,328
485,WICHITA,485,0406,4850406,9356,5424,3763,1661,222,496,862,1310,4128,3052,1076,151,293,546,823
491,WILLIAMSON,491,0424,4910424,9522,5264,3535,1729,483,313,843,1135,3828,2675,1153,323,202,546,740
215,HIDALGO,215,0223,2150223,5775,949,111,838,29,14,798,808,573,69,504,19,11,475,484
367,PARKER,367,0315,3670315,7364,5867,4725,1142,179,146,588,722,4669,3883,786,132,88,383,466
417,SHACKELFORD,417,0307,4170307,7696,343,288,55,6,9,32,36,278,240,38,4,7,20,23
439,TARRANT,439,1061,4391061,7862,641,62,579,18,242,314,549,444,51,393,14,174,200,373
439,TARRANT,439,3538,4393538,8360,5453,3627,1826,1011,192,501,676,3718,2549,1169,649,124,310,425
453,TRAVIS,453,0306,4530306,8858,4531,3443,1088,254,80,599,669,3818,2962,856,189,57,496,548
157,FORT BEND,157,4141,1574141,3783,4367,2160,2207,1061,592,522,1091,3859,2066,1793,919,435,398,819
201,HARRIS,201,0562,2010562,4779,1403,31,1372,8,331,1057,1361,1040,29,1011,5,272,745,1001
201,HARRIS,201,0064,2010064,4281,5686,287,5399,31,163,5184,5329,4292,243,4049,23,123,3882,3994
201,HARRIS,201,0727,2010727,4945,2358,449,1909,136,1228,584,1748,1854,423,1431,117,890,452,1295
201,HARRIS,201,1059,2011059,5277,3911,632,3279,247,587,2468,2996,2881,525,2356,199,398,1755,2121
209,HAYS,209,0140,2090140,5443,5465,1652,3813,1055,599,2121,2641,5042,1574,3468,1026,520,1886,2348
5,ANGELINA,5,0032,50032,59,146,104,42,1,7,22,29,110,86,24,0,4,11,15
27,BELL,27,0305,270305,225,3131,1982,1149,99,369,649,980,2588,1767,821,70,261,441,687
29,BEXAR,29,2144,292144,557,2874,790,2084,63,82,1931,1993,2352,690,1662,52,58,1545,1591
29,BEXAR,29,3119,293119,723,4095,1998,2097,185,290,1588,1830,3335,1733,1602,145,215,1197,1384
35,BOSQUE,35,0002,350002,1055,1788,1077,711,4,18,636,648,1332,865,467,1,13,406,417
41,BRAZOS,41,0030,410030,1221,5460,1195,4265,50,914,3278,4125,3731,945,2786,43,608,2088,2672
453,TRAVIS,453,0337,4530337,8881,6809,3021,3788,338,647,2732,3301,5603,2687,2916,269,515,2027,2495
477,WASHINGTON,477,0208,4770208,9213,2707,1630,1077,53,169,822,980,1997,1309,688,42,107,502,609
489,WILLACY,489,002A,489002A,9379,2121,155,1966,11,9,1929,1934,1544,113,1431,10,3,1401,1402
157,FORT BEND,157,4032,1574032,3760,2128,265,1863,718,823,324,1132,1591,230,1361,567,545,236,772
167,GALVESTON,167,0495,1670495,3926,2971,2240,731,238,78,363,429,2124,1657,467,148,49,224,270
201,HARRIS,201,0207,2010207,4424,1649,514,1135,34,30,1063,1087,1367,440,927,30,22,877,893
201,HARRIS,201,0704,2010704,4922,5057,3145,1912,140,81,1571,1633,3770,2464,1306,116,50,1044,1088
439,TARRANT,439,2644,4392644,8217,6068,1514,4554,974,2625,980,3539,3990,1060,2930,608,1708,590,2273
453,TRAVIS,453,0111,4530111,8715,3836,919,2917,106,1676,1127,2739,3082,805,2277,86,1374,783,2133
85,COLLIN,85,0090,850090,1719,4033,2598,1435,977,161,251,403,3110,2119,991,679,98,162,255
113,DALLAS,113,2006,1132006,2217,1930,1510,420,114,49,196,243,1463,1180,283,64,36,135,171
113,DALLAS,113,4111,1134111,2764,770,31,739,30,27,669,694,562,27,535,23,23,473,496
121,DENTON,121,1006,1211006,2930,11,5,6,0,0,1,1,9,5,4,0,0,1,1
139,ELLIS,139,1008,1391008,3262,281,99,182,3,15,152,166,211,91,120,3,15,91,105
141,EL PASO,141,0115,1410115,3428,6077,728,5349,180,425,4802,5132,4180,567,3613,115,281,3212,3464
37,BOWIE,37,001B,37001B,1078,2301,579,1722,11,1467,183,1640,1609,467,1142,7,971,116,1084
91,COMAL,91,0205,910205,1911,6125,3932,2193,241,581,1253,1778,4875,3237,1638,176,458,881,1310
113,DALLAS,113,1101,1131101,2074,5201,226,4975,24,319,4644,4938,3520,199,3321,13,240,3065,3294
113,DALLAS,113,4081,1134081,2738,7706,208,7498,47,796,6678,7410,5302,151,5151,33,431,4672,5083
115,DAWSON,115,0004,1150004,2907,2518,1027,1491,24,94,1380,1439,1851,867,984,16,52,903,944
121,DENTON,121,3146,1213146,3070,3611,2249,1362,527,260,501,740,2721,1785,936,345,187,340,515
329,MIDLAND,329,0108B,3290108B,6817,0,0,0,0,0,0,0,0,0,0,0,0,0,0
355,NUECES,355,0034,3550034,7149,1111,258,853,8,52,801,842,749,166,583,4,15,561,575
381,RANDALL,381,0418,3810418,7484,5928,3898,2030,113,461,1325,1707,4358,3122,1236,72,229,793,999
439,TARRANT,439,2357,4392357,8148,4466,2596,1870,320,858,587,1422,3280,2024,1256,204,599,378,959
463,UVALDE,463,0002,4630002,9070,1761,640,1121,3,9,1087,1093,1361,544,817,0,3,793,796
147,FANNIN,147,0002,1470002,3571,1771,1567,204,18,17,87,101,1411,1264,147,12,14,54,67
167,GALVESTON,167,0412,1670412,3903,14,0,14,3,4,3,7,6,0,6,0,3,3,6
201,HARRIS,201,0939,2010939,5157,0,0,0,0,0,0,0,0,0,0,0,0,0,0
217,HILL,217,0013,2170013,5824,4112,3171,941,38,201,555,749,3160,2543,617,25,138,327,465
249,JIM WELLS,249,0016,2490016,6153,1413,103,1310,11,45,1242,1279,1031,80,951,9,34,895,925
295,LIPSCOMB,295,0404,2950404,6488,468,390,78,1,3,39,42,364,318,46,0,1,22,23
29,BEXAR,29,4081,294081,892,1280,713,567,87,247,219,436,828,455,373,47,171,140,297
29,BEXAR,29,4032,294032,843,3098,344,2754,18,212,2552,2721,2368,314,2054,8,155,1891,2030
61,CAMERON,61,0021,610021,1433,1855,97,1758,4,14,1726,1737,1396,76,1320,2,10,1290,1299
71,CHAMBERS,71,0005,710005,1556,3627,2777,850,71,80,560,628,2774,2219,555,44,53,354,404
89,COLORADO,89,0201,890201,1888,4372,2810,1562,17,441,1071,1469,3466,2370,1096,14,327,705,1027
113,DALLAS,113,1136,1131136,2097,26,8,18,0,0,18,18,23,8,15,0,0,15,15
215,HIDALGO,215,0246,2150246,5798,23,0,23,0,1,18,19,23,0,23,0,1,18,19
329,MIDLAND,329,0404,3290404,6843,3850,2417,1433,158,213,953,1146,3029,1972,1057,114,159,691,837
387,RED RIVER,387,02-1B,38702-1B,7507,82,57,25,2,18,2,20,76,57,19,2,13,2,15
437,SWISHER,437,0007,4370007,7839,688,562,126,4,10,109,118,502,412,90,3,5,77,82
439,TARRANT,439,4290,4394290,8503,5109,2211,2898,215,213,2404,2580,3759,1820,1939,158,120,1590,1697
493,WILSON,493,0101,4930101,9548,5023,2366,2657,57,143,2325,2448,4032,1979,2053,41,120,1775,1883
113,DALLAS,113,2902,1132902,2429,3709,1391,2318,372,1133,783,1878,3127,1304,1823,308,879,600,1458
113,DALLAS,113,3110,1133110,2552,4545,440,4105,77,3195,842,3974,3315,367,2948,60,2320,555,2852
121,DENTON,121,4168,1214168,3093,2474,1691,783,93,183,424,592,2090,1492,598,78,126,309,431
189,HALE,189,0101,1890101,4138,680,184,496,1,31,458,487,517,164,353,1,24,323,346
201,HARRIS,201,0585,2010585,4802,5047,104,4943,29,2905,2055,4894,3412,83,3329,19,2016,1310,3295
201,HARRIS,201,0916,2010916,5134,6687,3900,2787,333,672,1658,2303,4779,2969,1810,230,437,1044,1470
5,ANGELINA,5,0007,50007,33,1965,1578,387,16,50,261,311,1373,1159,214,12,32,127,159
5,ANGELINA,5,0012,50012,39,1560,1014,546,28,127,363,489,1205,863,342,26,87,204,291
29,BEXAR,29,2118,292118,531,105,3,102,0,1,97,98,76,1,75,0,1,72,73
67,CASS,67,0011,670011,1533,1030,697,333,9,268,25,292,806,549,257,6,215,12,227
113,DALLAS,113,4035,1134035,2695,2313,426,1887,25,1344,517,1844,1561,372,1189,16,841,321,1158
113,DALLAS,113,1049,1131049,2031,3025,1857,1168,144,457,562,992,2387,1482,905,99,368,419,772
451,TOM GREEN,451,0358,4510358,8695,3091,2071,1020,30,59,828,874,2268,1599,669,18,24,548,568
451,TOM GREEN,451,0308,4510308,8689,703,213,490,15,47,437,475,539,177,362,11,25,327,352
245,JEFFERSON,245,0082,2450082,6110,6020,1373,4647,421,3261,991,4187,4408,1231,3177,319,2191,660,2822
303,LUBBOCK,303,0015,3030015,6531,4207,3017,1190,213,125,740,844,3435,2581,854,145,94,519,606
303,LUBBOCK,303,0141,3030141,6608,4325,2244,2081,71,393,1559,1921,3301,1839,1462,46,265,1079,1336
323,MAVERICK,323,001C,323001C,6774,6959,120,6839,32,32,6765,6780,4932,86,4846,24,21,4803,4817
439,TARRANT,439,1608,4391608,8025,1158,844,314,25,33,238,270,894,675,219,18,21,163,183
439,TARRANT,439,4410,4394410,8523,5506,2180,3326,776,1080,1387,2424,4363,1879,2484,623,790,980,1752
113,DALLAS,113,3015,1133015,2452,704,192,512,3,57,448,499,517,163,354,3,37,307,343
113,DALLAS,113,1739,1131739,2197,4448,1590,2858,1082,829,909,1725,3536,1369,2167,863,637,626,1256
171,GILLESPIE,171,0007,1710007,3946,3770,2777,993,21,28,860,881,3112,2423,689,17,18,576,591
201,HARRIS,201,0399,2010399,4616,10254,1270,8984,183,4469,4389,8669,7170,1130,6040,135,2934,2956,5805
201,HARRIS,201,0393,2010393,4610,3476,1277,2199,378,638,1160,1741,2711,1096,1615,261,480,814,1276
201,HARRIS,201,0227,2010227,4444,2139,1763,376,174,24,171,193,1625,1385,240,104,11,112,122
1,ANDERSON,1,0018,10018,16,2845,2275,570,16,259,175,428,2249,1840,409,13,195,107,300
25,BEE,25,0009,250009,182,1015,87,928,1,22,903,919,768,72,696,1,16,675,688
29,BEXAR,29,3076,293076,680,1513,1047,466,43,42,371,411,1226,889,337,32,33,271,302
139,ELLIS,139,1051,1391051,3305,4950,2192,2758,62,705,1878,2558,3689,1794,1895,41,497,1258,1749
161,FREESTONE,161,0004A,1610004A,3803,448,358,90,2,5,76,78,345,286,59,2,5,45,47
177,GONZALES,177,0005,1770005,3969,888,618,270,4,73,173,242,697,525,172,4,51,99,149
485,WICHITA,485,0207,4850207,9336,54,40,14,2,3,7,9,41,33,8,2,0,4,4
307,MCCULLOCH,307,0402,3070402,6631,403,345,58,2,8,36,39,324,283,41,1,4,21,23
309,MCLENNAN,309,0042,3090042,6674,2623,585,2038,7,620,1429,2004,1887,478,1409,5,419,969,1378
355,NUECES,355,0057,3550057,7172,1376,218,1158,9,56,1094,1136,1074,187,887,7,41,837,869
439,TARRANT,439,2462,4392462,8174,3315,824,2491,313,1165,1013,2130,2423,671,1752,213,850,665,1497
451,TOM GREEN,451,0107,4510107,8672,2279,827,1452,44,159,1241,1371,1626,693,933,27,101,781,870
453,TRAVIS,453,0270,4530270,8838,5762,3951,1811,714,226,725,924,4723,3372,1351,532,159,536,681
201,HARRIS,201,0250,2010250,4467,4213,497,3716,46,1316,2358,3631,2909,409,2500,26,991,1470,2445
209,HAYS,209,0317,2090317,5469,754,344,410,10,30,359,384,600,306,294,9,24,249,270
231,HUNT,231,0429,2310429,5967,434,391,43,4,8,25,32,361,341,20,1,4,9,13
241,JASPER,241,0007,2410007,6010,1790,704,1086,13,679,363,1034,1384,570,814,13,501,277,774
247,JIM HOGG,247,0001,2470001,6133,1181,79,1102,4,5,1079,1083,856,64,792,4,5,773,777
299,LLANO,299,0203,2990203,6508,3352,2743,609,24,24,428,445,2855,2426,429,22,16,285,296
21,BASTROP,21,2014,212014,159,4659,3035,1624,47,139,1324,1448,3657,2538,1119,26,90,891,973
29,BEXAR,29,4012,294012,823,1752,57,1695,11,487,1221,1677,1186,47,1139,9,360,783,1126
29,BEXAR,29,2167,292167,580,156,36,120,13,24,88,110,132,32,100,9,17,74,91
41,BRAZOS,41,0050,410050,1241,21,7,14,4,7,3,8,11,7,4,3,0,1,1
91,COMAL,91,0110,910110,1905,3099,2090,1009,96,68,774,838,2468,1750,718,62,52,544,595
113,DALLAS,113,4087,1134087,2744,6747,279,6468,41,455,5974,6394,4564,241,4323,30,349,3942,4272
453,TRAVIS,453,0241,4530241,8815,9366,2034,7332,352,1035,5877,6806,7002,1855,5147,328,816,3908,4659
479,WEBB,479,0169,4790169,9236,4199,113,4086,6,21,4066,4076,2735,69,2666,5,15,2650,2659
237,JACK,237,0002,2370002,5990,1579,1359,220,14,12,159,165,1235,1099,136,4,2,99,99
309,MCLENNAN,309,0019,3090019,6651,4318,3022,1296,196,404,638,1024,3307,2423,884,133,264,427,689
329,MIDLAND,329,0203,3290203,6823,1532,632,900,17,45,801,836,1136,516,620,13,34,544,572
363,PALO PINTO,363,0028,3630028,7315,1779,1119,660,1,51,545,592,1298,873,425,0,28,355,379
439,TARRANT,439,1154,4391154,7905,6362,896,5466,1464,2667,1324,3944,4431,848,3583,869,1728,965,2675
439,TARRANT,439,1439,4391439,7982,600,30,570,0,427,149,565,310,25,285,0,200,86,281
113,DALLAS,113,3209,1133209,2572,266,80,186,3,57,121,178,189,74,115,3,35,73,108
141,EL PASO,141,0092,1410092,3405,5244,921,4323,113,385,3857,4173,4348,850,3498,83,320,3105,3375
163,FRIO,163,0005,1630005,3826,1064,519,545,4,8,508,516,816,421,395,2,6,364,370
187,GUADALUPE,187,0110,1870110,4069,271,150,121,2,12,105,114,243,143,100,0,9,87,95
201,HARRIS,201,0519,2010519,4736,5519,2452,3067,470,1130,1390,2467,4233,2071,2162,342,756,956,1690
217,HILL,217,0007,2170007,5818,1401,1151,250,7,35,166,198,1067,900,167,6,27,103,129
55,CALDWELL,55,0401,550401,1390,1940,357,1583,19,222,1356,1549,1460,294,1166,13,171,975,1136
91,COMAL,91,0406,910406,1931,5820,4306,1514,115,168,1132,1267,4963,3798,1165,91,145,840,962
113,DALLAS,113,1081,1131081,2054,4585,1739,2846,97,695,2001,2650,3643,1537,2106,92,520,1429,1929
113,DALLAS,113,3319,1133319,2595,185,28,157,1,93,63,150,118,18,100,1,57,41,96
187,GUADALUPE,187,0211,1870211,4095,151,87,64,1,14,49,60,124,79,45,1,7,38,44
201,HARRIS,201,0419,2010419,4636,6426,1494,4932,68,191,4632,4801,4606,1305,3301,41,109,3097,3202
381,RANDALL,381,0131,3810131,7464,3516,2785,731,19,42,520,555,2873,2367,506,15,27,339,363
439,TARRANT,439,4512,4394512,8546,0,0,0,0,0,0,0,0,0,0,0,0,0,0
439,TARRANT,439,1095,4391095,7882,942,843,99,13,6,60,65,766,694,72,13,4,37,41
439,TARRANT,439,1515,4391515,8005,77,38,39,0,5,32,35,58,33,25,0,1,22,23
201,HARRIS,201,0542,2010542,4759,5177,49,5128,63,1891,3248,5064,3819,42,3777,56,1452,2317,3725
201,HARRIS,201,0959,2010959,5177,10,5,5,0,2,4,4,10,5,5,0,2,4,4
201,HARRIS,201,1082,2011082,5300,0,0,0,0,0,0,0,0,0,0,0,0,0,0
221,HOOD,221,0105,2210105,5841,3289,2862,427,20,31,261,287,2459,2170,289,16,22,166,186
325,MEDINA,325,004B,325004B,6800,5721,2279,3442,34,93,3227,3287,4258,1800,2458,26,64,2285,2333
367,PARKER,367,0115,3670115,7341,4247,3374,873,50,88,557,636,3238,2647,591,29,54,353,407
39,BRAZORIA,39,0008,390008,1121,1453,905,548,15,54,437,484,1147,768,379,9,32,300,329
55,CALDWELL,55,0100,550100,1370,861,322,539,18,19,469,484,677,283,394,10,7,355,361
79,COCHRAN,79,0404,790404,1619,628,128,500,7,38,466,493,443,93,350,5,24,322,345
85,COLLIN,85,0239,850239,1868,6673,4418,2255,635,793,738,1484,4249,2855,1394,375,490,442,909
113,DALLAS,113,1170,1131170,2117,1877,1366,511,82,131,256,376,1557,1176,381,55,95,198,282
113,DALLAS,113,2400,1132400,2366,258,160,98,3,21,71,92,212,143,69,2,16,47,63
291,LIBERTY,291,0008,2910008,6445,4103,3528,575,21,107,337,437,3098,2685,413,14,86,225,307
309,MCLENNAN,309,0061,3090061,6694,4672,2935,1737,221,587,875,1427,3587,2366,1221,164,394,601,982
339,MONTGOMERY,339,0045,3390045,6943,3734,2446,1288,241,203,743,926,2902,2014,888,176,126,515,630
355,NUECES,355,0077,3550077,7192,611,39,572,2,10,564,571,471,34,437,0,9,429,436
113,DALLAS,113,4624,1134624,2864,4356,1091,3265,129,262,2866,3093,3192,961,2231,92,189,1925,2092
113,DALLAS,113,3611,1133611,2615,1738,396,1342,27,870,439,1298,1287,352,935,22,628,270,898
209,HAYS,209,0204,2090204,5449,1887,579,1308,64,206,1034,1207,1289,450,839,39,109,661,765
215,HIDALGO,215,0146,2150146,5698,5853,108,5745,12,31,5720,5731,3694,47,3647,6,8,3626,3633
231,HUNT,231,0107,2310107,5947,5029,3408,1621,172,568,704,1254,3878,2789,1089,118,395,435,824
251,JOHNSON,251,0037,2510037,6196,2294,1831,463,37,73,297,370,1737,1440,297,17,55,183,238
5,ANGELINA,5,0026,50026,53,2241,1855,386,7,107,248,351,1779,1522,257,6,63,161,223
29,BEXAR,29,2181F,292181F,600,125,37,88,13,16,54,68,74,24,50,8,9,30,38
85,COLLIN,85,0133,850133,1762,4742,2246,2496,451,1053,890,1913,3386,1737,1649,322,665,553,1203
113,DALLAS,113,4100,1134100,2758,65,37,28,3,11,16,24,21,16,5,0,3,5,5
113,DALLAS,113,2015,1132015,2223,2683,1100,1583,74,321,1178,1486,2067,980,1087,51,254,766,1014
113,DALLAS,113,2055,1132055,2260,5351,914,4437,187,1267,2955,4171,4004,852,3152,158,948,2019,2930
479,WEBB,479,0266,4790266,9256,4904,164,4740,24,41,4683,4711,3287,115,3172,17,34,3125,3149
245,JEFFERSON,245,0025,2450025,6053,3620,2458,1162,110,628,340,960,2737,1963,774,68,445,201,643
303,LUBBOCK,303,0111,3030111,6588,3136,2090,1046,121,126,728,841,2260,1586,674,86,86,442,525
303,LUBBOCK,303,0037,3030037,6551,1481,944,537,39,145,325,464,838,571,267,17,73,163,234
419,SHELBY,419,01SE,41901SE,7713,3119,728,2391,234,1398,740,2115,2302,589,1713,154,1046,496,1533
439,TARRANT,439,2614,4392614,8211,508,153,355,24,262,63,322,332,107,225,10,172,37,208
453,TRAVIS,453,0162,4530162,8758,6496,2655,3841,707,1268,1870,3047,4877,2096,2781,517,926,1291,2170
141,EL PASO,141,0072,1410072,3385,2530,121,2409,18,42,2364,2382,1978,106,1872,9,36,1835,1849
167,GALVESTON,167,0341,1670341,3883,4544,1034,3510,49,404,3018,3375,3090,835,2255,40,250,1926,2160
201,HARRIS,201,0164,2010164,4381,2585,64,2521,21,1319,1198,2492,1906,59,1847,17,1080,759,1823
201,HARRIS,201,0213,2010213,4430,4285,3431,854,423,48,329,367,3132,2541,591,300,34,204,236
201,HARRIS,201,0710,2010710,4928,3840,2580,1260,463,164,571,718,3349,2315,1034,373,126,460,577
245,JEFFERSON,245,0062,2450062,6090,3698,2449,1249,155,595,414,998,2864,2027,837,108,393,260,651
29,BEXAR,29,4181,294181,992,20,0,20,7,6,10,11,18,0,18,6,6,9,10
29,BEXAR,29,3139A,293139A,743,1955,781,1174,164,290,701,956,1517,644,873,122,206,526,708
121,DENTON,121,2069,1212069,2993,4178,2467,1711,393,544,696,1214,3065,1849,1216,282,375,490,852
135,ECTOR,135,0402,1350402,3242,5456,697,4759,50,1222,3482,4630,4059,602,3457,43,926,2466,3358
181,GRAYSON,181,0103,1810103,3989,4679,2028,2651,43,650,1818,2436,3334,1631,1703,25,453,1106,1547
187,GUADALUPE,187,0117,1870117,4075,2910,1425,1485,111,184,1183,1325,1929,1014,915,79,118,700,796
439,TARRANT,439,3361,4393361,8317,4436,3191,1245,194,213,746,938,3665,2727,938,144,160,542,689
439,TARRANT,439,3716,4393716,8403,3239,2256,983,353,202,375,563,2430,1773,657,241,127,250,366
439,TARRANT,439,4599,4394599,8566,4744,2573,2171,505,637,992,1574,3313,1864,1449,334,406,654,1039
439,TARRANT,439,3574,4393574,8372,1835,843,992,462,238,278,505,1480,721,759,316,202,227,420
159,FRANKLIN,159,0202,1590202,3795,1681,996,685,15,275,349,607,1226,754,472,8,197,241,424
187,GUADALUPE,187,0404,1870404,4127,6016,2717,3299,290,938,2116,2912,4218,2093,2125,186,603,1304,1840
201,HARRIS,201,0242,2010242,4459,5959,856,5103,66,356,4659,4973,4191,716,3475,36,230,3167,3384
245,JEFFERSON,245,0020,2450020,6048,2758,234,2524,47,1594,878,2459,1901,216,1685,36,1105,537,1635
279,LAMB,279,0009,2790009,6380,1364,594,770,5,71,700,755,1046,509,537,4,47,483,525
309,MCLENNAN,309,0079,3090079,6712,3102,1585,1517,20,206,1217,1409,2211,1257,954,14,138,738,869
27,BELL,27,0318,270318,237,7361,4586,2775,362,767,1546,2229,5170,3383,1787,214,484,970,1417
29,BEXAR,29,4090,294090,901,4099,1387,2712,290,766,1697,2361,3066,1154,1912,212,529,1149,1629
29,BEXAR,29,2156,292156,569,2825,869,1956,550,331,1082,1379,2551,826,1725,487,267,961,1209
61,CAMERON,61,0036,610036,1448,4106,701,3405,98,69,3241,3287,3044,639,2405,80,51,2265,2306
85,COLLIN,85,0151,850151,1780,2815,1173,1642,811,485,278,753,1976,865,1111,548,314,193,504
113,DALLAS,113,3007,1133007,2444,2428,1764,664,223,150,264,392,2345,1729,616,212,134,247,365
491,WILLIAMSON,491,0136,4910136,9391,678,116,562,6,18,525,540,463,98,365,4,13,334,347
499,WOOD,499,04-3,49904-3,9606,5339,4123,1216,49,338,681,1007,4326,3346,980,36,286,525,805
373,POLK,373,0003,3730003,7399,2772,2077,695,26,268,311,564,2385,1895,490,19,215,182,392
423,SMITH,423,0010,4230010,7731,4440,1555,2885,12,1665,1136,2780,3375,1221,2154,8,1381,707,2080
439,TARRANT,439,1747,4391747,8063,0,0,0,0,0,0,0,0,0,0,0,0,0,0
439,TARRANT,439,3669,4393669,8395,11,5,6,2,1,2,3,8,5,3,2,0,0,0
453,TRAVIS,453,0125,4530125,8727,1723,361,1362,87,188,1075,1253,1321,331,990,73,162,745,900
459,UPSHUR,459,0016,4590016,9059,2714,1841,873,35,457,246,701,2089,1497,592,23,331,134,464
113,DALLAS,113,4126,1134126,2776,2164,1792,372,135,44,149,190,1727,1454,273,92,34,114,146
113,DALLAS,113,1163,1131163,2112,1952,1580,372,78,39,182,216,1369,1126,243,47,26,123,147
121,DENTON,121,4183,1214183,3108,613,554,59,6,5,38,43,477,433,44,5,5,27,32
141,EL PASO,141,0127,1410127,3440,998,57,941,4,7,929,932,728,45,683,0,3,674,674
157,FORT BEND,157,4076,1574076,3772,4837,1302,3535,1368,1302,873,2133,3716,1065,2651,1060,968,613,1558
349,NAVARRO,349,0300,3490300,7067,6454,2272,4182,124,1056,2644,3651,4744,1935,2809,92,757,1703,2441
141,EL PASO,141,0196,1410196,3509,6494,495,5999,138,350,5580,5823,4377,371,4006,80,212,3699,3870
167,GALVESTON,167,0144,1670144,3841,4149,2252,1897,142,417,1211,1599,3181,1878,1303,126,266,789,1047
191,HALL,191,0401,1910401,4173,385,269,116,2,12,95,102,314,226,88,1,7,73,78
201,HARRIS,201,0288,2010288,4505,2484,48,2436,2,1968,471,2422,1939,33,1906,2,1610,297,1894
201,HARRIS,201,0620,2010620,4837,7185,2458,4727,1179,2212,1304,3428,5972,2165,3807,1012,1697,1041,2679
201,HARRIS,201,0951,2010951,5169,871,91,780,46,215,535,731,607,76,531,36,142,355,491
453,TRAVIS,453,0152,4530152,8750,5057,2063,2994,1027,886,1067,1890,3382,1431,1951,670,556,693,1221
463,UVALDE,463,0014,4630014,9082,84,57,27,0,2,24,25,76,51,25,0,1,22,23
479,WEBB,479,0250B,4790250B,9251,8,0,8,0,0,8,8,5,0,5,0,0,5,5
491,WILLIAMSON,491,0186,4910186,9414,5838,1741,4097,3205,185,608,779,3955,1319,2636,2001,128,433,552
497,WISE,497,0018,4970018,9583,2263,1139,1124,14,156,917,1069,1764,929,835,11,137,655,792
209,HAYS,209,0436,2090436,5501,2191,1659,532,116,54,316,369,1551,1192,359,76,39,210,248
219,HOCKLEY,219,0035,2190035,5833,386,131,255,2,17,234,250,268,110,158,2,13,140,153
423,SMITH,423,0033,4230033,7754,1507,1061,446,28,264,119,380,1169,894,275,14,164,76,238
439,TARRANT,439,4018,4394018,8418,2130,1183,947,41,122,744,849,1565,971,594,34,60,464,522
439,TARRANT,439,2145,4392145,8086,6010,801,5209,146,837,4191,4979,4179,684,3495,114,582,2763,3321
453,TRAVIS,453,0380,4530380,8919,5754,4011,1743,599,210,813,994,4578,3293,1285,437,156,594,733
113,DALLAS,113,4529,1134529,2822,1048,263,785,130,346,333,648,768,219,549,87,256,213,457
121,DENTON,121,9200,1219200,3154,0,0,0,0,0,0,0,0,0,0,0,0,0,0
141,EL PASO,141,0173,1410173,3486,3700,82,3618,12,16,3602,3608,2569,64,2505,6,6,2499,2501
161,FREESTONE,161,0011B,1610011B,3818,428,215,213,4,183,17,197,352,177,175,4,153,8,161
189,HALE,189,0205,1890205,4150,821,73,748,4,66,688,745,574,66,508,1,52,456,505
201,HARRIS,201,0928,2010928,5146,82,61,21,7,1,11,12,57,40,17,7,1,8,9
453,TRAVIS,453,0352,4530352,8896,4496,2903,1593,270,189,1054,1227,3779,2481,1298,212,154,859,1002
453,TRAVIS,453,0182,4530182,8773,5655,830,4825,563,772,3496,4207,4136,724,3412,435,596,2353,2912
467,VAN ZANDT,467,001C,467001C,9105,2501,2070,431,14,20,316,334,1924,1639,285,9,10,205,214
479,WEBB,479,0130,4790130,9228,5859,86,5773,2,10,5765,5768,3834,37,3797,0,5,3794,3796
491,WILLIAMSON,491,0253,4910253,9437,7746,4704,3042,450,549,1907,2364,5529,3525,2004,288,355,1207,1517
493,WILSON,493,0416,4930416,9560,2806,1833,973,41,98,765,849,2129,1437,692,20,81,536,610
201,HARRIS,201,0265,2010265,4482,6363,3815,2548,1568,239,667,886,4874,3051,1823,1093,186,489,664
201,HARRIS,201,0597,2010597,4814,6311,678,5633,1475,1240,2919,4112,4619,581,4038,1110,795,2104,2877
439,TARRANT,439,4092,4394092,8441,2798,126,2672,13,44,2617,2650,2029,105,1924,9,31,1886,1910
439,TARRANT,439,1146,4391146,7900,4050,1402,2648,141,1576,905,2420,3095,1221,1874,102,1130,603,1699
439,TARRANT,439,4595,4394595,8564,220,72,148,1,3,142,145,154,54,100,0,3,95,98
439,TARRANT,439,2708,4392708,8232,2942,1059,1883,213,1209,419,1612,2047,797,1250,140,800,272,1064
29,BEXAR,29,4159,294159,970,92,23,69,5,23,52,60,54,18,36,4,5,30,30
29,BEXAR,29,1132,291132,383,926,142,784,21,9,761,768,691,129,562,18,4,543,546
33,BORDEN,33,0004,330004,1047,151,120,31,7,5,25,27,107,92,15,1,1,15,15
85,COLLIN,85,0005,850005,1634,1645,1004,641,88,148,347,472,1247,833,414,55,100,211,297
113,DALLAS,113,2112,1132112,2298,183,99,84,20,23,36,59,182,98,84,20,23,36,59
121,DENTON,121,1044,1211044,2968,2145,1214,931,98,331,449,759,1677,1019,658,82,239,294,520
491,WILLIAMSON,491,0305,4910305,9460,1469,988,481,37,111,308,405,1058,750,308,26,72,190,257
335,MITCHELL,335,0001,3350001,6875,1790,1036,754,21,79,636,702,1289,802,487,16,32,416,446
355,NUECES,355,0097,3550097,7213,2014,190,1824,9,72,1757,1796,1529,154,1375,7,43,1325,1353
393,ROBERTS,393,04-2,39304-2,7539,89,82,7,0,2,2,4,75,69,6,0,2,1,3
439,TARRANT,439,1085,4391085,7877,2169,345,1824,189,438,1194,1618,1451,269,1182,93,298,788,1078
439,TARRANT,439,4497,4394497,8541,8917,2629,6288,220,3882,2163,5912,6512,2269,4243,139,2613,1428,3979
477,WASHINGTON,477,0104,4770104,9205,3950,1113,2837,68,1701,1036,2702,2956,928,2028,40,1287,668,1946
121,DENTON,121,1038,1211038,2962,2642,1215,1427,282,648,439,1075,1708,826,882,174,403,258,655
157,FORT BEND,157,1144,1571144,3632,7661,3425,4236,2366,392,1346,1697,5306,2615,2691,1484,255,859,1092
201,HARRIS,201,0079,2010079,4296,6115,152,5963,22,216,5761,5918,4618,134,4484,13,148,4331,4461
201,HARRIS,201,0742,2010742,4960,2527,1026,1501,734,285,449,726,1902,812,1090,544,203,301,502
213,HENDERSON,213,04SE,21304SE,5547,4192,3280,912,27,187,541,722,3405,2781,624,21,126,348,471
255,KARNES,255,0005,2550005,6211,1236,380,856,5,21,817,833,896,328,568,4,14,543,553
29,BEXAR,29,1110,291110,360,6439,1346,5093,386,1060,3797,4680,4073,949,3124,233,624,2293,2834
85,COLLIN,85,0028,850028,1657,4698,2865,1833,716,499,549,1028,3822,2415,1407,596,355,377,725
113,DALLAS,113,2137,1132137,2321,4306,484,3822,309,1399,2124,3472,3272,442,2830,248,1113,1464,2545
121,DENTON,121,1061,1211061,2985,5304,2928,2376,116,533,1618,2114,4090,2458,1632,72,383,1080,1443
157,FORT BEND,157,2023,1572023,3649,5609,132,5477,78,1710,3737,5376,4103,100,4003,67,1306,2647,3918
201,HARRIS,201,0096,2010096,4313,6487,289,6198,49,2584,3652,6096,4120,205,3915,30,1700,2218,3847
267,KIMBLE,267,0004,2670004,6311,651,389,262,9,8,226,234,536,339,197,9,8,166,174
303,LUBBOCK,303,0010,3030010,6526,2240,937,1303,144,320,780,1070,1966,872,1094,124,271,654,901
329,MIDLAND,329,108A,329108A,6852,820,417,403,16,18,353,365,640,328,312,13,11,269,278
355,NUECES,355,0075,3550075,7190,3578,158,3420,19,76,3349,3394,2758,130,2628,12,40,2574,2608
439,TARRANT,439,1021,4391021,7854,3791,2791,1000,107,195,576,767,3039,2341,698,81,130,391,517
439,TARRANT,439,4375,4394375,8518,4418,2999,1419,205,369,735,1080,3388,2412,976,143,252,491,739
201,HARRIS,201,0102,2010102,4319,4267,519,3748,39,540,3156,3647,3246,427,2819,28,435,2320,2730
201,HARRIS,201,0765,2010765,4983,6301,1129,5172,961,2417,1808,4116,4832,972,3860,811,1683,1352,2964
201,HARRIS,201,0643,2010643,4860,8745,1886,6859,594,1440,4833,6149,6444,1603,4841,451,977,3378,4291
213,HENDERSON,213,0002,2130002,5524,585,469,116,5,18,65,83,428,352,76,5,6,44,50
215,HIDALGO,215,0095,2150095,5647,8579,152,8427,41,28,8355,8364,6096,102,5994,34,12,5944,5947
251,JOHNSON,251,0029,2510029,6188,1892,1545,347,21,44,192,232,1378,1159,219,14,25,116,140
29,BEXAR,29,4113,294113,924,1995,186,1809,35,734,1063,1763,1476,177,1299,21,544,745,1271
29,BEXAR,29,1010,291010,260,910,128,782,10,25,747,765,765,121,644,6,23,612,628
29,BEXAR,29,2017,292017,429,2364,53,2311,7,35,2270,2294,1731,38,1693,5,17,1671,1683
37,BOWIE,37,003B,37003B,1093,3923,1426,2497,30,1952,463,2383,3056,1224,1832,27,1450,305,1741
73,CHEROKEE,73,0042,730042,1588,2491,399,2092,17,1049,1023,2056,1726,317,1409,8,758,633,1386
85,COLLIN,85,0128,850128,1757,3820,2992,828,264,113,319,426,2717,2195,522,157,68,216,282
453,TRAVIS,453,0372A,4530372A,8913,954,583,371,263,24,71,93,639,382,257,185,21,47,66
339,MONTGOMERY,339,0028A,3390028A,6921,6751,4588,2163,81,152,1737,1873,5061,3647,1414,48,84,1133,1213
339,MONTGOMERY,339,0098,3390098,6998,3784,2238,1546,384,348,750,1080,2863,1751,1112,265,249,549,791
355,NUECES,355,0052,3550052,7167,1319,117,1202,7,66,1126,1183,995,99,896,3,54,836,884
399,RUNNELS,399,0004,3990004,7585,653,338,315,3,23,288,305,499,280,219,2,19,195,212
435,SUTTON,435,0201,4350201,7831,824,353,471,4,8,456,463,647,308,339,1,4,330,334
439,TARRANT,439,2827B,4392827B,8249,0,0,0,0,0,0,0,0,0,0,0,0,0,0
113,DALLAS,113,2805,1132805,2421,5792,2841,2951,1810,362,697,1022,4207,2248,1959,1219,236,445,658
201,HARRIS,201,0788,2010788,5006,1216,264,952,10,69,873,935,854,229,625,6,38,574,610
215,HIDALGO,215,0118,2150118,5670,3675,159,3516,41,14,3473,3477,2543,127,2416,26,8,2382,2386
221,HOOD,221,0101,2210101,5839,3117,2631,486,44,73,284,344,2664,2358,306,26,38,167,202
273,KLEBERG,273,0034,2730034,6334,1367,615,752,15,17,701,713,1122,546,576,9,7,539,545
297,LIVE OAK,297,0014,2970014,6503,1201,726,475,2,8,447,454,933,583,350,1,1,331,332
29,BEXAR,29,4136,294136,947,1962,669,1293,55,341,906,1218,1408,524,884,34,230,606,829
29,BEXAR,29,1033,291033,283,4788,576,4212,71,217,3917,4088,3375,504,2871,50,142,2662,2789
29,BEXAR,29,1154B,291154B,406,19,6,13,3,0,8,8,19,6,13,3,0,8,8
37,BOWIE,37,0013,370013,1070,56,42,14,1,2,5,7,48,41,7,1,0,3,3
77,CLAY,77,0024,770024,1611,459,424,35,2,10,11,21,362,338,24,1,7,4,11
85,COLLIN,85,0105,850105,1734,82,46,36,1,25,4,29,69,44,25,0,15,4,19
439,TARRANT,439,2673,4392673,8226,0,0,0,0,0,0,0,0,0,0,0,0,0,0
293,LIMESTONE,293,0405,2930405,6480,387,331,56,1,7,39,46,317,282,35,1,4,22,26
339,MONTGOMERY,339,0005,3390005,6898,407,354,53,1,9,33,41,340,299,41,1,5,26,31
343,MORRIS,343,0103,3430103,7021,932,532,400,10,275,88,360,760,448,312,6,215,69,282
355,NUECES,355,0029,3550029,7144,5126,1870,3256,346,237,2607,2809,3822,1548,2274,262,142,1806,1941
397,ROCKWALL,397,001D,397001D,7562,1798,811,987,76,325,522,837,1256,612,644,51,225,328,548
415,SCURRY,415,0009,4150009,7685,680,535,145,3,5,114,118,505,406,99,1,0,79,79
113,DALLAS,113,2087,1132087,2275,4030,2406,1624,145,369,1026,1376,3373,2131,1242,113,297,738,1027
201,HARRIS,201,0934,2010934,5152,424,68,356,23,266,78,332,329,63,266,9,209,53,255
215,HIDALGO,215,0141,2150141,5693,185,21,164,9,7,147,154,136,21,115,9,7,100,107
217,HILL,217,0005,2170005,5816,1820,1559,261,6,42,159,197,1407,1246,161,5,16,98,114
257,KAUFMAN,257,0013,2570013,6234,7149,3369,3780,283,1883,1518,3322,4882,2496,2386,191,1135,922,2038
277,LAMAR,277,003F,277003F,6357,1313,1114,199,6,10,130,139,894,762,132,5,6,86,92
27,BELL,27,0216,270216,220,5884,2558,3326,377,1457,1396,2724,4550,2171,2379,267,1034,933,1912
29,BEXAR,29,3195,293195,801,2945,858,2087,286,413,1394,1785,2621,773,1848,255,357,1238,1579
29,BEXAR,29,2057,292057,469,4521,293,4228,38,88,4121,4167,3467,252,3215,23,61,3127,3168
41,BRAZOS,41,0025,410025,1216,1883,147,1736,32,1111,607,1692,1250,104,1146,14,788,340,1120
69,CASTRO,69,0301,690301,1548,1448,557,891,8,33,836,864,1056,476,580,7,26,543,566
85,COLLIN,85,0168,850168,1797,2574,1799,775,408,103,191,289,1721,1246,475,253,71,103,170
489,WILLACY,489,0009,4890009,9374,1509,65,1444,9,20,1425,1435,1123,60,1063,7,12,1049,1056
505,ZAPATA,505,0002,5050002,9623,2874,152,2722,11,6,2705,2707,1948,133,1815,7,6,1805,1807
245,JEFFERSON,245,0097,2450097,6125,770,199,571,14,471,86,545,515,178,337,11,269,53,314
279,LAMB,279,0002,2790002,6374,1493,279,1214,8,156,1059,1197,1058,211,847,5,110,726,831
291,LIBERTY,291,0025,2910025,6457,1940,1599,341,7,24,250,274,1452,1228,224,4,13,159,172
439,TARRANT,439,3584,4393584,8378,0,0,0,0,0,0,0,0,0,0,0,0,0,0
439,TARRANT,439,3260,4393260,8295,2015,1549,466,77,114,218,324,1606,1267,339,59,75,155,228
441,TAYLOR,441,0403,4410403,8627,4777,2770,2007,172,905,888,1736,3924,2398,1526,128,676,651,1305
113,DALLAS,113,1307,1131307,2129,885,50,835,8,706,128,827,618,50,568,6,486,78,561
185,GRIMES,185,0002,1850002,4050,1323,1072,251,11,37,150,182,1012,855,157,8,15,95,110
201,HARRIS,201,0580,2010580,4797,1502,80,1422,9,955,471,1406,1187,67,1120,9,792,319,1105
201,HARRIS,201,0911,2010911,5129,1512,561,951,56,318,549,833,1199,494,705,46,221,400,607
201,HARRIS,201,1160,2011160,5378,0,0,0,0,0,0,0,0,0,0,0,0,0,0
201,HARRIS,201,0828,2010828,5046,2547,1869,678,167,93,348,438,1919,1471,448,100,66,222,288
13,ATASCOSA,13,0021,130021,114,1384,739,645,16,22,586,604,1090,607,483,12,13,441,450
29,BEXAR,29,4096,294096,907,5783,1423,4360,164,1139,3139,4154,4482,1263,3219,135,803,2282,3036
37,BOWIE,37,016A,37016A,1110,105,101,4,1,1,1,2,84,81,3,0,0,1,1
61,CAMERON,61,0030,610030,1442,2759,541,2218,17,53,2159,2189,1859,433,1426,16,32,1378,1398
91,COMAL,91,0108,910108,1903,2473,1883,590,42,53,420,470,2127,1673,454,34,35,323,357
113,DALLAS,113,2027,1132027,2235,1796,1472,324,75,49,178,227,1626,1341,285,73,40,153,193
453,TRAVIS,453,0393,4530393,8936,5437,3194,2243,1045,283,792,1047,3803,2325,1478,740,161,477,633
461,UPTON,461,0003,4610003,9065,858,244,614,4,35,578,601,633,201,432,3,22,401,419
479,WEBB,479,0311,4790311,9268,3031,82,2949,7,19,2934,2936,2271,74,2197,6,18,2189,2191
215,HIDALGO,215,0218,2150218,5770,2127,41,2086,4,11,2075,2080,1447,29,1418,1,8,1409,1414
245,JEFFERSON,245,0037,2450037,6065,3756,2779,977,98,173,619,786,2918,2297,621,63,97,384,479
349,NAVARRO,349,0201,3490201,7061,1449,196,1253,8,988,225,1201,995,133,862,6,694,124,817
371,PECOS,371,0006,3710006,7393,280,56,224,1,1,221,221,226,51,175,1,0,173,173
401,RUSK,401,0318,4010318,7608,1522,1087,435,12,250,149,394,1160,842,318,7,200,89,287
439,TARRANT,439,1293,4391293,7940,3159,324,2835,32,932,1890,2787,2225,283,1942,22,693,1226,1903
135,ECTOR,135,0305,1350305,3231,1537,227,1310,57,84,1157,1231,1161,192,969,38,59,863,916
187,GUADALUPE,187,0226,1870226,4110,617,224,393,0,17,366,380,496,206,290,0,14,267,278
201,HARRIS,201,0520,2010520,4737,1240,39,1201,17,944,260,1171,849,30,819,10,651,165,796
201,HARRIS,201,0225,2010225,4442,2702,805,1897,237,831,846,1634,2237,748,1489,195,630,662,1267
209,HAYS,209,0125,2090125,5438,2381,589,1792,41,92,1654,1719,1760,482,1278,37,68,1158,1212
215,HIDALGO,215,0181,2150181,5733,1003,598,405,0,5,390,392,917,598,319,0,2,306,306
29,BEXAR,29,2011,292011,423,3686,235,3451,15,139,3330,3421,2661,199,2462,11,80,2380,2436
29,BEXAR,29,3149,293149,755,4776,1153,3623,443,946,2295,3158,4491,1082,3409,408,879,2178,2987
73,CHEROKEE,73,0048,730048,1594,883,728,155,4,8,111,117,664,568,96,2,5,59,62
113,DALLAS,113,4014,1134014,2676,2394,1932,462,123,50,233,279,1872,1524,348,85,43,174,215
113,DALLAS,113,2900,1132900,2427,4427,2390,2037,332,533,1141,1628,3769,2236,1533,262,398,819,1198
113,DALLAS,113,3314,1133314,2590,5660,1157,4503,163,2259,2066,4272,4060,969,3091,124,1571,1361,2908
439,TARRANT,439,3396,4393396,8332,4541,3160,1381,599,206,438,638,3430,2455,975,412,162,292,453
201,HARRIS,201,0534,2010534,4751,2687,1019,1668,96,68,1491,1545,2084,926,1158,59,42,1037,1070
201,HARRIS,201,0782,2010782,5000,3230,1604,1626,249,369,962,1305,2526,1320,1206,208,275,667,934
201,HARRIS,201,0865,2010865,5083,5453,2098,3355,633,1122,1587,2625,4586,1848,2738,524,923,1262,2119
309,MCLENNAN,309,0040,3090040,6672,3087,1905,1182,71,525,533,1037,2457,1630,827,46,368,363,722
339,MONTGOMERY,339,0104,3390104,7004,1716,1016,700,194,109,367,472,1106,686,420,111,68,217,283
439,TARRANT,439,1490,4391490,8000,1377,369,1008,76,757,168,914,1058,316,742,63,550,127,666
119,DELTA,119,0009,1190009,2922,358,329,29,3,7,10,16,289,265,24,3,5,9,13
141,EL PASO,141,0110,1410110,3423,5274,522,4752,114,246,4420,4609,4053,458,3595,101,164,3332,3474
157,FORT BEND,157,2089,1572089,3672,1698,30,1668,28,1396,260,1635,1321,28,1293,24,1085,188,1263
157,FORT BEND,157,4012,1574012,3755,5740,1065,4675,47,401,4226,4583,4145,908,3237,31,269,2911,3167
167,GALVESTON,167,0461,1670461,3918,5090,3797,1293,280,171,705,863,3711,2839,872,207,115,460,569
181,GRAYSON,181,0209,1810209,4004,2195,1809,386,18,80,240,315,1758,1484,274,12,67,160,224
5,ANGELINA,5,017B,5017B,68,610,533,77,1,10,27,36,448,399,49,0,5,9,14
29,BEXAR,29,1027,291027,277,800,146,654,69,87,492,572,554,118,436,53,62,319,378
29,BEXAR,29,3005,293005,609,4496,2452,2044,190,367,1422,1756,3153,1803,1350,134,245,908,1136
85,COLLIN,85,0111,850111,1740,3868,2586,1282,538,286,369,646,2852,1987,865,376,198,239,431
113,DALLAS,113,4079,1134079,2736,5168,2938,2230,170,706,1290,1969,4350,2559,1791,136,593,985,1564
113,DALLAS,113,2096,1132096,2281,0,0,0,0,0,0,0,0,0,0,0,0,0,0
453,TRAVIS,453,0454,4530454,8982,4490,1684,2806,415,532,1848,2323,3787,1511,2276,347,445,1459,1861
455,TRINITY,455,0015,4550015,9019,151,139,12,2,4,3,7,125,115,10,2,2,3,5
481,WHARTON,481,0401,4810401,9314,5586,1372,4214,38,866,3321,4136,3914,1103,2811,21,597,2184,2762
201,HARRIS,201,0142,2010142,4359,2256,73,2183,18,38,2139,2159,1641,60,1581,12,29,1548,1560
201,HARRIS,201,0474,2010474,4691,1579,770,809,160,246,381,613,1186,607,579,125,173,266,426
215,HIDALGO,215,0135,2150135,5687,3672,403,3269,139,67,3034,3090,2890,365,2525,114,54,2326,2377
367,PARKER,367,0260,3670260,7359,4472,3728,744,76,76,449,516,3486,2982,504,46,45,294,337
415,SCURRY,415,0015,4150015,7691,3619,1054,2565,34,171,2332,2478,2526,822,1704,17,118,1524,1638
451,TOM GREEN,451,0304,4510304,8687,6362,2715,3647,66,232,3236,3424,4724,2238,2486,49,135,2181,2306
121,DENTON,121,3144,1213144,3068,5233,3194,2039,1308,168,456,610,3718,2390,1328,838,124,287,407
139,ELLIS,139,1023,1391023,3277,0,0,0,0,0,0,0,0,0,0,0,0,0,0
141,EL PASO,141,0050,1410050,3363,5084,621,4463,139,368,4000,4258,3593,504,3089,93,244,2739,2932
155,FOARD,155,0201,1550201,3609,277,211,66,3,7,52,59,221,178,43,2,3,34,37
187,GUADALUPE,187,0104,1870104,4064,2115,913,1202,48,193,946,1120,1765,814,951,41,154,731,880
201,HARRIS,201,0388,2010388,4605,5145,886,4259,264,2044,1968,3928,3564,686,2878,182,1399,1280,2630
29,BEXAR,29,4153,294153,964,339,122,217,3,13,195,203,246,90,156,2,9,140,145
29,BEXAR,29,3111,293111,715,0,0,0,0,0,0,0,0,0,0,0,0,0,0
33,BORDEN,33,003B,33003B,1053,56,43,13,1,4,9,12,43,33,10,1,3,7,9
43,BREWSTER,43,0002,430002,1302,1655,887,768,38,40,644,670,1394,801,593,30,25,487,508
113,DALLAS,113,3802,1133802,2630,6606,413,6193,50,4537,1655,6112,4727,375,4352,33,3293,1042,4300
113,DALLAS,113,2501,1132501,2381,4234,3086,1148,213,229,568,791,3699,2705,994,167,207,489,695
469,VICTORIA,469,0008,4690008,9128,5859,1542,4317,78,643,3635,4162,4156,1279,2877,63,389,2395,2761
339,MONTGOMERY,339,0060,3390060,6958,8597,2482,6115,334,886,4831,5663,6639,2074,4565,270,641,3582,4199
355,NUECES,355,0092A,3550092A,7207,2783,1195,1588,62,100,1383,1459,2251,1048,1203,47,81,1018,1090
395,ROBERTSON,395,0006,3950006,7545,2209,1664,545,16,307,182,481,1648,1288,360,10,201,121,319
425,SOMERVELL,425,0001,4250001,7794,2305,1581,724,23,33,557,584,1723,1248,475,17,16,354,369
453,TRAVIS,453,0327,4530327,8873,3670,2716,954,533,44,300,339,2550,1927,623,352,18,195,208
469,VICTORIA,469,0002,4690002,9122,1588,631,957,15,122,807,918,1352,561,791,9,104,664,762
135,ECTOR,135,0111,1350111,3217,4663,1561,3102,218,332,2519,2823,2996,1071,1925,148,217,1519,1725
175,GOLIAD,175,0042,1750042,3964,876,708,168,3,20,129,144,695,571,124,3,17,88,101
201,HARRIS,201,0328,2010328,4545,5741,431,5310,120,666,4602,5178,4078,397,3681,97,453,3176,3580
201,HARRIS,201,1074,2011074,5292,2310,214,2096,174,1397,573,1903,1686,199,1487,136,949,415,1335
215,HIDALGO,215,0078,2150078,5630,4443,118,4325,7,8,4306,4311,3245,95,3150,3,8,3138,3143
225,HOUSTON,225,0003,2250003,5879,2468,729,1739,9,1402,318,1711,1843,618,1225,5,1009,200,1205
5,ANGELINA,5,0002,50002,28,5254,946,4308,41,2076,2174,4217,3768,788,2980,29,1511,1424,2922
29,BEXAR,29,1073,291073,323,6070,1701,4369,412,737,3256,3884,4065,1187,2878,268,489,2092,2530
29,BEXAR,29,1116,291116,366,2298,718,1580,85,288,1232,1468,1675,573,1102,59,177,859,1019
85,COLLIN,85,0022,850022,1651,6397,4378,2019,144,361,1346,1671,4514,3211,1303,86,242,856,1076
85,COLLIN,85,0065,850065,1694,1940,1059,881,184,181,484,656,1532,912,620,137,125,322,442
101,COTTLE,101,0101,1010101,1989,344,251,93,8,23,66,86,274,206,68,6,18,47,62
491,WILLIAMSON,491,0421,4910421,9520,1778,793,985,58,245,659,870,1246,622,624,35,155,409,548
269,KING,269,0003,2690003,6317,70,60,10,2,4,6,9,55,48,7,2,1,6,6
303,LUBBOCK,303,0004,3030004,6520,2259,191,2068,20,207,1860,2038,1665,154,1511,16,143,1357,1487
331,MILAM,331,0105,3310105,6858,1876,1291,585,5,43,499,532,1424,1034,390,2,35,321,351
409,SAN PATRICIO,409,0101,4090101,7645,749,271,478,2,13,455,461,554,201,353,2,6,336,340
439,TARRANT,439,4222,4394222,8481,2420,766,1654,44,99,1479,1560,1760,649,1111,31,57,996,1044
439,TARRANT,439,2520,4392520,8186,2930,1480,1450,275,549,585,1123,2205,1211,994,211,373,370,740
113,DALLAS,113,3093,1133093,2530,55,3,52,1,5,47,51,39,3,36,1,3,33,35
141,EL PASO,141,0004,1410004,3317,3083,317,2766,55,62,2650,2700,2366,279,2087,33,43,2001,2041
167,GALVESTON,167,0197,1670197,3858,1914,975,939,28,177,695,856,1431,829,602,24,127,421,546
201,HARRIS,201,0434,2010434,4651,2381,1379,1002,279,258,441,681,2226,1334,892,250,219,394,602
201,HARRIS,201,0974,2010974,5192,3631,335,3296,504,1275,1554,2780,2403,222,2181,372,795,1031,1799
233,HUTCHINSON,233,0021,2330021,5979,4132,3445,687,41,53,345,390,3291,2793,498,20,26,240,266
23,BAYLOR,23,0003,230003,174,861,670,191,5,30,126,153,680,556,124,1,15,78,93
29,BEXAR,29,4199,294199,1010,3124,818,2306,203,503,1634,2074,2120,601,1519,144,295,1081,1353
29,BEXAR,29,4196,294196,1007,0,0,0,0,0,0,0,0,0,0,0,0,0,0
29,BEXAR,29,3155,293155,761,4377,2116,2261,415,257,1521,1754,3093,1555,1538,290,160,1024,1178
41,BRAZOS,41,0065,410065,1256,341,236,105,23,22,44,66,255,183,72,20,17,25,42
85,COLLIN,85,0214,850214,1843,5812,4550,1262,372,419,373,785,3887,3112,775,223,254,218,471
439,TARRANT,439,4683,4394683,8581,0,0,0,0,0,0,0,0,0,0,0,0,0,0
251,JOHNSON,251,0012B,2510012B,6171,1577,1262,315,21,29,205,232,1124,918,206,16,18,137,153
287,LEE,287,0401,2870401,6420,1160,611,549,7,295,239,512,893,513,380,5,210,144,349
309,MCLENNAN,309,0034,3090034,6666,1867,1281,586,17,173,374,533,1507,1140,367,14,104,223,324
359,OLDHAM,359,0303,3590303,7253,442,294,148,14,13,123,126,333,241,92,8,5,78,79
387,RED RIVER,387,0004,3870004,7499,1694,904,790,18,560,176,726,1359,805,554,12,420,87,506
423,SMITH,423,0027,4230027,7748,3303,1959,1344,127,547,613,1138,2734,1729,1005,104,397,446,828
113,DALLAS,113,2154,1132154,2338,67,28,39,6,14,17,30,60,28,32,4,13,10,23
113,DALLAS,113,1121,1131121,2089,5783,652,5131,569,894,3649,4513,4255,577,3678,445,719,2469,3176
123,DEWITT,123,0303,1230303,3171,718,485,233,1,21,199,214,551,386,165,1,14,141,153
201,HARRIS,201,0040,2010040,4256,638,514,124,41,23,56,77,515,424,91,29,15,43,57
201,HARRIS,201,1120,2011120,5338,4185,1299,2886,594,744,1524,2213,2832,953,1879,401,437,1014,1423
215,HIDALGO,215,0032,2150032,5584,4191,194,3997,15,41,3962,3983,2857,157,2700,14,21,2679,2687
7,ARANSAS,7,004A,7004A,74,1295,1025,270,20,12,180,183,1188,954,234,14,9,157,159
29,BEXAR,29,4050,294050,861,2368,1051,1317,94,285,931,1180,1969,957,1012,82,210,689,884
29,BEXAR,29,1070,291070,320,2528,321,2207,41,245,1935,2152,1840,271,1569,35,183,1360,1519
29,BEXAR,29,3011,293011,615,1220,607,613,65,51,496,537,1010,541,469,45,33,379,412
39,BRAZORIA,39,0043,390043,1156,8268,4381,3887,522,798,2455,3153,6375,3646,2729,402,543,1643,2145
57,CALHOUN,57,0009,570009,1402,1722,731,991,29,35,910,937,1279,588,691,18,22,635,653
439,TARRANT,439,1120,4391120,7894,4747,340,4407,77,2652,1710,4310,3402,277,3125,58,2013,1054,3048
439,TARRANT,439,4070,4394070,8435,3629,1782,1847,155,666,966,1586,2948,1620,1328,109,479,668,1124
243,JEFF DAVIS,243,0002,2430002,6025,494,257,237,10,4,216,218,405,221,184,8,3,169,170
259,KENDALL,259,3060,2593060,6271,969,727,242,20,7,174,177,781,605,176,12,1,129,130
303,LUBBOCK,303,0054,3030054,6566,3828,3020,808,64,118,559,665,3094,2545,549,45,63,374,433
329,MIDLAND,329,0104,3290104,6812,2344,552,1792,20,136,1624,1747,1681,460,1221,11,90,1105,1190
353,NOLAN,353,0001,3530001,7107,1898,1057,841,23,135,653,763,1427,847,580,13,79,435,511
367,PARKER,367,0230,3670230,7353,2345,1837,508,13,48,328,374,1777,1448,329,7,33,202,234
85,COLLIN,85,0068,850068,1697,3581,1352,2229,147,368,1633,1970,2724,1185,1539,112,256,1096,1340
93,COMANCHE,93,0012,930012,1943,2975,2109,866,8,32,755,775,2347,1737,610,5,20,525,539
113,DALLAS,113,3047,1133047,2484,5638,508,5130,238,3469,1139,4575,4070,433,3637,216,2456,781,3215
121,DENTON,121,2101,1212101,3025,8486,2108,6378,754,3675,1923,5475,7034,1959,5075,668,2811,1532,4275
201,HARRIS,201,0725,2010725,4943,5474,790,4684,124,1970,2665,4532,3937,668,3269,88,1395,1812,3158
209,HAYS,209,0342B,2090342B,5484,57,44,13,3,3,3,6,49,38,11,3,3,1,4
17,BAILEY,17,0001,170001,131,1650,647,1003,1,22,965,979,1155,508,647,0,9,622,630
113,DALLAS,113,1079,1131079,2052,3290,1139,2151,109,879,1133,1988,2622,983,1639,91,688,821,1500
113,DALLAS,113,3108,1133108,2550,3612,1346,2266,97,1315,810,2094,2775,1170,1605,75,942,531,1464
113,DALLAS,113,2504,1132504,2384,2007,1310,697,148,117,383,491,1598,1097,501,122,79,258,335
121,DENTON,121,3124,1213124,3048,294,161,133,72,24,32,51,247,144,103,56,18,22,38
143,ERATH,143,0025,1430025,3546,1225,838,387,13,13,335,346,933,674,259,8,7,221,228
355,NUECES,355,0012,3550012,7127,2023,267,1756,8,26,1717,1735,1425,186,1239,0,19,1211,1225
405,SAN AUGUSTINE,405,0003,4050003,7625,432,245,187,6,141,46,183,363,229,134,2,111,21,131
439,TARRANT,439,2281,4392281,8123,2127,1071,1056,145,472,413,852,1798,987,811,125,362,298,644
439,TARRANT,439,3216,4393216,8289,5914,3116,2798,1102,648,899,1521,4585,2543,2042,799,451,660,1097
441,TAYLOR,441,0305,4410305,8621,4918,3719,1199,176,288,646,903,3967,3143,824,132,184,443,617
183,GREGG,183,0017,1830017,4044,1908,737,1171,16,645,463,1099,1355,583,772,8,476,248,721
199,HARDIN,199,0013,1990013,4210,3940,3455,485,49,60,251,305,2975,2661,314,33,27,164,189
201,HARRIS,201,0325,2010325,4542,5995,414,5581,74,1599,3951,5473,4187,377,3810,51,1075,2684,3721
245,JEFFERSON,245,0103,2450103,6131,476,387,89,14,16,52,68,329,270,59,9,10,34,44
293,LIMESTONE,293,0103,2930103,6463,894,735,159,7,56,72,121,729,607,122,2,40,46,86
307,MCCULLOCH,307,0302,3070302,6629,313,252,61,3,5,51,51,276,224,52,2,1,44,44
115,DAWSON,115,0002,1150002,2905,2500,639,1861,21,104,1732,1815,1786,492,1294,11,70,1200,1262
141,EL PASO,141,0090,1410090,3403,2339,380,1959,35,66,1866,1917,1858,330,1528,26,48,1456,1494
145,FALLS,145,0403,1450403,3569,1183,684,499,1,144,330,470,909,549,360,1,128,206,334
167,GALVESTON,167,0399,1670399,3901,733,122,611,23,84,487,566,571,91,480,17,69,382,449
187,GUADALUPE,187,0107,1870107,4067,1694,1199,495,24,43,364,401,1336,999,337,5,30,248,277
201,HARRIS,201,0348,2010348,4565,4420,1591,2829,183,374,2230,2563,3555,1462,2093,137,269,1623,1875
323,MAVERICK,323,001A,323001A,6772,2590,61,2529,17,5,2488,2491,2006,54,1952,12,2,1925,1925
351,NEWTON,351,0021,3510021,7104,536,472,64,4,12,36,48,432,382,50,2,9,29,38
361,ORANGE,361,0015,3610015,7270,2550,1894,656,41,365,160,520,1980,1545,435,22,231,124,351
423,SMITH,423,0047,4230047,7768,652,336,316,3,193,81,274,518,278,240,3,158,49,207
201,HARRIS,201,0845,2010845,5063,837,410,427,50,185,192,368,750,392,358,40,157,159,308
201,HARRIS,201,0182,2010182,4399,1577,564,1013,257,463,291,741,1332,483,849,200,412,229,632
215,HIDALGO,215,0058,2150058,5610,7133,253,6880,52,58,6804,6830,5025,193,4832,34,27,4781,4796
245,JEFFERSON,245,0080,2450080,6108,394,291,103,7,8,74,82,306,238,68,7,7,45,52
259,KENDALL,259,4090,2594090,6274,1587,1116,471,38,38,353,377,1252,938,314,24,22,228,244
303,LUBBOCK,303,0139,3030139,6606,2643,1939,704,118,48,483,520,1920,1430,490,80,31,324,353
29,BEXAR,29,4030,294030,841,1008,29,979,4,296,708,967,677,21,656,2,222,435,645
29,BEXAR,29,2099,292099,512,2714,922,1792,153,214,1440,1622,2126,773,1353,129,149,1058,1198
39,BRAZORIA,39,0063,390063,1176,6806,1056,5750,638,3174,1974,5051,4712,785,3927,449,2169,1282,3420
61,CAMERON,61,0093,610093,1505,1003,89,914,31,14,877,883,712,68,644,24,9,611,616
85,COLLIN,85,0208,850208,1837,3687,2302,1385,528,338,430,740,2631,1715,916,355,227,273,481
113,DALLAS,113,4555,1134555,2836,73,28,45,0,1,40,40,60,26,34,0,0,31,31
471,WALKER,471,0302,4710302,9168,1294,749,545,18,191,303,492,974,603,371,8,126,210,335
491,WILLIAMSON,491,0390A,4910390A,9497,4339,2682,1657,693,230,660,863,3026,1915,1111,471,167,419,564
245,JEFFERSON,245,0054,2450054,6082,684,38,646,10,555,82,632,521,36,485,5,423,58,478
257,KAUFMAN,257,0030,2570030,6251,4112,2169,1943,32,128,1699,1807,2765,1637,1128,8,74,965,1033
339,MONTGOMERY,339,0022,3390022,6915,7870,5607,2263,105,487,1397,1863,5973,4465,1508,71,318,895,1205
437,SWISHER,437,0004,4370004,7837,1030,273,757,8,133,617,737,731,215,516,6,86,419,500
439,TARRANT,439,4285,4394285,8501,3260,1213,2047,96,879,1053,1886,2292,992,1300,74,531,661,1176
453,TRAVIS,453,0267,4530267,8836,4055,2842,1213,512,125,526,627,3169,2265,904,381,95,384,463
113,DALLAS,113,1714,1131714,2172,5295,1162,4133,86,272,3739,3974,3720,978,2742,55,177,2468,2628
157,FORT BEND,157,4025,1574025,3758,9033,2385,6648,322,1543,4765,6210,6388,1907,4481,223,976,3243,4177
201,HARRIS,201,0205,2010205,4422,2646,53,2593,8,1942,656,2567,1988,43,1945,6,1521,423,1925
201,HARRIS,201,0374,2010374,4591,1288,61,1227,9,40,1181,1214,992,60,932,5,28,901,925
201,HARRIS,201,1037,2011037,5255,5630,297,5333,2088,1532,1732,3224,4298,246,4052,1698,1083,1271,2332
207,HASKELL,207,0003,2070003,5418,882,552,330,12,63,258,311,670,448,222,7,37,171,207
29,BEXAR,29,2073,292073,486,2388,314,2074,19,116,1943,2032,1772,268,1504,17,63,1417,1468
67,CASS,67,0007,670007,1531,3350,2484,866,13,519,234,746,2487,1922,565,9,341,134,472
113,DALLAS,113,1737,1131737,2195,5893,3653,2240,1256,397,503,881,4838,3165,1673,945,304,353,643
113,DALLAS,113,3090,1133090,2527,1985,1110,875,158,403,297,697,1937,1092,845,150,385,293,675
129,DONLEY,129,0401,1290401,3191,813,569,244,20,105,110,207,635,468,167,12,75,68,139
201,HARRIS,201,0560,2010560,4777,2632,80,2552,9,56,2504,2540,1939,64,1875,5,29,1848,1870
289,LEON,289,0013,2890013,6437,1056,891,165,5,47,96,141,926,794,132,5,43,70,111
381,RANDALL,381,0332,3810332,7482,3223,2508,715,44,36,532,562,2267,1807,460,36,15,321,335
439,TARRANT,439,4203,4394203,8478,6753,1619,5134,212,2485,2415,4805,4600,1364,3236,159,1555,1477,2989
439,TARRANT,439,2355,4392355,8146,2721,1433,1288,120,555,574,1111,1932,1095,837,88,345,368,706
469,VICTORIA,469,0022,4690022,9142,2037,1650,387,9,38,289,319,1635,1357,278,5,23,202,225
201,HARRIS,201,0020,2010020,4236,4190,1577,2613,510,1265,784,2013,3801,1490,2311,459,1132,688,1786
201,HARRIS,201,0682,2010682,4900,4876,2743,2133,82,306,1634,1917,3788,2254,1534,69,200,1149,1345
201,HARRIS,201,1014,2011014,5232,0,0,0,0,0,0,0,0,0,0,0,0,0,0
209,HAYS,209,0134,2090134,5441,4289,769,3520,44,127,3332,3430,2975,647,2328,23,79,2201,2269
215,HIDALGO,215,0221,2150221,5773,3139,136,3003,35,23,2947,2958,2240,118,2122,26,13,2084,2088
225,HOUSTON,225,0021,2250021,5896,465,334,131,2,76,40,115,370,274,96,1,63,23,86
29,BEXAR,29,3192,293192,798,0,0,0,0,0,0,0,0,0,0,0,0,0,0
41,BRAZOS,41,0028,410028,1219,477,406,71,8,9,40,49,368,319,49,7,2,26,28
41,BRAZOS,41,0105,410105,1296,145,67,78,9,21,35,55,120,53,67,8,20,26,45
61,CAMERON,61,0050,610050,1462,2950,385,2565,32,33,2501,2517,2249,354,1895,19,16,1849,1857
113,DALLAS,113,4055,1134055,2713,6714,347,6367,192,1265,4905,6125,4915,311,4604,156,1000,3415,4396
135,ECTOR,135,0102,1350102,3211,7027,1079,5948,22,65,5793,5836,4759,842,3917,18,46,3787,3827
477,WASHINGTON,477,0203,4770203,9211,2336,1664,672,24,291,321,598,1935,1440,495,18,237,210,441
489,WILLACY,489,0012,4890012,9377,154,19,135,0,1,133,134,123,12,111,0,1,109,110
491,WILLIAMSON,491,0283,4910283,9454,6654,3302,3352,402,626,2165,2735,4870,2620,2250,272,387,1446,1815
213,HENDERSON,213,01TC,21301TC,5541,4132,3463,669,45,58,398,452,3414,2924,490,32,28,271,298
215,HIDALGO,215,0244,2150244,5796,1724,95,1629,12,21,1600,1610,1244,72,1172,5,17,1152,1160
363,PALO PINTO,363,0007,3630007,7296,948,755,193,7,7,141,146,711,574,137,7,4,99,101
363,PALO PINTO,363,0001,3630001,7290,763,637,126,7,12,80,91,636,529,107,6,10,65,75
381,RANDALL,381,0114,3810114,7462,6336,3489,2847,247,419,2098,2453,4598,2784,1814,167,226,1300,1514
439,TARRANT,439,1378,4391378,7960,7391,1137,6254,300,2705,3271,5872,5235,985,4250,220,1897,2105,3964
141,EL PASO,141,0064,1410064,3377,5367,328,5039,50,205,4827,4962,4025,283,3742,44,130,3587,3682
141,EL PASO,141,0070,1410070,3383,4057,357,3700,32,54,3634,3666,3253,304,2949,28,37,2901,2924
201,HARRIS,201,0914,2010914,5132,276,51,225,2,63,154,216,247,50,197,2,60,128,188
201,HARRIS,201,1157,2011157,5375,0,0,0,0,0,0,0,0,0,0,0,0,0,0
309,MCLENNAN,309,0060,3090060,6693,4789,3516,1273,79,332,710,1020,3502,2674,828,49,210,460,660
201,HARRIS,201,0561,2010561,4778,5916,2506,3410,94,744,2531,3203,4523,2089,2434,62,532,1756,2259
491,WILLIAMSON,491,0254,4910254,9438,6107,3648,2459,394,339,1602,1902,4656,2938,1718,276,210,1113,1306
453,TRAVIS,453,0216,4530216,8797,5175,2273,2902,427,512,1929,2378,4363,2100,2263,351,411,1462,1839
389,REEVES,389,0010,3890010,7523,2538,305,2233,46,50,2128,2166,1823,242,1581,34,35,1506,1536
29,BEXAR,29,4031,294031,842,3489,260,3229,33,198,3033,3192,2576,212,2364,21,128,2225,2343
215,HIDALGO,215,0099,2150099,5651,10163,289,9874,13,38,9820,9828,7062,235,6827,8,22,6791,6799
507,ZAVALA,507,0002,5070002,9630,2429,78,2351,10,37,2311,2335,1714,67,1647,9,19,1616,1632
97,COOKE,97,0022,970022,1970,2254,2055,199,16,18,61,79,1998,1847,151,14,11,42,53
303,LUBBOCK,303,0110,3030110,6587,4905,3856,1049,242,128,579,689,3655,2968,687,176,71,352,419
29,BEXAR,29,4223,294223,1034,63,37,26,4,11,20,26,42,32,10,0,5,7,10
157,FORT BEND,157,4106,1574106,3779,11189,1086,10103,2859,4212,3153,7195,8055,887,7168,2177,2813,2230,4951
85,COLLIN,85,0149,850149,1778,6307,3743,2564,759,863,829,1640,4416,2730,1686,522,550,532,1065
167,GALVESTON,167,0146,1670146,3842,4589,2387,2202,95,595,1463,2014,3555,1989,1566,62,392,1042,1422
85,COLLIN,85,0046,850046,1675,6783,1849,4934,360,712,3780,4448,5242,1664,3578,318,519,2660,3159
157,FORT BEND,157,2028,1572028,3650,2927,1300,1627,240,946,418,1325,2437,1177,1260,172,742,304,1030
113,DALLAS,113,3607,1133607,2611,5049,363,4686,103,4071,555,4569,3876,304,3572,68,3150,355,3479
309,MCLENNAN,309,0082,3090082,6716,3793,2983,810,56,86,558,631,2975,2433,542,36,56,349,401
113,DALLAS,113,4056,1134056,2714,7864,390,7474,75,2230,5220,7366,5640,338,5302,56,1755,3502,5214
143,ERATH,143,0030,1430030,3547,856,722,134,6,9,63,71,667,589,78,2,8,32,39
29,BEXAR,29,4094,294094,905,2754,1140,1614,73,226,1294,1476,2227,1035,1192,62,157,931,1066
215,HIDALGO,215,0228,2150228,5780,3642,55,3587,4,28,3566,3568,2619,30,2589,2,17,2572,2574
491,WILLIAMSON,491,0393,4910393,9501,3086,2909,177,24,18,79,96,3074,2904,170,20,15,76,90
85,COLLIN,85,0212,850212,1841,9623,2320,7303,6132,643,355,988,5841,1538,4303,3622,403,207,603
29,BEXAR,29,3196,293196,802,18,7,11,1,1,8,8,15,7,8,0,1,7,7
201,HARRIS,201,0498,2010498,4715,3476,807,2669,166,1071,1423,2460,2631,721,1910,144,753,984,1726
115,DAWSON,115,0003,1150003,2906,2522,1215,1307,21,98,1197,1267,1852,1001,851,19,48,777,818
9,ARCHER,9,0004,90004,78,911,691,220,1,3,204,206,681,524,157,1,2,142,144
485,WICHITA,485,0405,4850405,9355,7791,4118,3673,174,751,2484,3148,5947,3411,2536,129,516,1650,2122
375,POTTER,375,0425,3750425,7440,5564,813,4751,560,1421,2780,4137,3569,672,2897,350,789,1728,2498
113,DALLAS,113,4012,1134012,2674,127,53,74,11,9,53,62,98,46,52,4,9,38,47
157,FORT BEND,157,2033,1572033,3653,1470,310,1160,80,746,354,1076,1154,285,869,66,561,247,799
29,BEXAR,29,3153,293153,759,1993,940,1053,104,195,755,931,1642,829,813,86,152,563,706
481,WHARTON,481,0302,4810302,9312,3883,1695,2188,29,299,1857,2109,2779,1399,1380,27,174,1163,1324
201,HARRIS,201,0329,2010329,4546,4550,411,4139,340,757,3102,3777,3295,370,2925,276,513,2165,2628
29,BEXAR,29,3112,293112,716,2868,825,2043,135,352,1585,1866,2306,747,1559,109,221,1231,1418
85,COLLIN,85,0152,850152,1781,995,103,892,21,19,852,866,740,87,653,21,10,623,629
113,DALLAS,113,3803,1133803,2631,6685,264,6421,72,5224,1135,6289,4769,239,4530,50,3714,741,4420
215,HIDALGO,215,0185,2150185,5737,7,4,3,1,0,2,2,5,3,2,1,0,1,1
409,SAN PATRICIO,409,0108,4090108,7652,7124,3018,4106,173,223,3517,3694,5094,2395,2699,117,134,2288,2397
163,FRIO,163,0001,1630001,3822,2055,292,1763,9,14,1726,1734,1504,247,1257,7,14,1226,1234
91,COMAL,91,0202A,910202A,1907,3570,1719,1851,106,339,1354,1672,2533,1317,1216,79,228,853,1070
215,HIDALGO,215,0059,2150059,5611,5076,102,4974,7,20,4936,4945,3504,54,3450,4,17,3421,3429
157,FORT BEND,157,3022,1573022,3696,4785,2040,2745,983,557,1177,1706,3785,1749,2036,765,416,811,1211
29,BEXAR,29,4117,294117,928,700,339,361,19,34,312,331,554,287,267,8,29,225,241
213,HENDERSON,213,0003,2130003,5525,3688,912,2776,32,1101,1620,2697,2735,805,1930,29,829,1038,1863
397,ROCKWALL,397,002C,397002C,7566,2008,1555,453,101,78,200,269,1567,1265,302,61,44,126,169
201,HARRIS,201,0455,2010455,4672,2829,42,2787,10,1747,1068,2767,2186,40,2146,6,1436,719,2130
491,WILLIAMSON,491,0426,4910426,9524,1414,964,450,44,64,280,327,1090,774,316,29,49,192,236
215,HIDALGO,215,0142,2150142,5694,5833,116,5717,21,24,5651,5661,3791,80,3711,15,22,3656,3666
85,COLLIN,85,0195,850195,1824,1235,880,355,51,40,231,253,910,703,207,31,22,128,141
439,TARRANT,439,4129,4394129,8459,1468,1263,205,36,29,114,138,1077,941,136,22,14,76,88
287,LEE,287,0303,2870303,6418,332,286,46,3,28,19,39,274,241,33,1,21,11,28
441,TAYLOR,441,0407,4410407,8631,2299,1554,745,106,191,394,561,1680,1228,452,76,102,222,317
201,HARRIS,201,0412,2010412,4629,884,59,825,16,397,433,810,688,58,630,9,339,297,621
171,GILLESPIE,171,0009,1710009,3948,202,169,33,1,2,25,26,171,147,24,1,1,18,19
167,GALVESTON,167,0215,1670215,3865,5851,2451,3400,119,1079,2104,3125,4865,2224,2641,79,820,1632,2423
5,ANGELINA,5,0009,50009,35,373,261,112,11,69,34,101,297,231,66,8,42,17,58
201,HARRIS,201,0686,2010686,4904,1069,173,896,331,159,420,562,698,119,579,165,123,299,410
381,RANDALL,381,0415,3810415,7483,6420,3802,2618,253,394,1837,2201,4566,2841,1725,171,229,1193,1414
113,DALLAS,113,4505,1134505,2800,3782,992,2790,92,636,2031,2628,2836,878,1958,70,442,1402,1822
85,COLLIN,85,0169,850169,1798,5933,2535,3398,1821,818,681,1471,3950,1822,2128,1149,510,408,908
303,LUBBOCK,303,0140,3030140,6607,3740,2527,1213,172,130,854,976,2715,1937,778,119,75,529,604
427,STARR,427,0001,4270001,7798,3465,94,3371,5,7,3351,3354,2408,74,2334,1,5,2326,2328
499,WOOD,499,04-4,49904-4,9607,1204,980,224,17,43,106,148,919,767,152,16,20,68,87
309,MCLENNAN,309,0080A,3090080A,6713,3233,2756,477,26,71,275,340,2446,2114,332,13,53,180,231
201,HARRIS,201,0581,2010581,4798,1399,22,1377,6,905,479,1369,1045,19,1026,4,749,279,1020
439,TARRANT,439,4400,4394400,8522,873,376,497,8,25,453,473,671,333,338,4,16,306,319
29,BEXAR,29,4200,294200,1011,5204,565,4639,145,341,4214,4475,3586,451,3135,100,215,2836,3022
201,HARRIS,201,0518,2010518,4735,7077,2513,4564,1275,1328,1894,3165,5683,2185,3498,1030,1021,1370,2350
121,DENTON,121,1002,1211002,2926,340,274,66,0,9,46,55,256,211,45,0,5,33,38
39,BRAZORIA,39,0004,390004,1117,5765,3299,2466,61,1028,1290,2286,4703,2718,1985,37,892,976,1855
323,MAVERICK,323,002A,323002A,6776,1340,27,1313,3,0,1304,1304,996,26,970,3,0,964,964
113,DALLAS,113,4623,1134623,2863,5978,1171,4807,246,348,4159,4466,4340,1029,3311,195,234,2823,3033
35,BOSQUE,35,0001,350001,1054,886,724,162,4,9,131,135,693,601,92,3,0,73,73
29,BEXAR,29,4137,294137,948,199,144,55,5,4,40,43,158,116,42,5,3,28,30
113,DALLAS,113,40A3,11340A3,2757,0,0,0,0,0,0,0,0,0,0,0,0,0,0
439,TARRANT,439,4204,4394204,8479,7905,4037,3868,302,834,2476,3251,5993,3310,2683,227,556,1674,2202
309,MCLENNAN,309,0038,3090038,6670,1477,530,947,12,298,636,904,1056,415,641,11,204,407,605
423,SMITH,423,0014,4230014,7735,3189,1383,1806,47,580,1133,1695,2275,1075,1200,37,429,689,1113
439,TARRANT,439,4689,4394689,8585,328,103,225,5,5,216,220,247,96,151,5,5,142,146
491,WILLIAMSON,491,0488,4910488,9544,4772,2578,2194,742,395,1034,1387,3340,1872,1468,500,264,673,915
491,WILLIAMSON,491,0341,4910341,9481,4096,2530,1566,68,320,1105,1372,3106,2085,1021,51,174,717,866
29,BEXAR,29,4074,294074,885,4059,1164,2895,40,88,2743,2789,3024,966,2058,29,49,1939,1975
411,SAN SABA,411,002B,411002B,7672,690,346,344,19,5,314,319,513,295,218,14,1,197,198
401,RUSK,401,0319,4010319,7609,406,239,167,0,147,14,160,340,190,150,0,139,6,145
439,TARRANT,439,3511,4393511,8353,5496,2192,3304,717,1475,1047,2443,4425,1958,2467,570,1065,770,1781
303,LUBBOCK,303,0030,3030030,6544,4249,1919,2330,118,431,1717,2114,3232,1616,1616,99,269,1161,1425
215,HIDALGO,215,0248,2150248,5800,164,0,164,0,4,164,164,111,0,111,0,2,111,111
491,WILLIAMSON,491,0198,4910198,9418,170,13,157,138,6,7,10,100,9,91,85,3,1,4
439,TARRANT,439,4016,4394016,8416,2016,1468,548,44,186,296,467,1731,1319,412,25,128,228,351
113,DALLAS,113,4033,1134033,2694,7021,2761,4260,235,2633,1401,3968,6896,2740,4156,225,2574,1366,3876
223,HOPKINS,223,0012,2230012,5863,360,319,41,3,3,29,32,280,256,24,0,2,21,23
201,HARRIS,201,0286,2010286,4503,6922,202,6720,72,2698,4002,6629,5264,167,5097,58,2184,2892,5028
95,CONCHO,95,0203,950203,1950,136,120,16,2,1,10,10,115,101,14,2,1,8,8
215,HIDALGO,215,0016,2150016,5568,3111,72,3039,8,25,3023,3031,2165,56,2109,6,15,2101,2106
339,MONTGOMERY,339,0066,3390066,6965,7260,4424,2836,147,243,2240,2466,5282,3507,1775,102,158,1354,1507
187,GUADALUPE,187,0113,1870113,4071,2018,1089,929,23,32,800,829,1566,930,636,11,16,556,571
201,HARRIS,201,0832,2010832,5050,1560,102,1458,38,220,1210,1413,1062,98,964,30,175,764,926
113,DALLAS,113,1411,1131411,2156,7379,1156,6223,126,1939,4147,6025,5014,976,4038,98,1319,2589,3882
245,JEFFERSON,245,0001,2450001,6029,3444,256,3188,11,1973,1208,3160,2393,233,2160,9,1404,743,2136
121,DENTON,121,4209,1214209,3135,4403,2631,1772,251,237,1124,1333,3281,2099,1182,171,118,755,866
187,GUADALUPE,187,0230,1870230,4114,67,48,19,2,1,15,15,51,40,11,1,0,10,10
27,BELL,27,0405,270405,241,10012,2097,7915,618,4743,2651,6983,6851,1629,5222,433,3010,1722,4534
41,BRAZOS,41,0029,410029,1220,985,651,334,13,187,104,287,847,577,270,9,155,77,228
231,HUNT,231,0103,2310103,5943,1005,809,196,10,18,118,136,818,671,147,6,13,85,98
439,TARRANT,439,1297,4391297,7944,5407,197,5210,38,3741,1448,5134,3835,183,3652,31,2716,892,3591
125,DICKENS,125,0005,1250005,3178,256,188,68,5,11,58,61,206,156,50,4,7,43,46
183,GREGG,183,0001,1830001,4028,3194,1833,1361,36,702,546,1230,2529,1554,975,26,545,334,868
201,HARRIS,201,0875,2010875,5093,7185,1939,5246,1269,1648,2337,3883,4983,1471,3512,896,1059,1511,2527
235,IRION,235,0200,2350200,5986,378,299,79,4,11,65,74,310,244,66,4,8,55,62
439,TARRANT,439,1149,4391149,7901,7717,1054,6663,143,3012,3528,6455,5340,881,4459,80,2220,2142,4320
27,BELL,27,0110,270110,198,10130,5038,5092,558,1885,2478,4157,8155,4193,3962,451,1410,1921,3211
41,BRAZOS,41,0072,410072,1263,50,35,15,1,5,10,14,36,29,7,1,2,5,6
113,DALLAS,113,1164,1131164,2113,3112,2340,772,156,146,342,482,2631,2022,609,120,123,265,384
453,TRAVIS,453,0213,4530213,8794,3924,2787,1137,303,138,623,742,3557,2523,1034,280,114,560,660
227,HOWARD,227,0013,2270013,5900,5481,825,4656,56,461,4131,4510,5133,751,4382,46,383,3944,4251
429,STEPHENS,429,0004,4290004,7815,2207,1642,565,10,38,450,484,1746,1356,390,6,25,299,322
121,DENTON,121,3125,1213125,3049,728,291,437,282,56,74,130,549,224,325,210,45,57,102
21,BASTROP,21,2010,212010,155,1340,790,550,47,181,304,479,1130,696,434,34,144,240,379
39,BRAZORIA,39,0021,390021,1134,8092,1581,6511,383,2880,3283,6045,5460,1195,4265,268,1889,2068,3912
337,MONTAGUE,337,0002,3370002,6879,3203,2655,548,16,34,363,391,2585,2175,410,13,15,268,279
179,GRAY,179,0006,1790006,3985,4282,2939,1343,34,83,1088,1158,3146,2349,797,22,38,616,649
201,HARRIS,201,0746,2010746,4964,1781,735,1046,224,237,545,769,1462,649,813,185,182,406,581
113,DALLAS,113,1097,1131097,2070,6647,469,6178,36,1065,5099,6120,4677,424,4253,27,832,3393,4210
29,BEXAR,29,1034,291034,284,7595,2458,5137,501,1285,3404,4527,4875,1716,3159,291,780,2027,2751
113,DALLAS,113,1741,1131741,2199,8464,1923,6541,2052,2065,2343,4343,6285,1653,4632,1572,1437,1542,2953
453,TRAVIS,453,0336,4530336,8880,4688,2518,2170,252,224,1637,1799,3699,2123,1576,194,150,1158,1280
201,HARRIS,201,0661,2010661,4878,6251,2268,3983,817,1219,1931,3099,4907,1933,2974,679,857,1402,2234
453,TRAVIS,453,0102,4530102,8708,3485,2004,1481,245,495,689,1152,3048,1792,1256,217,417,578,972
217,HILL,217,0003,2170003,5814,3514,818,2696,23,725,1941,2648,2452,693,1759,19,500,1221,1721
303,LUBBOCK,303,0104,3030104,6584,1619,1109,510,125,66,306,360,1165,814,351,80,53,208,255
121,DENTON,121,2082,1212082,3006,2288,1127,1161,769,142,195,334,1481,782,699,454,88,115,201
329,MIDLAND,329,0307,3290307,6836,2096,913,1183,29,105,1005,1098,1579,750,829,15,78,696,768
201,HARRIS,201,0495,2010495,4712,3870,1717,2153,771,465,830,1280,3104,1466,1638,591,360,610,963
215,HIDALGO,215,0096,2150096,5648,4887,821,4066,160,74,3802,3860,3753,687,3066,132,55,2854,2898
453,TRAVIS,453,0268,4530268,8837,3297,1535,1762,1460,48,210,252,2398,1197,1201,997,39,128,163
423,SMITH,423,0051,4230051,7772,5784,3369,2415,499,1177,615,1763,4240,2649,1591,343,767,386,1145
13,ATASCOSA,13,0019,130019,112,692,311,381,3,9,344,352,517,238,279,2,9,246,254
39,BRAZORIA,39,0064,390064,1177,117,30,87,9,25,54,75,69,25,44,3,3,34,37
171,GILLESPIE,171,0003,1710003,3942,2120,1394,726,37,30,632,653,1674,1209,465,30,13,395,406
201,HARRIS,201,0789,2010789,5007,5405,2017,3388,465,1384,1577,2844,4294,1730,2564,381,1027,1159,2115
29,BEXAR,29,4071,294071,882,1897,1326,571,16,65,464,527,1552,1153,399,13,42,315,357
113,DALLAS,113,2037,1132037,2242,2252,1839,413,121,76,166,242,2168,1778,390,117,70,157,227
91,COMAL,91,0109,910109,1904,2107,1618,489,28,51,346,388,1604,1285,319,19,29,218,244
37,BOWIE,37,0017,370017,1074,2419,2077,342,17,188,78,262,1841,1582,259,8,146,52,196
157,FORT BEND,157,4099,1574099,3776,6430,735,5695,2036,1702,2029,3651,4994,661,4333,1658,1243,1459,2655
121,DENTON,121,1022,1211022,2946,6277,3318,2959,1565,695,604,1263,4478,2530,1948,983,492,402,875
29,BEXAR,29,4220,294220,1031,10,0,10,0,5,7,10,7,0,7,0,3,4,7
201,HARRIS,201,1021,2011021,5239,2204,484,1720,108,780,810,1564,1692,445,1247,93,553,580,1111
111,DALLAM,111,0001,1110001,2010,767,472,295,3,6,269,274,533,352,181,1,3,169,171
11,ARMSTRONG,11,0404,110404,95,41,39,2,2,0,1,1,30,30,0,0,0,0,0
113,DALLAS,113,4600,1134600,2840,4442,1063,3379,1113,453,1754,2177,3318,902,2416,811,316,1235,1534
309,MCLENNAN,309,0057,3090057,6690,2806,1231,1575,89,391,1056,1422,2238,1104,1134,80,299,698,994
325,MEDINA,325,002C,325002C,6793,6635,3055,3580,86,115,3281,3366,5022,2452,2570,58,69,2353,2406
215,HIDALGO,215,0202,2150202,5754,1831,669,1162,7,11,1133,1138,1406,657,749,4,6,728,730
423,SMITH,423,0008,4230008,7729,2158,1587,571,12,267,252,511,1692,1284,408,7,213,157,366
439,TARRANT,439,4276,4394276,8499,4066,2175,1891,205,466,1148,1584,2908,1673,1235,142,300,733,1013
201,HARRIS,201,0703,2010703,4921,3554,2827,727,154,134,352,471,2798,2274,524,116,96,255,339
167,GALVESTON,167,0340,1670340,3882,1520,107,1413,14,673,728,1389,1010,86,924,9,465,446,906
29,BEXAR,29,1077,291077,327,2745,114,2631,7,27,2600,2616,2114,93,2021,4,12,2001,2012
439,TARRANT,439,2161,4392161,8090,4733,1739,2994,1016,1072,863,1904,4367,1634,2733,946,992,743,1716
313,MADISON,313,0101,3130101,6730,5002,1904,3098,36,1285,1768,3026,4345,1649,2696,31,1194,1459,2634
397,ROCKWALL,397,001E,397001E,7563,2798,2159,639,126,173,283,442,2061,1646,415,94,117,164,267
439,TARRANT,439,1025,4391025,7858,4186,780,3406,51,1003,2359,3325,2975,699,2276,39,731,1494,2205
201,HARRIS,201,0601,2010601,4818,5547,3514,2033,465,571,889,1434,4158,2750,1408,346,392,585,973
339,MONTGOMERY,339,0028B,3390028B,6922,110,34,76,1,0,68,68,77,31,46,0,0,39,39
223,HOPKINS,223,0002,2230002,5857,3380,2295,1085,46,296,635,922,2564,1806,758,26,212,422,633
457,TYLER,457,0001,4570001,9026,539,444,95,2,44,35,77,420,361,59,1,26,17,43
201,HARRIS,201,0683,2010683,4901,955,70,885,4,30,853,878,674,59,615,2,18,594,609
121,DENTON,121,1062,1211062,2986,3761,2334,1427,166,407,737,1120,3024,2023,1001,117,270,508,767
11,ARMSTRONG,11,0303,110303,92,63,57,6,2,2,6,6,53,47,6,2,2,6,6
49,BROWN,49,0214,490214,1326,1112,979,133,4,14,77,88,949,849,100,4,9,53,59
451,TOM GREEN,451,0306,4510306,8688,3747,1772,1975,145,245,1544,1742,2538,1284,1254,93,150,943,1075
245,JEFFERSON,245,0064,2450064,6092,1085,230,855,23,584,253,824,854,207,647,19,460,160,617
121,DENTON,121,2105,1212105,3029,3180,1868,1312,346,209,700,893,2582,1601,981,270,174,497,657
39,BRAZORIA,39,0001,390001,1114,8300,3425,4875,115,797,3879,4576,6115,2767,3348,87,506,2636,3112
425,SOMERVELL,425,0002,4250002,7795,2267,1894,373,15,42,255,287,1775,1533,242,9,19,157,173
109,CULBERSON,109,0004,1090004,2007,547,111,436,13,20,402,416,405,91,314,11,18,285,297
193,HAMILTON,193,0005,1930005,4177,150,134,16,4,1,7,8,128,116,12,4,1,3,4
39,BRAZORIA,39,0044,390044,1157,6973,2418,4555,1823,1691,1014,2642,4881,1744,3137,1224,1219,663,1850
227,HOWARD,227,0209,2270209,5923,0,0,0,0,0,0,0,0,0,0,0,0,0,0
167,GALVESTON,167,0277,1670277,3879,3790,2971,819,25,46,616,655,2961,2390,571,15,26,421,445
201,HARRIS,201,0852,2010852,5070,3614,2526,1088,182,250,572,801,2585,1892,693,121,166,347,507
41,BRAZOS,41,0049,410049,1240,858,520,338,70,95,175,264,780,476,304,68,80,156,233
437,SWISHER,437,0006,4370006,7838,568,223,345,7,26,309,325,412,173,239,2,17,212,225
121,DENTON,121,9201,1219201,3155,0,0,0,0,0,0,0,0,0,0,0,0,0,0
201,HARRIS,201,0726,2010726,4944,2644,1929,715,42,65,559,620,1996,1538,458,22,38,365,403
323,MAVERICK,323,001B,323001B,6773,2502,137,2365,38,16,2312,2322,1814,104,1710,30,10,1668,1674
491,WILLIAMSON,491,0485,4910485,9541,3411,1627,1784,251,376,1094,1447,2362,1208,1154,162,231,700,926
201,HARRIS,201,0641,2010641,4858,6651,1998,4653,810,1448,2362,3748,5078,1747,3331,647,982,1656,2601
453,TRAVIS,453,0305,4530305,8857,2948,1932,1016,394,96,455,531,2679,1827,852,309,78,394,459
409,SAN PATRICIO,409,0125,4090125,7669,84,37,47,1,3,42,42,61,29,32,1,0,30,30
201,HARRIS,201,0558,2010558,4775,2909,567,2342,406,994,950,1905,2272,504,1768,342,726,704,1401
241,JASPER,241,0006,2410006,6009,1954,957,997,11,590,366,954,1516,815,701,8,433,235,666
113,DALLAS,113,1721,1131721,2179,3184,1318,1866,134,450,1236,1668,2550,1203,1347,95,331,870,1193
339,MONTGOMERY,339,0006,3390006,6899,6212,3797,2415,831,297,1217,1491,4292,2681,1611,557,209,799,993
29,BEXAR,29,4134,294134,945,19,7,12,0,2,9,10,16,6,10,0,2,7,8
29,BEXAR,29,1011,291011,261,2169,112,2057,10,16,2039,2045,1698,95,1603,8,11,1590,1594
439,TARRANT,439,4592,4394592,8562,0,0,0,0,0,0,0,0,0,0,0,0,0,0
201,HARRIS,201,0515,2010515,4732,3949,2793,1156,404,213,473,677,3106,2272,834,303,148,321,463
215,HIDALGO,215,0245,2150245,5797,1454,19,1435,2,8,1426,1426,932,5,927,2,5,922,922
201,HARRIS,201,0809,2010809,5027,391,60,331,26,23,279,299,275,51,224,22,19,179,196
445,TERRY,445,0401,4450401,8645,2428,810,1618,7,90,1522,1586,1746,652,1094,7,64,1022,1075
439,TARRANT,439,1394,4391394,7964,0,0,0,0,0,0,0,0,0,0,0,0,0,0
113,DALLAS,113,4678,1134678,2903,371,82,289,230,30,37,60,271,70,201,170,12,19,30
353,NOLAN,353,0005,3530005,7111,145,135,10,0,1,5,6,124,119,5,0,0,2,2
439,TARRANT,439,1094,4391094,7881,3103,1266,1837,121,495,1185,1663,2595,1172,1423,108,379,888,1257
131,DUVAL,131,0007,1310007,3198,239,49,190,1,6,174,179,200,42,158,0,2,145,147
185,GRIMES,185,0003,1850003,4051,4557,908,3649,18,1460,2162,3580,3252,703,2549,16,1062,1446,2491
19,BANDERA,19,0203,190203,138,3077,2304,773,52,50,571,613,2469,1911,558,40,29,407,432
329,MIDLAND,329,0108A,3290108A,6816,1713,772,941,36,80,793,868,1252,590,662,23,54,551,605
113,DALLAS,113,1311,1131311,2133,4243,1344,2899,118,619,2160,2707,3117,1152,1965,85,423,1421,1810
167,GALVESTON,167,0492,1670492,3925,2455,1823,632,107,78,387,457,1932,1495,437,63,65,266,325
29,BEXAR,29,4114,294114,925,226,28,198,17,55,137,177,153,24,129,8,34,89,119
181,GRAYSON,181,0210,1810210,4005,3196,2617,579,34,66,250,313,2351,1994,357,21,41,136,177
453,TRAVIS,453,0333,4530333,8877,3364,1830,1534,283,206,990,1164,2875,1599,1276,254,176,792,947
113,DALLAS,113,4620,1134620,2860,5002,932,4070,152,288,3594,3856,3645,824,2821,132,230,2424,2641
227,HOWARD,227,0024,2270024,5903,557,434,123,32,7,73,79,436,352,84,30,5,42,46
51,BURLESON,51,0308,510308,1346,567,439,128,1,79,46,124,454,357,97,0,64,33,97
453,TRAVIS,453,0240,4530240,8814,10070,2187,7883,463,875,6497,7262,7473,1937,5536,339,627,4494,5069
187,GUADALUPE,187,0210,1870210,4094,1329,569,760,21,39,690,725,1025,480,545,17,27,492,518
33,BORDEN,33,002B,33002B,1051,66,60,6,4,1,4,5,54,50,4,3,1,3,4
309,MCLENNAN,309,0015,3090015,6647,398,257,141,2,13,122,132,296,192,104,2,12,87,97
201,HARRIS,201,0915,2010915,5133,4851,2686,2165,342,554,1195,1718,3388,1971,1417,240,342,777,1106
113,DALLAS,113,1169,1131169,2116,3940,3179,761,172,112,394,493,2864,2332,532,117,86,258,333
339,MONTGOMERY,339,0044,3390044,6942,5774,2638,3136,118,918,2033,2892,4138,2134,2004,93,553,1307,1829
453,TRAVIS,453,0153,4530153,8751,5714,3087,2627,563,705,1297,1964,3973,2281,1692,344,471,804,1257
339,MONTGOMERY,339,0105,3390105,7005,5023,4137,886,100,170,437,599,3927,3323,604,78,119,291,407
27,BELL,27,0409,270409,244,3505,1178,2327,278,1209,861,1938,2492,923,1569,177,807,542,1284
309,MCLENNAN,309,0077,3090077,6710,2806,1983,823,23,157,565,707,2103,1564,539,11,97,367,461
29,BEXAR,29,4177,294177,988,54,0,54,0,0,54,54,37,0,37,0,0,37,37
113,DALLAS,113,1045,1131045,2027,7585,993,6592,162,2709,3704,6350,5746,901,4845,137,2094,2581,4641
423,SMITH,423,0054,4230054,7775,4876,3412,1464,243,624,487,1089,4159,3040,1119,174,470,365,827
497,WISE,497,0019,4970019,9584,707,584,123,3,8,88,94,612,520,92,0,5,65,69
121,DENTON,121,4167,1214167,3092,8868,3341,5527,362,1273,3755,4985,7373,3040,4333,344,1048,2823,3847
113,DALLAS,113,4502,1134502,2797,5973,1267,4706,859,1983,1889,3806,4441,1062,3379,630,1432,1284,2692
231,HUNT,231,0428,2310428,5966,3896,2236,1660,92,924,472,1382,3298,1885,1413,85,844,336,1171
41,BRAZOS,41,0091B,410091B,1283,16,13,3,0,1,3,3,11,10,1,0,1,1,1
439,TARRANT,439,4685,4394685,8582,18,1,17,1,5,13,17,8,1,7,0,2,5,7
499,WOOD,499,04-1,49904-1,9604,1185,1007,178,11,25,100,125,907,780,127,9,14,72,86
495,WINKLER,495,0101,4950101,9561,1927,739,1188,23,58,1097,1132,1355,588,767,11,24,718,738
215,HIDALGO,215,0179,2150179,5731,1424,22,1402,1,1,1400,1400,886,13,873,1,1,873,873
409,SAN PATRICIO,409,0102,4090102,7646,3656,938,2718,18,45,2628,2658,2766,795,1971,11,29,1900,1927
449,TITUS,449,0018,4490018,8668,487,190,297,14,18,255,271,319,146,173,6,11,145,156
319,MASON,319,0405,3190405,6753,965,763,202,6,11,168,175,792,645,147,5,10,118,124
119,DELTA,119,0010,1190010,2923,534,463,71,7,22,27,45,438,390,48,3,16,18,32
201,HARRIS,201,0621,2010621,4838,3002,779,2223,330,483,1409,1860,2421,680,1741,283,364,1088,1435
29,BEXAR,29,4197,294197,1008,57,15,42,0,14,30,39,29,7,22,0,7,17,22
423,SMITH,423,0011,4230011,7732,4601,366,4235,30,1798,2400,4167,3246,304,2942,25,1400,1506,2893
217,HILL,217,0006,2170006,5817,2796,1439,1357,23,215,1033,1238,2097,1200,897,8,134,687,817
167,GALVESTON,167,0401,1670401,3902,2317,1318,999,333,210,428,628,1527,903,624,221,125,247,368
7,ARANSAS,7,0004,70004,72,4876,3710,1166,233,55,709,754,4188,3307,881,185,24,514,536
99,CORYELL,99,0415,990415,1987,299,253,46,4,2,24,26,237,205,32,2,2,15,17
453,TRAVIS,453,0155,4530155,8754,5415,2414,3001,432,900,1587,2438,3801,1792,2009,297,600,1025,1613
439,TARRANT,439,1611,4391611,8027,36,9,27,0,0,27,27,26,4,22,0,0,22,22
113,DALLAS,113,2097,1132097,2282,0,0,0,0,0,0,0,0,0,0,0,0,0,0
201,HARRIS,201,0706,2010706,4924,6392,1605,4787,1538,2156,1046,3154,5156,1426,3730,1268,1612,810,2388
37,BOWIE,37,004A,37004A,1094,2075,672,1403,47,1153,160,1303,1511,599,912,36,730,102,829
347,NACOGDOCHES,347,0044,3470044,7048,2851,2144,707,20,138,485,616,2152,1695,457,12,89,304,388
431,STERLING,431,0001B,4310001B,7818,65,43,22,1,0,22,22,50,38,12,0,0,12,12
139,ELLIS,139,1007,1391007,3261,2857,1884,973,37,220,637,843,2136,1483,653,26,156,406,556
181,GRAYSON,181,0102,1810102,3988,4663,1553,3110,169,806,2021,2794,3455,1307,2148,160,595,1290,1877
113,DALLAS,113,1048,1131048,2030,3342,2354,988,114,130,670,784,2741,2044,697,82,90,453,539
439,TARRANT,439,1441,4391441,7984,2078,332,1746,105,1222,396,1595,1603,296,1307,89,897,300,1183
325,MEDINA,325,003C,325003C,6796,3655,1650,2005,28,60,1853,1896,2801,1358,1443,22,35,1326,1356
121,DENTON,121,1042,1211042,2966,4387,2191,2196,299,893,936,1792,3000,1582,1418,208,575,574,1133
113,DALLAS,113,2141,1132141,2325,2273,540,1733,90,638,1001,1625,1840,483,1357,85,536,727,1260
351,NEWTON,351,0008C,3510008C,7091,4,4,0,0,0,0,0,4,4,0,0,0,0,0
135,ECTOR,135,0201,1350201,3218,5585,2855,2730,396,280,1954,2222,3935,2132,1803,295,178,1246,1419
183,GREGG,183,0004,1830004,4031,4349,3393,956,93,507,283,779,3538,2812,726,74,415,174,585
21,BASTROP,21,2013,212013,158,4477,2900,1577,57,133,1228,1340,3571,2500,1071,34,89,814,890
121,DENTON,121,4170,1214170,3095,7672,3258,4414,989,1437,1911,3260,7218,3144,4074,919,1368,1699,2986
415,SCURRY,415,0013,4150013,7689,663,429,234,3,5,211,213,491,339,152,3,3,138,140
113,DALLAS,113,1701,1131701,2159,4648,1185,3463,338,309,2755,3046,3443,989,2454,284,229,1875,2095
167,GALVESTON,167,0202,1670202,3859,2416,1503,913,112,323,435,726,2060,1370,690,100,201,327,517
201,HARRIS,201,0872,2010872,5090,2986,610,2376,26,45,2277,2312,1957,464,1493,16,33,1421,1449
441,TAYLOR,441,0401,4410401,8625,4095,2833,1262,238,316,620,921,2759,1959,800,167,191,376,559
189,HALE,189,0215,1890215,4154,723,247,476,9,34,430,460,530,183,347,6,17,322,339
201,HARRIS,201,0578,2010578,4795,2579,1826,753,142,87,438,514,1949,1410,539,84,65,314,377
453,TRAVIS,453,0381A,4530381A,8920,4628,2241,2387,466,676,1233,1831,3757,1945,1812,356,488,921,1372
223,HOPKINS,223,0005,2230005,5860,986,698,288,30,22,200,221,710,541,169,26,11,106,117
5,ANGELINA,5,0003,50003,29,3546,2350,1196,13,198,896,1093,2723,1916,807,13,160,572,731
55,CALDWELL,55,0400,550400,1389,1745,476,1269,15,74,1159,1230,1239,414,825,11,61,734,793
243,JEFF DAVIS,243,0003,2430003,6026,490,290,200,10,8,181,185,403,261,142,4,1,130,131
423,SMITH,423,0082,4230082,7792,127,42,85,0,13,68,81,71,30,41,0,5,32,37
27,BELL,27,0114,270114,201,5551,2831,2720,236,1005,1416,2281,3987,2202,1785,168,669,855,1461
337,MONTAGUE,337,0005,3370005,6882,1746,1372,374,23,24,257,279,1306,1070,236,17,8,152,160
39,BRAZORIA,39,0024,390024,1137,2271,1207,1064,28,88,923,999,1740,976,764,21,57,658,711
329,MIDLAND,329,309A,329309A,6856,150,75,75,4,17,45,60,136,71,65,2,17,37,52
453,TRAVIS,453,0180,4530180,8771,5960,1526,4434,661,842,2928,3677,4339,1273,3066,502,589,1935,2471
245,JEFFERSON,245,0084,2450084,6112,1321,53,1268,8,935,330,1256,1001,45,956,7,729,222,945
121,DENTON,121,2085,1212085,3009,5300,3236,2064,332,521,1052,1549,4175,2700,1475,253,354,733,1076
29,BEXAR,29,1117,291117,367,638,43,595,9,23,555,577,497,35,462,9,18,430,448
183,GREGG,183,0021,1830021,4048,9720,2787,6933,101,3142,3607,6676,7141,2421,4720,63,2239,2335,4540
29,BEXAR,29,1014,291014,264,2642,82,2560,21,55,2504,2530,1948,67,1881,15,30,1836,1856
453,TRAVIS,453,0430,4530430,8963,3957,2274,1683,103,226,1262,1471,3402,2035,1367,81,204,986,1180
171,GILLESPIE,171,0006,1710006,3945,831,600,231,1,12,204,216,698,528,170,1,4,153,157
201,HARRIS,201,0766,2010766,4984,1243,54,1189,3,51,1138,1183,930,54,876,1,38,837,873
41,BRAZOS,41,0009,410009,1200,3130,1824,1306,495,247,535,759,2730,1641,1089,453,185,422,592
201,HARRIS,201,0664,2010664,4881,8437,375,8062,92,660,7348,7948,5810,322,5488,78,473,4933,5390
227,HOWARD,227,0205,2270205,5920,1870,1449,421,19,51,314,353,1384,1118,266,15,23,191,206
339,MONTGOMERY,339,0085,3390085,6985,6642,3959,2683,56,234,2219,2432,4929,3205,1724,29,136,1410,1534
231,HUNT,231,0106,2310106,5946,4295,2267,2028,76,962,920,1844,3363,1941,1422,54,664,636,1280
201,HARRIS,201,0958,2010958,5176,5105,211,4894,469,1373,3050,4399,3490,147,3343,340,972,2043,2994
113,DALLAS,113,1100,1131100,2073,7143,163,6980,44,2531,4462,6925,4857,127,4730,35,1718,3008,4697
121,DENTON,121,4187,1214187,3112,4490,1812,2678,330,671,1602,2212,3831,1671,2160,302,560,1225,1731
453,TRAVIS,453,0310,4530310,8860,4268,2081,2187,1159,207,779,976,3987,1937,2050,1094,184,730,908
121,DENTON,121,3148,1213148,3072,4150,2688,1462,351,281,711,971,3072,2109,963,226,204,440,639
201,HARRIS,201,0792,2010792,5010,3947,194,3753,44,565,3165,3696,2881,162,2719,37,455,2229,2669
201,HARRIS,201,0895,2010895,5113,1136,847,289,96,34,140,172,894,705,189,63,22,89,110
93,COMANCHE,93,0013,930013,1944,330,280,50,1,1,40,40,276,242,34,1,0,27,27
245,JEFFERSON,245,0021,2450021,6049,6021,2257,3764,21,2313,1453,3740,5944,2229,3715,18,2275,1444,3695
201,HARRIS,201,0024,2010024,4240,1620,317,1303,129,859,306,1156,1334,291,1043,117,698,228,921
113,DALLAS,113,4646,1134646,2880,1615,357,1258,32,85,1136,1216,1230,334,896,30,64,799,859
113,DALLAS,113,1314,1131314,2136,5671,942,4729,80,1049,3574,4594,3935,826,3109,61,708,2317,3011
453,TRAVIS,453,0131,4530131,8731,8935,1357,7578,357,1059,6225,7169,6355,1181,5174,246,812,4133,4877
29,BEXAR,29,1139,291139,390,3791,525,3266,158,430,2729,3091,2740,409,2331,117,307,1916,2195
37,BOWIE,37,0014,370014,1071,1098,878,220,15,89,50,138,874,705,169,11,67,39,105
423,SMITH,423,0031,4230031,7752,4998,3765,1233,44,217,842,1035,3988,3150,838,40,139,557,684
175,GOLIAD,175,0043,1750043,3965,477,365,112,0,27,72,99,376,306,70,0,21,38,59
17,BAILEY,17,0004B,170004B,135,203,125,78,1,1,76,76,147,97,50,0,0,48,48
113,DALLAS,113,1077,1131077,2050,0,0,0,0,0,0,0,0,0,0,0,0,0,0
113,DALLAS,113,2057,1132057,2262,689,543,146,39,22,71,91,519,405,114,35,13,54,65
225,HOUSTON,225,0004,2250004,5880,2938,1537,1401,50,695,637,1297,2275,1340,935,33,495,386,859
29,BEXAR,29,1097,291097,347,1488,76,1412,7,23,1398,1404,1137,59,1078,3,15,1072,1074
219,HOCKLEY,219,0045,2190045,5837,2697,1175,1522,10,97,1400,1470,2004,1004,1000,9,49,915,958
167,GALVESTON,167,0481,1670481,3922,308,200,108,3,4,95,98,252,170,82,3,4,70,73
181,GRAYSON,181,0303,1810303,4008,699,518,181,5,20,123,142,525,414,111,0,13,78,90
419,SHELBY,419,001S,419001S,7709,3118,1709,1409,70,502,804,1296,2296,1377,919,49,330,504,833
215,HIDALGO,215,0242,2150242,5794,120,7,113,1,3,110,111,83,7,76,1,1,73,74
241,JASPER,241,0003,2410003,6006,1388,1188,200,7,118,32,147,1136,981,155,7,88,19,107
331,MILAM,331,0203,3310203,6859,575,433,142,3,28,91,116,469,372,97,0,16,62,76
113,DALLAS,113,1718,1131718,2176,3341,1120,2221,91,294,1811,2088,2493,981,1512,63,238,1176,1406
121,DENTON,121,1019,1211019,2943,4613,2411,2202,1321,405,378,765,2900,1630,1270,762,239,217,451
505,ZAPATA,505,0003,5050003,9624,3589,383,3206,10,4,3171,3175,2477,349,2128,8,3,2102,2105
453,TRAVIS,453,0183,4530183,8774,2536,505,2031,477,476,1078,1529,1840,436,1404,374,315,705,1007
135,ECTOR,135,0401,1350401,3241,1854,572,1282,41,195,1033,1202,1406,473,933,29,147,736,871
187,GUADALUPE,187,0207,1870207,4091,2462,546,1916,18,247,1668,1875,1741,450,1291,11,159,1117,1265
87,COLLINGSWORTH,87,0301,870301,1881,562,299,263,8,57,206,252,411,240,171,6,36,128,161
405,SAN AUGUSTINE,405,0004,4050004,7626,659,338,321,7,233,83,312,496,301,195,4,150,43,190
159,FRANKLIN,159,0301,1590301,3796,1149,885,264,5,14,198,210,893,717,176,4,7,127,134
113,DALLAS,113,1129,1131129,2093,976,32,944,139,282,532,804,618,20,598,80,186,336,516
215,HIDALGO,215,0159,2150159,5711,1518,32,1486,3,8,1468,1468,1085,24,1061,3,3,1048,1048
439,TARRANT,439,1227,4391227,7921,3169,611,2558,353,1622,608,2168,2263,497,1766,246,1120,412,1495
25,BEE,25,0003,250003,178,10625,2249,8376,84,2004,6299,8270,9616,2046,7570,76,1936,5551,7471
29,BEXAR,29,4217,294217,1028,198,49,149,5,21,124,141,189,48,141,4,20,116,133
231,HUNT,231,0325,2310325,5963,3563,2853,710,59,196,309,492,2887,2397,490,47,152,181,327
121,DENTON,121,9204,1219204,3158,0,0,0,0,0,0,0,0,0,0,0,0,0,0
1,ANDERSON,1,0009,10009,9,2131,1507,624,41,281,234,510,1612,1194,418,26,192,143,334
41,BRAZOS,41,0006,410006,1197,1446,1049,397,11,45,265,303,1120,859,261,9,30,161,188
313,MADISON,313,0404,3130404,6733,2712,2143,569,40,101,356,455,2104,1707,397,24,60,255,314
167,GALVESTON,167,0142,1670142,3839,8217,3083,5134,119,2232,2723,4887,6322,2593,3729,75,1629,1935,3542
339,MONTGOMERY,339,0047,3390047,6945,4452,2113,2339,271,604,1332,1906,3146,1569,1577,186,411,877,1279
121,DENTON,121,4190,1214190,3115,4709,3321,1388,91,205,931,1112,3296,2400,896,64,122,582,692
437,SWISHER,437,0002,4370002,7835,1569,703,866,6,96,757,834,1122,573,549,2,49,476,522
121,DENTON,121,3145,1213145,3069,6073,4217,1856,750,222,730,943,4473,3254,1219,487,153,466,616
453,TRAVIS,453,0356,4530356,8900,3644,2465,1179,313,105,633,726,2916,2045,871,230,78,457,531
441,TAYLOR,441,0106,4410106,8605,4834,2671,2163,284,739,1086,1741,3202,1888,1314,175,456,606,1021
97,COOKE,97,0018,970018,1967,2369,2099,270,11,12,137,148,1749,1580,169,7,7,92,98
453,TRAVIS,453,0243,4530243,8817,5159,2409,2750,422,406,1855,2212,4168,2150,2018,338,323,1299,1592
251,JOHNSON,251,0016,2510016,6175,840,590,250,8,23,205,223,665,494,171,4,10,142,148
187,GUADALUPE,187,0412,1870412,4134,5004,1972,3032,287,1053,1728,2635,3420,1412,2008,190,742,1071,1738
201,HARRIS,201,0769,2010769,4987,232,14,218,0,187,33,218,213,14,199,0,173,28,199
29,BEXAR,29,1054,291054,304,4349,444,3905,35,59,3801,3838,3222,384,2838,26,31,2757,2784
491,WILLIAMSON,491,0390B,4910390B,9498,0,0,0,0,0,0,0,0,0,0,0,0,0,0
453,TRAVIS,453,0126,4530126,8728,6593,1312,5281,208,1534,3605,5038,4579,1076,3503,156,1062,2300,3320
345,MOTLEY,345,0002,3450002,7028,100,81,19,0,0,15,15,84,71,13,0,0,9,9
27,BELL,27,0301,270301,221,6390,4574,1816,57,252,1319,1533,4626,3471,1155,40,130,829,948
497,WISE,497,0016,4970016,9581,3506,2844,662,30,40,451,482,2746,2278,468,24,26,295,318
439,TARRANT,439,1294,4391294,7941,4990,2755,2235,153,933,1077,1974,3701,2215,1486,106,614,691,1297
201,HARRIS,201,0723,2010723,4941,5702,380,5322,535,2283,2559,4759,4245,332,3913,453,1744,1732,3440
121,DENTON,121,3128,1213128,3052,4367,1656,2711,678,958,1035,1940,3388,1430,1958,507,682,720,1375
201,HARRIS,201,0749,2010749,4967,1380,80,1300,59,495,805,1233,997,66,931,54,375,527,871
201,HARRIS,201,0644,2010644,4861,9199,3683,5516,2285,1015,2198,3114,6607,2729,3878,1605,677,1548,2173
329,MIDLAND,329,0310,3290310,6839,1651,432,1219,33,177,1010,1161,1117,327,790,16,125,639,754
197,HARDEMAN,197,0004,1970004,4197,913,673,240,3,38,173,207,713,557,156,2,29,101,128
439,TARRANT,439,1088,4391088,7878,3747,264,3483,36,456,2973,3411,2595,225,2370,28,341,1974,2306
41,BRAZOS,41,0052,410052,1243,32,10,22,5,1,12,13,21,8,13,5,1,4,5
13,ATASCOSA,13,0022,130022,115,989,535,454,9,6,409,414,742,416,326,5,5,292,297
91,COMAL,91,0307,910307,1924,3019,1339,1680,37,94,1537,1602,2299,1119,1180,33,61,1071,1120
453,TRAVIS,453,0105,4530105,8711,3572,1507,2065,189,852,1021,1834,3029,1354,1675,160,731,764,1476
29,BEXAR,29,1157,291157,410,5191,608,4583,206,743,3742,4355,3454,475,2979,135,478,2391,2811
447,THROCKMORTON,447,0002,4470002,8648,356,299,57,2,6,44,47,288,245,43,0,1,34,35
201,HARRIS,201,0413,2010413,4630,5199,928,4271,109,1177,2994,4110,3878,817,3061,87,963,1996,2926
201,HARRIS,201,0967,2010967,5185,6432,281,6151,123,2017,4108,5984,4256,229,4027,100,1341,2627,3902
355,NUECES,355,0068,3550068,7183,1921,207,1714,8,42,1665,1692,1436,191,1245,6,27,1202,1227
155,FOARD,155,0101,1550101,3608,270,212,58,3,10,45,52,224,176,48,3,7,39,43
297,LIVE OAK,297,0013,2970013,6502,678,519,159,2,3,123,125,557,436,121,2,2,90,91
141,EL PASO,141,0083,1410083,3396,2580,57,2523,16,30,2484,2497,1967,52,1915,9,18,1892,1898
355,NUECES,355,0110,3550110,7226,3241,1103,2138,61,100,1962,2032,2349,870,1479,54,56,1340,1386
439,TARRANT,439,3579,4393579,8374,1212,899,313,120,51,102,150,932,724,208,78,35,62,94
61,CAMERON,61,0029,610029,1441,3179,843,2336,32,25,2272,2277,2453,775,1678,21,10,1635,1638
85,COLLIN,85,0107,850107,1736,4496,2489,2007,1209,298,425,719,3545,2059,1486,914,208,303,508
201,HARRIS,201,1136,2011136,5354,7958,760,7198,588,3208,3488,6554,5317,582,4735,432,1991,2321,4250
65,CARSON,65,0401,650401,1524,990,829,161,5,8,90,94,761,642,119,3,4,65,67
29,BEXAR,29,3067,293067,671,1788,935,853,54,37,740,769,1453,800,653,44,32,557,585
479,WEBB,479,0310,4790310,9267,648,13,635,3,5,630,634,488,12,476,2,4,472,476
139,ELLIS,139,1059,1391059,3313,1173,820,353,18,50,226,273,859,622,237,12,29,147,174
283,LA SALLE,283,0001,2830001,6393,1392,301,1091,12,22,1053,1062,1037,261,776,10,11,745,751
209,HAYS,209,0122,2090122,5437,2660,1086,1574,113,331,1129,1428,2375,995,1380,102,293,974,1245
29,BEXAR,29,3130,293130,734,2165,1393,772,136,36,582,609,1686,1120,566,98,29,428,452
201,HARRIS,201,0198,2010198,4415,931,62,869,34,668,173,831,719,49,670,30,516,130,640
113,DALLAS,113,3063,1133063,2500,7029,202,6827,49,5414,1444,6757,5020,178,4842,35,3942,901,4786
157,FORT BEND,157,3127B,1573127B,3734,20,3,17,6,3,8,10,15,0,15,6,2,8,9
85,COLLIN,85,0190,850190,1819,118,71,47,1,13,28,39,86,58,28,0,6,15,21
157,FORT BEND,157,1132,1571132,3628,9553,3907,5646,3001,876,1674,2507,6584,2823,3761,1983,570,1137,1671
213,HENDERSON,213,03NW,21303NW,5543,930,682,248,3,60,159,219,728,564,164,2,45,101,146
29,BEXAR,29,3024,293024,628,0,0,0,0,0,0,0,0,0,0,0,0,0,0
113,DALLAS,113,3101,1133101,2543,1093,194,899,35,646,209,847,809,175,634,26,468,131,595
215,HIDALGO,215,0054,2150054,5606,3449,419,3030,160,79,2772,2842,2397,334,2063,113,50,1875,1921
389,REEVES,389,0007,3890007,7521,2312,292,2020,30,44,1934,1971,1759,259,1500,25,35,1423,1455
485,WICHITA,485,0201,4850201,9330,7494,4459,3035,433,1293,1178,2399,6280,3809,2471,360,1065,953,1967
479,WEBB,479,0124,4790124,9224,4009,54,3955,13,24,3934,3942,2852,46,2806,11,22,2787,2795
373,POLK,373,0019,3730019,7415,1628,1480,148,8,17,64,81,1551,1426,125,8,10,50,60
145,FALLS,145,0302,1450302,3565,2075,1185,890,22,302,523,813,1607,950,657,19,213,375,586
491,WILLIAMSON,491,0139,4910139,9393,6638,3038,3600,639,1006,1874,2779,5089,2533,2556,458,719,1283,1959
381,RANDALL,381,0315,3810315,7478,404,375,29,3,7,10,15,385,363,22,1,5,4,8
479,WEBB,479,0405,4790405,9287,3733,40,3693,0,6,3679,3679,2578,22,2556,0,4,2551,2551
361,ORANGE,361,0034,3610034,7289,2528,2203,325,61,25,152,170,1920,1698,222,39,11,97,108
201,HARRIS,201,1156,2011156,5374,0,0,0,0,0,0,0,0,0,0,0,0,0,0
85,COLLIN,85,0233,850233,1862,3084,1656,1428,261,544,563,1099,2184,1250,934,187,344,354,696
85,COLLIN,85,0127,850127,1756,5535,3049,2486,892,674,852,1498,4261,2495,1766,648,455,594,1033
209,HAYS,209,0338,2090338,5480,2831,2413,418,38,10,271,281,2322,2050,272,22,8,172,180
157,FORT BEND,157,2088,1572088,3671,2467,225,2242,254,1107,881,1966,1864,194,1670,203,836,623,1441
465,VAL VERDE,465,0033,4650033,9098,2474,1086,1388,19,37,1312,1335,1917,926,991,12,22,937,951
141,EL PASO,141,0189,1410189,3502,388,24,364,12,12,336,346,270,15,255,6,3,242,245
29,BEXAR,29,3050,293050,654,1853,913,940,43,142,755,875,1502,803,699,32,106,550,650
439,TARRANT,439,4017,4394017,8417,9380,892,8488,247,1458,6769,8153,6273,682,5591,134,880,4537,5384
201,HARRIS,201,1093,2011093,5311,2512,1719,793,91,37,594,624,2069,1491,578,72,28,424,448
85,COLLIN,85,0064,850064,1693,4518,2326,2192,1156,367,576,928,3403,1900,1503,792,258,390,641
85,COLLIN,85,0001,850001,1630,4198,2471,1727,74,441,1132,1539,3270,2074,1196,59,291,776,1052
141,EL PASO,141,0126,1410126,3439,7538,560,6978,199,315,6528,6775,5634,451,5183,150,229,4826,5022
471,WALKER,471,0201B,4710201B,9161,28,5,23,0,16,6,21,22,4,18,0,14,2,16
355,NUECES,355,0005,3550005,7120,2211,1065,1146,29,62,1019,1061,1800,938,862,21,39,759,785
439,TARRANT,439,4218,4394218,8480,3322,913,2409,256,48,2085,2125,2424,806,1618,213,37,1349,1382
201,HARRIS,201,0350,2010350,4567,6895,2917,3978,1981,845,1152,1931,5995,2631,3364,1631,724,990,1666
29,BEXAR,29,2152,292152,565,1100,185,915,11,62,847,899,924,174,750,9,53,686,736
57,CALHOUN,57,0005,570005,1398,2728,1321,1407,243,47,1102,1142,2092,1088,1004,173,40,775,811
367,PARKER,367,0225,3670225,7352,1806,1512,294,13,35,187,217,1458,1273,185,11,17,111,128
29,BEXAR,29,3174,293174,780,5994,3130,2864,552,283,1986,2223,4270,2393,1877,363,174,1301,1458
113,DALLAS,113,3967,1133967,2652,2189,1075,1114,128,352,612,940,1657,908,749,98,225,393,611
29,BEXAR,29,3133,293133,737,0,0,0,0,0,0,0,0,0,0,0,0,0,0
485,WICHITA,485,0204,4850204,9333,1002,826,176,27,16,99,113,809,677,132,15,3,78,81
209,HAYS,209,0440,2090440,5503,775,526,249,20,14,184,197,549,396,153,9,12,110,121
85,COLLIN,85,0044,850044,1673,3878,1346,2532,44,367,2053,2393,2882,1143,1739,33,267,1364,1618
201,HARRIS,201,0307,2010307,4524,5347,3413,1934,293,450,1107,1511,4360,2907,1453,230,330,812,1113
373,POLK,373,0022,3730022,7418,251,221,30,4,5,14,19,233,210,23,4,5,8,13
113,DALLAS,113,3605,1133605,2609,3787,370,3417,23,2692,723,3351,2929,347,2582,17,2085,470,2534
149,FAYETTE,149,0112,1490112,3588,1816,1155,661,3,106,511,609,1419,983,436,1,68,333,399
29,BEXAR,29,3090,293090,694,4718,2178,2540,197,411,1893,2242,3814,1843,1971,166,304,1446,1713
291,LIBERTY,291,0001,2910001,6439,1929,1529,400,10,78,239,311,1519,1244,275,5,60,149,207
439,TARRANT,439,3516,4393516,8354,2313,1822,491,128,83,219,290,1949,1582,367,89,64,157,213
479,WEBB,479,0237,4790237,9247,570,32,538,1,9,533,536,416,28,388,1,3,383,386
207,HASKELL,207,0002,2070002,5417,1506,903,603,11,111,465,566,1253,748,505,7,91,393,479
73,CHEROKEE,73,0038,730038,1587,1282,228,1054,6,260,769,1020,872,198,674,4,180,476,653
439,TARRANT,439,3332,4393332,8311,6240,2841,3399,730,865,1664,2472,4463,2235,2228,548,472,1080,1523
113,DALLAS,113,3086,1133086,2523,5604,4052,1552,433,304,730,1021,5458,3977,1481,416,282,694,968
277,LAMAR,277,002F,277002F,6353,314,247,67,3,7,40,47,243,201,42,3,3,24,27
69,CASTRO,69,0101,690101,1544,1281,240,1041,2,8,1010,1018,958,189,769,2,7,750,757
143,ERATH,143,0024,1430024,3545,2549,2018,531,57,76,351,411,2082,1716,366,48,49,221,260
367,PARKER,367,0420,3670420,7375,2945,2476,469,50,67,299,357,2237,1936,301,37,35,186,218
113,DALLAS,113,3043,1133043,2480,3679,59,3620,15,1952,1666,3588,2569,44,2525,8,1530,974,2500
267,KIMBLE,267,0003,2670003,6310,311,245,66,4,6,55,59,269,215,54,4,6,44,48
357,OCHILTREE,357,0002,3570002,7246,2489,904,1585,17,18,1517,1527,1707,705,1002,12,9,948,955
439,TARRANT,439,2505,4392505,8182,2552,1432,1120,107,278,687,944,1945,1201,744,74,176,441,610
295,LIPSCOMB,295,0106,2950106,6482,770,300,470,5,9,440,448,565,251,314,4,7,295,301
303,LUBBOCK,303,0108,3030108,6585,2120,1013,1107,73,224,820,1013,1406,742,664,60,118,474,585
213,HENDERSON,213,04MS,21304MS,5546,1562,989,573,10,427,85,511,1286,819,467,6,356,62,417
201,HARRIS,201,0264,2010264,4481,6879,1490,5389,280,209,4853,5033,5196,1329,3867,209,147,3454,3581
29,BEXAR,29,3047,293047,651,2257,1610,647,53,39,498,530,1648,1227,421,31,23,324,344
141,EL PASO,141,0103,1410103,3416,2844,520,2324,49,118,2206,2282,2269,473,1796,34,81,1699,1759
85,COLLIN,85,0087,850087,1716,6533,543,5990,5631,178,143,315,3967,344,3623,3405,109,98,205
201,HARRIS,201,0496,2010496,4713,4960,500,4460,333,582,3528,4090,3591,451,3140,294,430,2411,2832
307,MCCULLOCH,307,0301,3070301,6628,1628,1046,582,9,32,519,542,1231,835,396,7,16,350,364
215,HIDALGO,215,0097,2150097,5649,5518,331,5187,31,38,5120,5137,3946,264,3682,17,20,3637,3648
467,VAN ZANDT,467,004C,467004C,9118,2679,2202,477,28,60,311,370,2118,1761,357,22,50,218,268
397,ROCKWALL,397,002A,397002A,7564,4167,3240,927,143,201,452,645,3454,2789,665,105,144,310,450
141,EL PASO,141,0146,1410146,3459,2058,61,1997,15,46,1958,1976,1673,58,1615,12,31,1583,1596
157,FORT BEND,157,4100,1574100,3777,4988,600,4388,478,1168,2815,3907,3800,525,3275,404,861,2061,2872
477,WASHINGTON,477,0101,4770101,9204,1721,903,818,14,568,196,762,1344,734,610,10,463,116,579
201,HARRIS,201,1050,2011050,5268,1634,17,1617,13,1245,368,1605,1307,16,1291,9,1070,214,1282
439,TARRANT,439,3156,4393156,8268,2187,1587,600,86,99,305,397,1734,1339,395,55,55,197,250
29,BEXAR,29,3004,293004,608,0,0,0,0,0,0,0,0,0,0,0,0,0,0
365,PANOLA,365,0022,3650022,7332,542,299,243,0,209,15,224,443,246,197,0,172,13,185
469,VICTORIA,469,0021,4690021,9141,5849,3554,2295,214,214,1766,1952,4363,2803,1560,143,146,1178,1310
61,CAMERON,61,0069,610069,1481,7092,215,6877,31,49,6821,6833,4965,157,4808,14,21,4774,4780
439,TARRANT,439,4593,4394593,8563,1769,394,1375,29,205,1130,1327,1244,336,908,22,154,723,870
141,EL PASO,141,0043,1410043,3356,2864,855,2009,219,384,1440,1772,2289,745,1544,180,287,1080,1341
201,HARRIS,201,0178,2010178,4395,2933,2003,930,356,222,342,553,2473,1723,750,266,183,278,457
209,HAYS,209,0227,2090227,5460,5101,1618,3483,202,295,2971,3220,3665,1280,2385,144,183,2015,2185
361,ORANGE,361,0014,3610014,7269,2651,1742,909,31,500,289,786,2162,1498,664,24,391,179,568
201,HARRIS,201,1113,2011113,5331,6589,773,5816,1220,1186,3444,4568,4641,631,4010,910,817,2281,3065
201,HARRIS,201,1010,2011010,5228,2930,198,2732,231,1087,1455,2501,2019,160,1859,182,718,986,1678
491,WILLIAMSON,491,0252,4910252,9436,6021,3423,2598,1193,300,1013,1259,4193,2536,1657,750,177,651,804
29,BEXAR,29,2132,292132,545,0,0,0,0,0,0,0,0,0,0,0,0,0,0
439,TARRANT,439,3695,4393695,8397,6326,3976,2350,784,471,958,1393,4189,2741,1448,494,286,556,836
259,KENDALL,259,3010,2593010,6267,3093,2049,1044,69,62,840,891,2291,1602,689,45,35,556,583
405,SAN AUGUSTINE,405,0005,4050005,7627,610,463,147,7,62,64,123,450,353,97,6,42,36,75
201,HARRIS,201,0075,2010075,4292,2831,1780,1051,225,104,695,783,2327,1504,823,166,90,540,619
439,TARRANT,439,4284,4394284,8500,398,307,91,4,20,51,69,299,243,56,4,13,29,40
283,LA SALLE,283,0004,2830004,6396,113,54,59,1,0,54,54,87,45,42,1,0,38,38
439,TARRANT,439,2600,4392600,8205,0,0,0,0,0,0,0,0,0,0,0,0,0,0
141,EL PASO,141,0211A,1410211A,3525,820,239,581,5,154,421,575,820,239,581,5,154,421,575
209,HAYS,209,0132,2090132,5440,1161,661,500,16,77,403,463,934,565,369,13,63,285,334
367,PARKER,367,0240,3670240,7355,2426,1863,563,40,40,357,392,1880,1517,363,18,19,224,242
245,JEFFERSON,245,0093,2450093,6121,1890,216,1674,69,576,1024,1584,1439,202,1237,59,489,676,1162
439,TARRANT,439,1633,4391633,8036,75,31,44,0,0,41,41,66,28,38,0,0,38,38
479,WEBB,479,0129,4790129,9227,4432,72,4360,4,19,4327,4336,3114,53,3061,3,11,3041,3044
85,COLLIN,85,0024,850024,1653,4386,1542,2844,404,1704,727,2369,3626,1388,2238,334,1326,546,1830
363,PALO PINTO,363,0025,3630025,7312,189,133,56,3,10,38,46,154,110,44,3,7,30,35
201,HARRIS,201,0033,2010033,4249,5836,3655,2181,688,269,1098,1344,5396,3447,1949,605,231,970,1190
113,DALLAS,113,2150,1132150,2334,3091,281,2810,28,112,2653,2741,2387,265,2122,25,78,1994,2062
29,BEXAR,29,3027,293027,631,2208,1216,992,128,79,773,834,1708,1006,702,77,45,551,591
113,DALLAS,113,3104,1133104,2546,3836,548,3288,133,2084,1104,3129,2913,499,2414,102,1583,737,2294
439,TARRANT,439,3406,4393406,8334,0,0,0,0,0,0,0,0,0,0,0,0,0,0
251,JOHNSON,251,0006,2510006,6164,626,507,119,7,27,55,78,509,430,79,3,18,41,56
473,WALLER,473,0209,4730209,9184,4384,2783,1601,47,116,1326,1434,3313,2249,1064,31,84,858,939
201,HARRIS,201,0201,2010201,4418,1491,38,1453,12,781,679,1440,1082,27,1055,8,622,441,1047
29,BEXAR,29,2175,292175,588,4742,1206,3536,1561,407,1557,1918,3836,1095,2741,1137,322,1255,1559
113,DALLAS,113,3066,1133066,2503,4744,73,4671,19,2496,2169,4621,3159,61,3098,7,1791,1295,3071
29,BEXAR,29,2007,292007,419,3491,106,3385,17,58,3317,3357,2628,92,2536,11,43,2484,2514
85,COLLIN,85,0150,850150,1779,2210,1370,840,182,295,316,601,1589,1027,562,128,205,194,389
145,FALLS,145,0402,1450402,3568,1651,920,731,6,130,556,681,1233,746,487,6,93,350,443
203,HARRISON,203,0014,2030014,5397,1987,1363,624,13,326,203,529,1534,1073,461,7,263,122,385
209,HAYS,209,0342A,2090342A,5483,1557,897,660,30,86,511,585,1202,724,478,23,62,371,426
455,TRINITY,455,0010,4550010,9015,395,375,20,2,3,8,11,323,308,15,1,1,8,9
29,BEXAR,29,3194,293194,800,6921,3781,3140,539,313,2203,2449,4727,2693,2034,336,203,1424,1585
29,BEXAR,29,2092,292092,505,992,232,760,36,94,626,710,792,224,568,28,70,459,525
113,DALLAS,113,4010,1134010,2672,1842,1013,829,74,52,662,709,1501,872,629,50,41,499,539
215,HIDALGO,215,0014,2150014,5566,1867,102,1765,10,13,1732,1737,1438,90,1348,7,9,1322,1327
439,TARRANT,439,2425,4392425,8162,5513,2237,3276,276,1905,1062,2881,4287,1908,2379,215,1371,737,2071
201,HARRIS,201,0115,2010115,4332,4141,144,3997,13,1012,2999,3971,2913,131,2782,10,791,1984,2759
201,HARRIS,201,0327,2010327,4544,2625,97,2528,21,1679,839,2489,1966,56,1910,15,1350,538,1877
439,TARRANT,439,2269,4392269,8119,998,199,799,135,235,426,654,717,172,545,117,150,269,414
85,COLLIN,85,0067,850067,1696,4208,2513,1695,743,429,446,861,3710,2259,1451,664,360,347,699
113,DALLAS,113,2411,1132411,2377,2573,211,2362,62,95,2218,2291,1902,187,1715,60,72,1595,1654
375,POTTER,375,0422,3750422,7438,8931,2289,6642,160,2541,3854,6262,6645,1944,4701,103,1871,2588,4412
113,DALLAS,113,3023,1133023,2460,1939,36,1903,1,1388,500,1881,1506,31,1475,0,1134,328,1458
265,KERR,265,0109,2650109,6290,2048,1577,471,39,36,363,388,1713,1374,339,26,23,253,269
77,CLAY,77,0014,770014,1607,227,205,22,2,1,12,12,175,160,15,2,1,5,5
29,BEXAR,29,4072,294072,883,4254,2300,1954,77,205,1578,1763,3413,1944,1469,46,150,1186,1324
113,DALLAS,113,4503,1134503,2798,7754,1208,6546,959,2398,3201,5497,5726,1035,4691,748,1696,2220,3864
439,TARRANT,439,3668,4393668,8394,506,364,142,65,11,60,66,355,272,83,45,1,31,32
293,LIMESTONE,293,0404,2930404,6479,537,393,144,5,39,83,120,430,334,96,2,30,45,74
141,EL PASO,141,0166,1410166,3479,5819,616,5203,33,72,5082,5130,4329,526,3803,16,55,3712,3749
71,CHAMBERS,71,0013,710013,1564,0,0,0,0,0,0,0,0,0,0,0,0,0,0
29,BEXAR,29,4115,294115,926,266,125,141,7,16,111,122,219,106,113,7,15,84,94
113,DALLAS,113,4030,1134030,2692,287,28,259,0,113,146,254,40,1,39,0,3,36,36
201,HARRIS,201,0390,2010390,4607,5734,1643,4091,1477,1612,1016,2605,5551,1604,3947,1462,1506,983,2474
491,WILLIAMSON,491,0338,4910338,9479,3826,2866,960,126,78,628,695,3016,2353,663,90,41,431,469
201,HARRIS,201,0284,2010284,4501,14660,1714,12946,1353,2120,9478,11373,10513,1523,8990,861,1564,6575,7990
201,HARRIS,201,1133,2011133,5351,161,58,103,22,39,46,82,100,39,61,9,24,26,49
303,LUBBOCK,303,0028,3030028,6542,3006,1856,1150,189,189,713,882,2363,1574,789,141,114,465,573
439,TARRANT,439,4125,4394125,8457,1759,538,1221,12,68,1127,1185,1256,433,823,6,54,739,793
29,BEXAR,29,4009,294009,820,2342,129,2213,59,650,1570,2152,1644,118,1526,39,395,1114,1474
287,LEE,287,0301,2870301,6416,210,164,46,0,12,29,40,163,133,30,0,8,18,26
113,DALLAS,113,4078,1134078,2735,3212,1112,2100,89,298,1690,1969,2712,1027,1685,77,255,1321,1566
491,WILLIAMSON,491,0191,4910191,9416,1308,680,628,82,186,337,507,981,545,436,54,128,231,353
113,DALLAS,113,3801,1133801,2629,1289,112,1177,6,163,1005,1163,922,93,829,3,132,688,817
439,TARRANT,439,3509,4393509,8351,3483,2165,1318,163,244,771,985,2646,1737,909,122,142,530,654
381,RANDALL,381,0325,3810325,7481,2794,2117,677,51,60,472,531,2028,1598,430,34,32,292,323
257,KAUFMAN,257,0026,2570026,6247,4203,1026,3177,35,1782,1357,3093,2937,804,2133,29,1231,834,2060
201,HARRIS,201,0221,2010221,4438,6235,607,5628,65,91,5470,5538,4612,542,4070,54,69,3934,3994
73,CHEROKEE,73,0044,730044,1590,2218,1520,698,23,67,547,614,1690,1212,478,17,44,360,404
479,WEBB,479,0413,4790413,9290,4316,79,4237,7,25,4210,4215,3115,61,3054,3,15,3043,3045
439,TARRANT,439,2670,4392670,8225,306,103,203,3,64,132,192,234,97,137,1,43,95,134
61,CAMERON,61,0089,610089,1501,1929,99,1830,14,11,1806,1812,1342,87,1255,9,7,1241,1244
29,BEXAR,29,2050,292050,462,3103,483,2620,41,169,2422,2562,2347,417,1930,31,103,1788,1882
201,HARRIS,201,0453,2010453,4670,1962,407,1555,92,334,1131,1438,1514,341,1173,73,266,831,1081
157,FORT BEND,157,1143,1571143,3631,13512,4855,8657,4691,1119,2648,3713,8437,3102,5335,2854,687,1656,2313
113,DALLAS,113,2083,1132083,2271,2116,1321,795,102,56,607,651,1834,1188,646,90,42,484,521
485,WICHITA,485,0403,4850403,9353,5758,3686,2072,206,450,1267,1646,4283,2975,1308,150,270,751,994
439,TARRANT,439,3215,4393215,8288,3199,2302,897,134,254,417,654,2635,2007,628,94,168,299,458
201,HARRIS,201,0158,2010158,4375,4734,48,4686,43,4216,496,4637,3319,31,3288,31,2978,311,3253
251,JOHNSON,251,0025,2510025,6184,3848,1948,1900,148,416,1284,1679,3148,1618,1530,128,381,978,1346
29,BEXAR,29,3151,293151,757,4762,2216,2546,394,233,1886,2084,3369,1625,1744,276,154,1265,1404
113,DALLAS,113,3203,1133203,2566,3446,737,2709,65,1383,1268,2610,2567,644,1923,51,1013,844,1840
359,OLDHAM,359,0101,3590101,7249,271,168,103,5,44,56,93,90,59,31,0,14,17,26
439,TARRANT,439,4261,4394261,8497,5927,2543,3384,674,807,1821,2590,4489,2079,2410,523,534,1273,1778
157,FORT BEND,157,2151,1572151,3688,3758,825,2933,697,1838,406,2210,2846,687,2159,520,1365,280,1624
29,BEXAR,29,4026,294026,837,6892,659,6233,41,206,6001,6145,5124,591,4533,30,139,4346,4462
215,HIDALGO,215,0051,2150051,5603,3908,45,3863,6,12,3836,3838,2731,26,2705,2,8,2689,2691
303,LUBBOCK,303,0102,3030102,6582,637,492,145,4,13,99,108,477,384,93,4,11,54,63
491,WILLIAMSON,491,0244,4910244,9433,3756,2754,1002,163,201,528,711,2856,2188,668,113,124,346,466
201,HARRIS,201,0407,2010407,4624,7186,2622,4564,877,562,3094,3605,5694,2277,3417,741,415,2211,2595
303,LUBBOCK,303,0025,3030025,6539,2226,468,1758,20,325,1385,1682,1661,407,1254,19,222,981,1192
389,REEVES,389,0004,3890004,7518,76,38,38,0,1,37,38,62,34,28,0,0,28,28
491,WILLIAMSON,491,0331,4910331,9476,2060,502,1558,1286,95,165,252,1246,329,917,762,60,86,143
157,FORT BEND,157,3125,1573125,3731,7107,1300,5807,3449,1468,847,2278,5370,999,4371,2648,1059,615,1655
85,COLLIN,85,0187,850187,1816,803,602,201,13,11,130,141,624,482,142,9,7,85,92
439,TARRANT,439,4122,4394122,8454,5837,448,5389,21,145,5196,5311,4006,378,3628,19,87,3493,3569
439,TARRANT,439,3757,4393757,8411,0,0,0,0,0,0,0,0,0,0,0,0,0,0
85,COLLIN,85,0144,850144,1773,3819,2159,1660,839,394,337,723,2881,1674,1207,611,294,233,523
215,HIDALGO,215,0094,2150094,5646,6036,241,5795,21,32,5743,5749,4069,194,3875,16,17,3849,3854
297,LIVE OAK,297,0007,2970007,6496,67,36,31,1,1,26,26,51,28,23,0,1,19,19
397,ROCKWALL,397,001C,397001C,7561,5906,4489,1417,280,330,609,921,4274,3345,929,185,209,405,602
491,WILLIAMSON,491,0420,4910420,9519,5938,2531,3407,252,963,2187,3051,3991,1828,2163,134,606,1338,1914
85,COLLIN,85,0230,850230,1859,8997,3616,5381,2500,1738,1011,2695,6483,2865,3618,1641,1174,697,1846
401,RUSK,401,0314B,4010314B,7604,239,47,192,0,16,175,190,130,33,97,0,9,87,96
157,FORT BEND,157,4083,1574083,3774,8709,2020,6689,2154,2702,1847,4463,6079,1524,4555,1517,1801,1223,2983
157,FORT BEND,157,2010,1572010,3645,6067,3497,2570,70,348,2033,2353,4427,2733,1694,48,246,1326,1555
29,BEXAR,29,4069,294069,880,1142,552,590,10,86,464,541,991,514,477,7,78,367,438
85,COLLIN,85,0101,850101,1730,6353,3382,2971,1514,601,716,1294,4923,2693,2230,1129,465,521,974
113,DALLAS,113,4500,1134500,2795,3817,863,2954,528,972,1456,2394,2807,728,2079,369,672,1004,1672
215,HIDALGO,215,0137,2150137,5689,58,14,44,1,1,43,43,47,13,34,1,1,33,33
201,HARRIS,201,0493,2010493,4710,6466,834,5632,1213,1529,2946,4390,4783,741,4042,980,1049,2035,3039
29,BEXAR,29,3188,293188,794,0,0,0,0,0,0,0,0,0,0,0,0,0,0
113,DALLAS,113,4051,1134051,2709,42,7,35,4,8,24,26,28,7,21,4,6,12,14
215,HIDALGO,215,0008,2150008,5560,3301,462,2839,86,41,2723,2737,2609,420,2189,68,26,2087,2100
307,MCCULLOCH,307,0102,3070102,6625,204,121,83,0,3,75,76,177,108,69,0,2,62,63
381,RANDALL,381,0306,3810306,7475,3253,2560,693,82,59,458,512,2485,1982,503,54,40,336,373
491,WILLIAMSON,491,0135,4910135,9390,6504,2351,4153,464,982,2630,3545,5232,2084,3148,376,736,1926,2624
439,TARRANT,439,4496,4394496,8540,1448,459,989,85,434,442,864,1173,431,742,80,297,340,629
167,GALVESTON,167,0203,1670203,3860,1450,1240,210,27,17,127,142,1278,1130,148,18,12,85,97
29,BEXAR,29,4198,294198,1009,2976,625,2351,116,908,1406,2221,2121,485,1636,87,614,944,1521
5,ANGELINA,5,0004,50004,30,3006,1298,1708,37,650,968,1612,2215,1044,1171,28,494,604,1096
29,BEXAR,29,4155,294155,966,3435,942,2493,57,103,2310,2380,2909,843,2066,47,79,1902,1961
201,HARRIS,201,0579,2010579,4796,4368,210,4158,61,1307,2822,4086,3086,180,2906,40,979,1896,2855
439,TARRANT,439,1023,4391023,7856,6766,2895,3871,232,1903,1678,3509,4719,2235,2484,154,1219,1034,2231
453,TRAVIS,453,0211,4530211,8792,3201,2392,809,195,128,412,523,2659,1990,669,167,106,333,427
113,DALLAS,113,4558,1134558,2838,0,0,0,0,0,0,0,0,0,0,0,0,0,0
375,POTTER,375,0323,3750323,7432,6133,4595,1538,53,144,1077,1208,4786,3723,1063,33,81,720,794
495,WINKLER,495,0201,4950201,9562,1049,266,783,8,22,757,773,741,216,525,8,19,506,522
309,MCLENNAN,309,0036,3090036,6668,1265,975,290,28,62,177,235,1008,810,198,23,36,119,155
215,HIDALGO,215,0180,2150180,5732,903,16,887,1,0,880,880,535,12,523,1,0,516,516
201,HARRIS,201,0450,2010450,4667,7985,948,7037,130,2303,4648,6853,5780,795,4985,103,1815,3088,4838
91,COMAL,91,0107,910107,1902,4051,2883,1168,111,193,804,970,3141,2336,805,70,150,522,660
445,TERRY,445,0202,4450202,8643,810,321,489,4,4,466,470,595,240,355,1,0,339,339
497,WISE,497,0014,4970014,9579,1188,887,301,7,13,254,259,935,736,199,4,6,159,163
423,SMITH,423,0085,4230085,7793,1682,1257,425,32,95,248,339,1264,979,285,21,71,153,222
121,DENTON,121,1060,1211060,2984,1872,1373,499,54,116,306,408,1646,1255,391,47,87,229,310
93,COMANCHE,93,0014,930014,1945,160,135,25,1,0,17,17,130,114,16,1,0,11,11
167,GALVESTON,167,0479,1670479,3920,2008,1421,587,24,26,456,475,1557,1156,401,15,17,302,317
113,DALLAS,113,4648,1134648,2881,6507,845,5662,2088,2220,1367,3514,5071,757,4314,1596,1719,992,2674
331,MILAM,331,0101,3310101,6857,4060,2379,1681,34,413,1201,1582,3086,1992,1094,22,262,758,1012
215,HIDALGO,215,0240,2150240,5792,2161,171,1990,26,13,1951,1956,1518,158,1360,20,3,1330,1333
29,BEXAR,29,3044,293044,648,2184,1103,1081,103,146,843,962,1794,944,850,81,97,667,749
109,CULBERSON,109,03-3,10903-3,2008,54,21,33,3,3,28,30,48,21,27,0,2,25,27
485,WICHITA,485,0307,4850307,9347,2026,794,1232,24,254,944,1179,1490,679,811,20,146,639,775
201,HARRIS,201,0536,2010536,4753,7448,503,6945,1302,904,4797,5596,5495,424,5071,1045,674,3346,3974
121,DENTON,121,1020,1211020,2944,3497,2300,1197,624,225,310,512,2204,1483,721,377,146,172,308
201,HARRIS,201,0639,2010639,4856,3953,2314,1639,85,225,1246,1446,3134,1930,1204,69,156,903,1049
161,FREESTONE,161,0011A,1610011A,3817,571,335,236,1,187,38,222,464,267,197,0,163,22,183
113,DALLAS,113,4096,1134096,2752,160,149,11,0,6,5,9,154,149,5,0,1,2,3
497,WISE,497,0017,4970017,9582,3933,3259,674,16,44,443,479,2947,2513,434,14,22,265,284
113,DALLAS,113,4675,1134675,2901,501,36,465,14,27,427,449,337,28,309,12,16,282,295
409,SAN PATRICIO,409,0123,4090123,7667,254,60,194,6,4,180,182,166,44,122,4,0,112,112
29,BEXAR,29,4175,294175,986,0,0,0,0,0,0,0,0,0,0,0,0,0,0
309,MCLENNAN,309,0055,3090055,6688,6272,4080,2192,350,673,1075,1695,4527,3100,1427,220,441,659,1081
439,TARRANT,439,3500,4393500,8348,688,524,164,31,38,84,122,548,436,112,20,24,55,79
419,SHELBY,419,001W,419001W,7710,959,433,526,9,38,466,503,663,358,305,2,19,271,290
29,BEXAR,29,4218,294218,1029,206,50,156,2,66,92,153,202,48,154,2,66,91,152
87,COLLINGSWORTH,87,0201,870201,1879,558,268,290,6,44,220,258,410,218,192,3,34,132,166
215,HIDALGO,215,0243,2150243,5795,132,13,119,0,2,116,118,82,9,73,0,2,71,73
439,TARRANT,439,4588,4394588,8560,6437,3569,2868,821,703,1227,1893,4648,2654,1994,617,466,826,1268
209,HAYS,209,0426,2090426,5497,3398,2417,981,73,73,748,806,2682,1993,689,46,39,517,555
85,COLLIN,85,0207,850207,1836,6258,3764,2494,703,961,700,1630,4187,2625,1562,449,594,413,999
113,DALLAS,113,4027,1134027,2689,776,7,769,4,17,760,761,543,7,536,4,12,527,528
303,LUBBOCK,303,0003,3030003,6519,5403,841,4562,645,462,3441,3842,4433,777,3656,605,366,2637,2980
157,FORT BEND,157,3174,1573174,3751,2580,703,1877,813,639,423,1052,2006,574,1432,628,483,312,788
309,MCLENNAN,309,0013,3090013,6645,51,39,12,3,2,7,8,39,34,5,1,1,4,4
439,TARRANT,439,4069,4394069,8434,2438,1783,655,87,127,350,470,1983,1541,442,62,85,232,312
491,WILLIAMSON,491,0184,4910184,9413,2265,933,1332,181,372,736,1068,1652,727,925,141,245,512,734
201,HARRIS,201,0513,2010513,4730,4118,2376,1742,274,696,699,1364,3305,2049,1256,214,491,472,949
201,HARRIS,201,0387,2010387,4604,10301,4053,6248,139,1324,4674,5913,7398,3319,4079,95,910,2953,3815
201,HARRIS,201,0599,2010599,4816,1234,439,795,76,190,537,702,971,393,578,68,139,369,496
17,BAILEY,17,0003,170003,133,1753,418,1335,1,22,1293,1306,1196,341,855,1,10,831,839
113,DALLAS,113,4125,1134125,2775,0,0,0,0,0,0,0,0,0,0,0,0,0,0
385,REAL,385,0002,3850002,7495,693,493,200,8,10,171,177,593,449,144,6,6,122,125
453,TRAVIS,453,0127,4530127,8729,7529,1251,6278,179,1649,4503,5995,5184,1034,4150,130,1088,2904,3937
201,HARRIS,201,0681,2010681,4899,257,141,116,26,33,55,87,253,140,113,26,31,53,84
215,HIDALGO,215,0117,2150117,5669,6281,162,6119,6,17,6067,6075,4554,115,4439,1,10,4403,4408
201,HARRIS,201,0430,2010430,4647,8039,724,7315,1989,1403,3994,5281,5556,560,4996,1216,949,2876,3748
29,BEXAR,29,4006,294006,817,833,257,576,43,50,480,519,738,248,490,39,44,403,440
439,TARRANT,439,4374,4394374,8517,3524,1854,1670,353,357,925,1248,2667,1482,1185,280,212,641,840
37,BOWIE,37,020A,37020A,1112,436,177,259,4,197,48,245,345,142,203,3,160,31,191
439,TARRANT,439,3139,4393139,8265,2756,1336,1420,69,407,869,1241,2052,1092,960,47,243,588,820
201,HARRIS,201,0724,2010724,4942,1731,741,990,595,102,251,345,1312,573,739,445,87,171,254
87,COLLINGSWORTH,87,0302,870302,1882,111,86,25,2,2,22,23,90,73,17,1,0,15,15
113,DALLAS,113,3200,1133200,2563,2721,1027,1694,77,909,671,1560,2258,928,1330,68,728,500,1222
215,HIDALGO,215,0160,2150160,5712,926,297,629,86,39,508,533,767,273,494,73,32,390,413
1,ANDERSON,1,0010,10010,10,6985,2641,4344,51,2377,1894,4250,6772,2529,4243,36,2347,1842,4170
85,COLLIN,85,0081,850081,1710,4525,2396,2129,821,512,729,1224,3612,2022,1590,598,402,538,933
215,HIDALGO,215,0071,2150071,5623,482,19,463,0,2,460,462,285,17,268,0,2,265,267
113,DALLAS,113,4618,1134618,2858,1131,213,918,40,37,836,868,826,183,643,31,27,577,601
321,MATAGORDA,321,003B,321003B,6771,1261,608,653,57,40,550,578,904,484,420,42,13,349,360
395,ROBERTSON,395,0002,3950002,7541,2035,978,1057,9,330,726,1025,1512,789,723,2,230,473,699
85,COLLIN,85,0164,850164,1793,2055,1338,717,477,86,117,196,1807,1262,545,365,63,87,144
293,LIMESTONE,293,0401,2930401,6476,3201,1063,2138,34,956,1130,2054,2369,923,1446,17,687,711,1388
29,BEXAR,29,3191,293191,797,310,145,165,47,1,114,114,237,111,126,38,0,84,84
397,ROCKWALL,397,001A,397001A,7558,4727,2975,1752,214,560,842,1376,3788,2499,1289,164,388,619,995
113,DALLAS,113,3602,1133602,2606,689,74,615,27,542,49,586,590,70,520,23,460,37,495
29,BEXAR,29,3087,293087,691,2390,1104,1286,70,131,1042,1157,1936,965,971,53,95,767,857
399,RUNNELS,399,0003,3990003,7584,2358,1348,1010,24,60,879,932,1809,1128,681,18,43,576,615
201,HARRIS,201,0324,2010324,4541,3695,2467,1228,144,235,826,1046,2809,1932,877,98,178,571,743
91,COMAL,91,0104,910104,1899,2752,2193,559,32,65,367,423,2373,1949,424,26,40,268,303
215,HIDALGO,215,0028,2150028,5580,7206,513,6693,25,54,6623,6640,4852,452,4400,20,32,4351,4364
491,WILLIAMSON,491,0287,4910287,9456,3590,2308,1282,200,311,696,991,2624,1738,886,148,209,481,678
441,TAYLOR,441,0307,4410307,8623,5608,4240,1368,230,239,810,1012,3951,3101,850,152,149,470,598
29,BEXAR,29,4049,294049,860,5128,894,4234,486,1470,2309,3671,3875,773,3102,386,1082,1613,2647
329,MIDLAND,329,0106,3290106,6814,7216,2517,4699,225,629,3782,4314,5256,2004,3252,152,396,2597,2964
157,FORT BEND,157,4074,1574074,3771,7871,1869,6002,680,2111,3268,5248,5847,1587,4260,516,1432,2273,3669
277,LAMAR,277,001I,277001I,6350,481,392,89,4,17,27,44,374,307,67,3,12,15,27
201,HARRIS,201,0619,2010619,4836,7067,4485,2582,1042,378,1059,1414,5256,3404,1852,757,262,747,997
121,DENTON,121,2103,1212103,3027,3837,1200,2637,268,336,2011,2320,2907,1058,1849,210,238,1362,1592
159,FRANKLIN,159,0302,1590302,3797,1477,1126,351,24,43,217,256,1108,878,230,16,19,135,153
29,BEXAR,29,4112,294112,923,915,674,241,20,53,159,206,850,636,214,15,49,142,186
113,DALLAS,113,4075,1134075,2732,2551,324,2227,32,132,2042,2165,1969,300,1669,27,109,1510,1615
201,HARRIS,201,0261,2010261,4478,5093,376,4717,28,428,4259,4650,3695,317,3378,18,332,3013,3329
121,DENTON,121,1040,1211040,2964,2291,634,1657,909,489,241,709,1362,414,948,539,261,127,379
491,WILLIAMSON,491,0229,4910229,9430,388,283,105,17,18,56,74,307,240,67,11,12,29,41
113,DALLAS,113,4007,1134007,2669,250,130,120,10,35,62,97,198,107,91,7,26,47,73
439,TARRANT,439,3664,4393664,8391,0,0,0,0,0,0,0,0,0,0,0,0,0,0
157,FORT BEND,157,3060,1573060,3708,7960,686,7274,3138,2849,1341,4114,5876,568,5308,2466,1926,934,2822
409,SAN PATRICIO,409,0103,4090103,7647,621,335,286,8,9,257,264,501,295,206,4,5,181,185
201,HARRIS,201,0556,2010556,4773,6620,314,6306,958,1987,3361,5272,4840,277,4563,774,1470,2312,3726
335,MITCHELL,335,0003,3350003,6877,1707,1050,657,14,71,543,601,1286,863,423,9,39,340,378
451,TOM GREEN,451,0241,4510241,8686,6901,5102,1799,178,233,1244,1436,5589,4304,1285,128,183,842,1006
21,BASTROP,21,2011,212011,156,2821,1568,1253,162,281,733,997,2050,1244,806,114,187,442,624
171,GILLESPIE,171,0004,1710004,3943,4224,3057,1167,81,54,929,973,3461,2606,855,64,32,666,696
13,ATASCOSA,13,0020,130020,113,5696,3092,2604,63,109,2358,2442,4229,2462,1767,49,57,1601,1652
113,DALLAS,113,1046,1131046,2028,473,191,282,30,48,192,236,378,168,210,22,39,132,169
223,HOPKINS,223,0003,2230003,5858,3245,2137,1108,34,410,590,989,2469,1716,753,25,310,358,663
119,DELTA,119,0007,1190007,2921,334,286,48,4,5,23,27,271,243,28,2,2,11,13
29,BEXAR,29,4195,294195,1006,7,4,3,0,2,1,3,7,4,3,0,2,1,3
499,WOOD,499,03-2,49903-2,9602,3718,3315,403,17,28,215,241,3309,3008,301,14,23,142,163
439,TARRANT,439,3389,4393389,8328,6249,3115,3134,1054,976,986,1907,5003,2664,2339,770,729,735,1432
167,GALVESTON,167,0196,1670196,3857,1494,328,1166,23,726,430,1120,1145,285,860,17,562,282,823
5,ANGELINA,5,0001,50001,27,1318,375,943,15,320,607,918,895,319,576,9,195,370,562
93,COMANCHE,93,0011,930011,1942,789,559,230,0,9,185,190,586,450,136,0,3,112,114
215,HIDALGO,215,0220,2150220,5772,1482,70,1412,34,14,1371,1378,927,44,883,24,4,861,862
415,SCURRY,415,0011,4150011,7687,205,156,49,6,7,34,39,168,133,35,6,3,23,26
121,DENTON,121,2083,1212083,3007,2999,1567,1432,712,329,347,657,2115,1115,1000,519,220,220,432
145,FALLS,145,0202,1450202,3562,2209,411,1798,6,1166,640,1773,1633,365,1268,4,824,438,1253
209,HAYS,209,0335,2090335,5477,4420,3374,1046,50,49,788,822,3547,2888,659,30,25,496,510
37,BOWIE,37,003A,37003A,1092,2135,1237,898,24,615,199,799,1579,1030,549,19,357,113,465
85,COLLIN,85,0018,850018,1647,1478,982,496,24,24,376,398,1121,803,318,20,19,221,239
113,DALLAS,113,3701,1133701,2626,12,4,8,1,1,6,7,10,3,7,1,1,5,6
161,FREESTONE,161,0009B,1610009B,3814,312,249,63,0,23,40,61,255,202,53,0,21,31,52
291,LIBERTY,291,0024,2910024,6456,4813,3503,1310,27,169,965,1124,3671,2797,874,19,120,619,730
407,SAN JACINTO,407,0011,4070011,7644,994,684,310,7,164,112,271,797,545,252,4,139,88,223
201,HARRIS,201,0533,2010533,4750,2902,716,2186,47,535,1584,2091,2082,587,1495,42,350,1069,1408
85,COLLIN,85,0061,850061,1690,2121,1355,766,208,195,320,504,1781,1207,574,166,145,216,359
309,MCLENNAN,309,0075,3090075,6708,4530,3688,842,62,76,563,628,3391,2825,566,47,38,368,404
371,PECOS,371,0005,3710005,7392,97,44,53,2,1,49,50,77,38,39,2,1,35,36
491,WILLIAMSON,491,0415,4910415,9516,2621,1728,893,9,118,706,810,2057,1439,618,6,92,466,552
439,TARRANT,439,3826,4393826,8414,0,0,0,0,0,0,0,0,0,0,0,0,0,0
201,HARRIS,201,0367,2010367,4584,2717,523,2194,83,636,1472,2080,2183,492,1691,71,560,1052,1590
215,HIDALGO,215,0134,2150134,5686,4620,980,3640,84,64,3483,3524,3514,807,2707,60,47,2584,2620
287,LEE,287,0201,2870201,6413,762,660,102,6,18,68,84,629,561,68,3,12,47,57
113,DALLAS,113,4642,1134642,2878,452,80,372,22,18,337,350,345,76,269,16,14,239,252
319,MASON,319,0210,3190210,6751,961,557,404,4,7,378,381,761,467,294,0,5,278,279
99,CORYELL,99,0413,990413,1985,11883,6361,5522,105,2521,2777,5249,10867,5731,5136,86,2409,2537,4908
217,HILL,217,0004,2170004,5815,3265,2661,604,38,63,401,455,2694,2314,380,21,28,230,258
453,TRAVIS,453,0103,4530103,8709,2903,1591,1312,161,472,630,1074,2611,1471,1140,129,410,554,945
201,HARRIS,201,0662,2010662,4879,2989,1743,1246,129,50,1016,1063,2275,1395,880,108,32,689,718
367,PARKER,367,0210,3670210,7349,2834,2290,544,10,42,338,380,2209,1836,373,7,30,219,249
29,BEXAR,29,3148,293148,754,2062,991,1071,300,139,639,753,1361,687,674,183,80,407,480
113,DALLAS,113,4099,1134099,2755,1555,1077,478,112,116,218,330,1360,962,398,89,92,187,279
485,WICHITA,485,0310,4850310,9350,4988,1321,3667,68,1714,1829,3468,3770,1167,2603,45,1218,1261,2442
33,BORDEN,33,001B,33001B,1049,84,75,9,1,2,7,8,65,61,4,0,0,4,4
211,HEMPHILL,211,0303,2110303,5520,127,94,33,5,3,28,30,98,80,18,3,0,15,15
439,TARRANT,439,4682,4394682,8580,1009,148,861,43,22,798,819,720,141,579,40,7,532,539
157,FORT BEND,157,2161,1572161,3691,1044,633,411,9,137,234,369,771,496,275,4,98,149,247
85,COLLIN,85,0147,850147,1776,3629,1716,1913,653,704,527,1211,2711,1358,1353,468,497,357,847
491,WILLIAMSON,491,0321,4910321,9473,44,25,19,6,1,12,13,28,18,10,4,0,6,6
201,HARRIS,201,0410,2010410,4627,2002,164,1838,35,523,1280,1788,1456,147,1309,27,421,858,1271
